Poker Hand #HD1181512554: Hold'em No Limit  ($0.02/$0.05) - 2023/03/29 21:33:22
Table 'NLHBlue66' 6-max Seat #5 is the button
Seat 1: 9ad9efcc ($1.93 in chips)
Seat 2: 6b01355c ($5.35 in chips)
Seat 3: b57f88ab ($5.12 in chips)
Seat 4: 832c3754 ($5.06 in chips)
Seat 5: Hero ($7.83 in chips)
Seat 6: 79eaf66f ($5.02 in chips)
79eaf66f: posts small blind $0.02
9ad9efcc: posts big blind $0.05
*** HOLE CARDS ***
Dealt to 9ad9efcc 
Dealt to 6b01355c 
Dealt to b57f88ab 
Dealt to 832c3754 
Dealt to Hero [7s 3d]
Dealt to 79eaf66f 
6b01355c: folds
b57f88ab: folds
832c3754: raises $0.07 to $0.12
Hero: folds
79eaf66f: folds
9ad9efcc: calls $0.07
*** FLOP *** [Jc 7h 5d]
9ad9efcc: bets $0.09
832c3754: calls $0.09
*** TURN *** [Jc 7h 5d] [6c]
9ad9efcc: bets $0.15
832c3754: raises $0.37 to $0.52
9ad9efcc: folds
Uncalled bet ($0.37) returned to 832c3754
*** SHOWDOWN ***
832c3754 collected $0.71 from pot
*** SUMMARY ***
Total pot $0.74 | Rake $0.03 | Jackpot $0 | Bingo $0 | Fortune $0
Board [Jc 7h 5d 6c]
Seat 1: 9ad9efcc (big blind) folded on the Turn
Seat 2: 6b01355c folded before Flop (didn't bet)
Seat 3: b57f88ab folded before Flop (didn't bet)
Seat 4: 832c3754 won ($0.71)
Seat 5: Hero (button) folded before Flop (didn't bet)
Seat 6: 79eaf66f (small blind) folded before Flop


Poker Hand #HD1181512488: Hold'em No Limit  ($0.02/$0.05) - 2023/03/29 21:32:52
Table 'NLHBlue66' 6-max Seat #4 is the button
Seat 1: 9ad9efcc ($1.98 in chips)
Seat 2: 6b01355c ($5.35 in chips)
Seat 3: b57f88ab ($5 in chips)
Seat 4: 832c3754 ($5.06 in chips)
Seat 5: Hero ($7.85 in chips)
Seat 6: 79eaf66f ($5.07 in chips)
Hero: posts small blind $0.02
79eaf66f: posts big blind $0.05
*** HOLE CARDS ***
Dealt to 9ad9efcc 
Dealt to 6b01355c 
Dealt to b57f88ab 
Dealt to 832c3754 
Dealt to Hero [9h 7c]
Dealt to 79eaf66f 
9ad9efcc: calls $0.05
6b01355c: folds
b57f88ab: raises $0.15 to $0.2
832c3754: folds
Hero: folds
79eaf66f: folds
9ad9efcc: folds
Uncalled bet ($0.15) returned to b57f88ab
*** SHOWDOWN ***
b57f88ab collected $0.17 from pot
*** SUMMARY ***
Total pot $0.17 | Rake $0 | Jackpot $0 | Bingo $0 | Fortune $0
Seat 1: 9ad9efcc folded before Flop
Seat 2: 6b01355c folded before Flop (didn't bet)
Seat 3: b57f88ab collected ($0.17)
Seat 4: 832c3754 (button) folded before Flop (didn't bet)
Seat 5: Hero (small blind) folded before Flop
Seat 6: 79eaf66f (big blind) folded before Flop


Poker Hand #HD1181512435: Hold'em No Limit  ($0.02/$0.05) - 2023/03/29 21:32:25
Table 'NLHBlue66' 6-max Seat #3 is the button
Seat 1: 9ad9efcc ($1.82 in chips)
Seat 2: 6b01355c ($5.35 in chips)
Seat 3: b57f88ab ($5 in chips)
Seat 4: 832c3754 ($5.08 in chips)
Seat 5: Hero ($8 in chips)
Seat 6: 79eaf66f ($5.07 in chips)
832c3754: posts small blind $0.02
Hero: posts big blind $0.05
*** HOLE CARDS ***
Dealt to 9ad9efcc 
Dealt to 6b01355c 
Dealt to b57f88ab 
Dealt to 832c3754 
Dealt to Hero [8d 5d]
Dealt to 79eaf66f 
79eaf66f: folds
9ad9efcc: raises $0.1 to $0.15
6b01355c: folds
b57f88ab: folds
832c3754: folds
Hero: calls $0.1
*** FLOP *** [Th Kh 3h]
Hero: checks
9ad9efcc: bets $0.11
Hero: folds
Uncalled bet ($0.11) returned to 9ad9efcc
*** SHOWDOWN ***
9ad9efcc collected $0.31 from pot
*** SUMMARY ***
Total pot $0.32 | Rake $0.01 | Jackpot $0 | Bingo $0 | Fortune $0
Board [Th Kh 3h]
Seat 1: 9ad9efcc won ($0.31)
Seat 2: 6b01355c folded before Flop (didn't bet)
Seat 3: b57f88ab (button) folded before Flop (didn't bet)
Seat 4: 832c3754 (small blind) folded before Flop
Seat 5: Hero (big blind) folded on the Flop
Seat 6: 79eaf66f folded before Flop (didn't bet)


Poker Hand #HD1181512389: Hold'em No Limit  ($0.02/$0.05) - 2023/03/29 21:32:05
Table 'NLHBlue66' 6-max Seat #2 is the button
Seat 1: 9ad9efcc ($1.75 in chips)
Seat 2: 6b01355c ($5.35 in chips)
Seat 3: b57f88ab ($5.02 in chips)
Seat 4: 832c3754 ($5.13 in chips)
Seat 5: Hero ($8 in chips)
Seat 6: 79eaf66f ($5.07 in chips)
b57f88ab: posts small blind $0.02
832c3754: posts big blind $0.05
*** HOLE CARDS ***
Dealt to 9ad9efcc 
Dealt to 6b01355c 
Dealt to b57f88ab 
Dealt to 832c3754 
Dealt to Hero [6c Ad]
Dealt to 79eaf66f 
Hero: folds
79eaf66f: folds
9ad9efcc: raises $0.15 to $0.2
6b01355c: folds
b57f88ab: folds
832c3754: folds
Uncalled bet ($0.15) returned to 9ad9efcc
*** SHOWDOWN ***
9ad9efcc collected $0.12 from pot
*** SUMMARY ***
Total pot $0.12 | Rake $0 | Jackpot $0 | Bingo $0 | Fortune $0
Seat 1: 9ad9efcc collected ($0.12)
Seat 2: 6b01355c (button) folded before Flop (didn't bet)
Seat 3: b57f88ab (small blind) folded before Flop
Seat 4: 832c3754 (big blind) folded before Flop
Seat 5: Hero folded before Flop (didn't bet)
Seat 6: 79eaf66f folded before Flop (didn't bet)


Poker Hand #HD1181512340: Hold'em No Limit  ($0.02/$0.05) - 2023/03/29 21:31:34
Table 'NLHBlue66' 6-max Seat #1 is the button
Seat 1: 9ad9efcc ($1.75 in chips)
Seat 2: 6b01355c ($5.37 in chips)
Seat 3: b57f88ab ($5.07 in chips)
Seat 4: 832c3754 ($5.13 in chips)
Seat 5: Hero ($8 in chips)
Seat 6: 79eaf66f ($5 in chips)
6b01355c: posts small blind $0.02
b57f88ab: posts big blind $0.05
*** HOLE CARDS ***
Dealt to 9ad9efcc 
Dealt to 6b01355c 
Dealt to b57f88ab 
Dealt to 832c3754 
Dealt to Hero [6s Tc]
Dealt to 79eaf66f 
832c3754: folds
Hero: folds
79eaf66f: raises $0.08 to $0.13
9ad9efcc: folds
6b01355c: folds
b57f88ab: folds
Uncalled bet ($0.08) returned to 79eaf66f
*** SHOWDOWN ***
79eaf66f collected $0.12 from pot
*** SUMMARY ***
Total pot $0.12 | Rake $0 | Jackpot $0 | Bingo $0 | Fortune $0
Seat 1: 9ad9efcc (button) folded before Flop (didn't bet)
Seat 2: 6b01355c (small blind) folded before Flop
Seat 3: b57f88ab (big blind) folded before Flop
Seat 4: 832c3754 folded before Flop (didn't bet)
Seat 5: Hero folded before Flop (didn't bet)
Seat 6: 79eaf66f collected ($0.12)


Poker Hand #HD1181512295: Hold'em No Limit  ($0.02/$0.05) - 2023/03/29 21:31:09
Table 'NLHBlue66' 6-max Seat #6 is the button
Seat 1: 9ad9efcc ($1.7 in chips)
Seat 2: 6b01355c ($5.42 in chips)
Seat 3: b57f88ab ($5.07 in chips)
Seat 4: 832c3754 ($5.13 in chips)
Seat 5: Hero ($8 in chips)
Seat 6: 79eaf66f ($5 in chips)
9ad9efcc: posts small blind $0.02
6b01355c: posts big blind $0.05
*** HOLE CARDS ***
Dealt to 9ad9efcc 
Dealt to 6b01355c 
Dealt to b57f88ab 
Dealt to 832c3754 
Dealt to Hero [9d Js]
Dealt to 79eaf66f 
b57f88ab: folds
832c3754: folds
Hero: folds
79eaf66f: folds
9ad9efcc: raises $0.1 to $0.15
6b01355c: folds
Uncalled bet ($0.1) returned to 9ad9efcc
*** SHOWDOWN ***
9ad9efcc collected $0.1 from pot
*** SUMMARY ***
Total pot $0.1 | Rake $0 | Jackpot $0 | Bingo $0 | Fortune $0
Seat 1: 9ad9efcc (small blind) collected ($0.1)
Seat 2: 6b01355c (big blind) folded before Flop
Seat 3: b57f88ab folded before Flop (didn't bet)
Seat 4: 832c3754 folded before Flop (didn't bet)
Seat 5: Hero folded before Flop (didn't bet)
Seat 6: 79eaf66f (button) folded before Flop (didn't bet)


Poker Hand #HD1181512270: Hold'em No Limit  ($0.02/$0.05) - 2023/03/29 21:30:56
Table 'NLHBlue66' 6-max Seat #5 is the button
Seat 1: 9ad9efcc ($1.75 in chips)
Seat 2: 6b01355c ($5.42 in chips)
Seat 3: b57f88ab ($5.07 in chips)
Seat 4: 832c3754 ($5.13 in chips)
Seat 5: Hero ($7.93 in chips)
Seat 6: 79eaf66f ($5 in chips)
79eaf66f: posts small blind $0.02
9ad9efcc: posts big blind $0.05
*** HOLE CARDS ***
Dealt to 9ad9efcc 
Dealt to 6b01355c 
Dealt to b57f88ab 
Dealt to 832c3754 
Dealt to Hero [Js Ts]
Dealt to 79eaf66f 
6b01355c: folds
b57f88ab: folds
832c3754: folds
Hero: raises $0.07 to $0.12
79eaf66f: folds
9ad9efcc: folds
Uncalled bet ($0.07) returned to Hero
*** SHOWDOWN ***
Hero collected $0.12 from pot
*** SUMMARY ***
Total pot $0.12 | Rake $0 | Jackpot $0 | Bingo $0 | Fortune $0
Seat 1: 9ad9efcc (big blind) folded before Flop
Seat 2: 6b01355c folded before Flop (didn't bet)
Seat 3: b57f88ab folded before Flop (didn't bet)
Seat 4: 832c3754 folded before Flop (didn't bet)
Seat 5: Hero (button) collected ($0.12)
Seat 6: 79eaf66f (small blind) folded before Flop


Poker Hand #HD1181512191: Hold'em No Limit  ($0.02/$0.05) - 2023/03/29 21:30:18
Table 'NLHBlue66' 6-max Seat #4 is the button
Seat 1: 9ad9efcc ($1.75 in chips)
Seat 2: 6b01355c ($5.42 in chips)
Seat 3: b57f88ab ($5.07 in chips)
Seat 4: 832c3754 ($5 in chips)
Seat 5: Hero ($7.95 in chips)
Seat 6: 79eaf66f ($5 in chips)
Hero: posts small blind $0.02
79eaf66f: posts big blind $0.05
*** HOLE CARDS ***
Dealt to 9ad9efcc 
Dealt to 6b01355c 
Dealt to b57f88ab 
Dealt to 832c3754 
Dealt to Hero [7c 4d]
Dealt to 79eaf66f 
9ad9efcc: folds
6b01355c: folds
b57f88ab: folds
832c3754: raises $0.07 to $0.12
Hero: folds
79eaf66f: calls $0.07
*** FLOP *** [6d 2d Qd]
79eaf66f: checks
832c3754: bets $0.21
79eaf66f: folds
Uncalled bet ($0.21) returned to 832c3754
*** SHOWDOWN ***
832c3754 collected $0.25 from pot
*** SUMMARY ***
Total pot $0.26 | Rake $0.01 | Jackpot $0 | Bingo $0 | Fortune $0
Board [6d 2d Qd]
Seat 1: 9ad9efcc folded before Flop (didn't bet)
Seat 2: 6b01355c folded before Flop (didn't bet)
Seat 3: b57f88ab folded before Flop (didn't bet)
Seat 4: 832c3754 (button) won ($0.25)
Seat 5: Hero (small blind) folded before Flop
Seat 6: 79eaf66f (big blind) folded on the Flop


Poker Hand #HD1181512167: Hold'em No Limit  ($0.02/$0.05) - 2023/03/29 21:30:06
Table 'NLHBlue66' 6-max Seat #3 is the button
Seat 1: 9ad9efcc ($1.75 in chips)
Seat 2: 6b01355c ($5.42 in chips)
Seat 3: b57f88ab ($5 in chips)
Seat 4: 832c3754 ($5 in chips)
Seat 5: Hero ($8 in chips)
Seat 6: 79eaf66f ($5 in chips)
832c3754: posts small blind $0.02
Hero: posts big blind $0.05
*** HOLE CARDS ***
Dealt to 9ad9efcc 
Dealt to 6b01355c 
Dealt to b57f88ab 
Dealt to 832c3754 
Dealt to Hero [2s 3d]
Dealt to 79eaf66f 
79eaf66f: folds
9ad9efcc: folds
6b01355c: folds
b57f88ab: raises $0.08 to $0.13
832c3754: folds
Hero: folds
Uncalled bet ($0.08) returned to b57f88ab
*** SHOWDOWN ***
b57f88ab collected $0.12 from pot
*** SUMMARY ***
Total pot $0.12 | Rake $0 | Jackpot $0 | Bingo $0 | Fortune $0
Seat 1: 9ad9efcc folded before Flop (didn't bet)
Seat 2: 6b01355c folded before Flop (didn't bet)
Seat 3: b57f88ab (button) collected ($0.12)
Seat 4: 832c3754 (small blind) folded before Flop
Seat 5: Hero (big blind) folded before Flop
Seat 6: 79eaf66f folded before Flop (didn't bet)


Poker Hand #HD1181512093: Hold'em No Limit  ($0.02/$0.05) - 2023/03/29 21:29:25
Table 'NLHBlue66' 6-max Seat #2 is the button
Seat 1: 9ad9efcc ($1.87 in chips)
Seat 2: 6b01355c ($5.42 in chips)
Seat 3: b57f88ab ($5 in chips)
Seat 4: 832c3754 ($5 in chips)
Seat 5: Hero ($7.82 in chips)
Seat 6: 79eaf66f ($5 in chips)
b57f88ab: posts small blind $0.02
832c3754: posts big blind $0.05
*** HOLE CARDS ***
Dealt to 9ad9efcc 
Dealt to 6b01355c 
Dealt to b57f88ab 
Dealt to 832c3754 
Dealt to Hero [Ts Qs]
Dealt to 79eaf66f 
Hero: raises $0.07 to $0.12
79eaf66f: folds
9ad9efcc: calls $0.12
6b01355c: folds
b57f88ab: folds
832c3754: folds
*** FLOP *** [9s Kd Ks]
Hero: bets $0.24
9ad9efcc: folds
Uncalled bet ($0.24) returned to Hero
*** SHOWDOWN ***
Hero collected $0.3 from pot
*** SUMMARY ***
Total pot $0.31 | Rake $0.01 | Jackpot $0 | Bingo $0 | Fortune $0
Board [9s Kd Ks]
Seat 1: 9ad9efcc folded on the Flop
Seat 2: 6b01355c (button) folded before Flop (didn't bet)
Seat 3: b57f88ab (small blind) folded before Flop
Seat 4: 832c3754 (big blind) folded before Flop
Seat 5: Hero won ($0.3)
Seat 6: 79eaf66f folded before Flop (didn't bet)


Poker Hand #HD1181511973: Hold'em No Limit  ($0.02/$0.05) - 2023/03/29 21:28:32
Table 'NLHBlue66' 6-max Seat #1 is the button
Seat 1: 9ad9efcc ($1.87 in chips)
Seat 2: 6b01355c ($5.44 in chips)
Seat 3: b57f88ab ($5 in chips)
Seat 4: 832c3754 ($5 in chips)
Seat 5: Hero ($7.44 in chips)
Seat 6: 79eaf66f ($5 in chips)
6b01355c: posts small blind $0.02
b57f88ab: posts big blind $0.05
*** HOLE CARDS ***
Dealt to 9ad9efcc 
Dealt to 6b01355c 
Dealt to b57f88ab 
Dealt to 832c3754 
Dealt to Hero [Th Tc]
Dealt to 79eaf66f 
832c3754: raises $0.07 to $0.12
Hero: raises $0.22 to $0.34
79eaf66f: folds
9ad9efcc: folds
6b01355c: folds
b57f88ab: folds
832c3754: calls $0.22
*** FLOP *** [5d Kh Ad]
832c3754: checks
Hero: bets $0.5
832c3754: folds
Uncalled bet ($0.5) returned to Hero
*** SHOWDOWN ***
Hero collected $0.72 from pot
*** SUMMARY ***
Total pot $0.75 | Rake $0.03 | Jackpot $0 | Bingo $0 | Fortune $0
Board [5d Kh Ad]
Seat 1: 9ad9efcc (button) folded before Flop (didn't bet)
Seat 2: 6b01355c (small blind) folded before Flop
Seat 3: b57f88ab (big blind) folded before Flop
Seat 4: 832c3754 folded on the Flop
Seat 5: Hero won ($0.72)
Seat 6: 79eaf66f folded before Flop (didn't bet)


Poker Hand #HD1181511884: Hold'em No Limit  ($0.02/$0.05) - 2023/03/29 21:27:47
Table 'NLHBlue66' 6-max Seat #6 is the button
Seat 1: 9ad9efcc ($1.89 in chips)
Seat 2: 6b01355c ($5.03 in chips)
Seat 3: b57f88ab ($5 in chips)
Seat 4: 832c3754 ($5 in chips)
Seat 5: Hero ($7.44 in chips)
Seat 6: 79eaf66f ($5 in chips)
9ad9efcc: posts small blind $0.02
6b01355c: posts big blind $0.05
*** HOLE CARDS ***
Dealt to 9ad9efcc 
Dealt to 6b01355c 
Dealt to b57f88ab 
Dealt to 832c3754 
Dealt to Hero [Kd 5h]
Dealt to 79eaf66f 
b57f88ab: folds
832c3754: raises $0.07 to $0.12
Hero: folds
79eaf66f: folds
9ad9efcc: folds
6b01355c: calls $0.07
*** FLOP *** [9d Jd 7s]
6b01355c: checks
832c3754: checks
*** TURN *** [9d Jd 7s] [Jh]
6b01355c: bets $0.14
832c3754: calls $0.14
*** RIVER *** [9d Jd 7s Jh] [7h]
6b01355c: bets $0.17
832c3754: calls $0.17
6b01355c: shows [8d Td] (Jacks-High Straight)
832c3754: shows [Ks Ah] (Pair of Jacks and Pair of Sevens)
*** SHOWDOWN ***
6b01355c collected $0.84 from pot
*** SUMMARY ***
Total pot $0.88 | Rake $0.04 | Jackpot $0 | Bingo $0 | Fortune $0
Board [9d Jd 7s Jh 7h]
Seat 1: 9ad9efcc (small blind) folded before Flop
Seat 2: 6b01355c (big blind) showed [8d Td] and won ($0.84) with Jacks-High Straight
Seat 3: b57f88ab folded before Flop (didn't bet)
Seat 4: 832c3754 showed [Ks Ah] and lost with Pair of Jacks and Pair of Sevens
Seat 5: Hero folded before Flop (didn't bet)
Seat 6: 79eaf66f (button) folded before Flop (didn't bet)


Poker Hand #HD1181511814: Hold'em No Limit  ($0.02/$0.05) - 2023/03/29 21:27:14
Table 'NLHBlue66' 6-max Seat #5 is the button
Seat 1: 9ad9efcc ($1.94 in chips)
Seat 2: 6b01355c ($5.03 in chips)
Seat 3: b57f88ab ($5.07 in chips)
Seat 4: 832c3754 ($5 in chips)
Seat 5: Hero ($6.79 in chips)
Seat 6: 79eaf66f ($5 in chips)
79eaf66f: posts small blind $0.02
9ad9efcc: posts big blind $0.05
*** HOLE CARDS ***
Dealt to 9ad9efcc 
Dealt to 6b01355c 
Dealt to b57f88ab 
Dealt to 832c3754 
Dealt to Hero [Qc Ks]
Dealt to 79eaf66f 
6b01355c: folds
b57f88ab: raises $0.08 to $0.13
832c3754: folds
Hero: calls $0.13
79eaf66f: folds
9ad9efcc: folds
*** FLOP *** [7d Kd 6d]
b57f88ab: checks
Hero: bets $0.17
b57f88ab: calls $0.17
*** TURN *** [7d Kd 6d] [8c]
b57f88ab: checks
Hero: bets $0.34
b57f88ab: calls $0.34
*** RIVER *** [7d Kd 6d 8c] [7s]
b57f88ab: checks
Hero: checks
b57f88ab: shows [Qs Qd] (Pair of Queens and Pair of Sevens)
Hero: shows [Qc Ks] (Pair of Kings and Pair of Sevens)
*** SHOWDOWN ***
Hero collected $1.29 from pot
*** SUMMARY ***
Total pot $1.35 | Rake $0.06 | Jackpot $0 | Bingo $0 | Fortune $0
Board [7d Kd 6d 8c 7s]
Seat 1: 9ad9efcc (big blind) folded before Flop
Seat 2: 6b01355c folded before Flop (didn't bet)
Seat 3: b57f88ab showed [Qs Qd] and lost with Pair of Queens and Pair of Sevens
Seat 4: 832c3754 folded before Flop (didn't bet)
Seat 5: Hero (button) showed [Qc Ks] and won ($1.29) with Pair of Kings and Pair of Sevens
Seat 6: 79eaf66f (small blind) folded before Flop


Poker Hand #HD1181511673: Hold'em No Limit  ($0.02/$0.05) - 2023/03/29 21:25:59
Table 'NLHBlue66' 6-max Seat #4 is the button
Seat 1: 9ad9efcc ($1.5 in chips)
Seat 2: 6b01355c ($5.03 in chips)
Seat 3: b57f88ab ($5.07 in chips)
Seat 4: 832c3754 ($5.24 in chips)
Seat 5: Hero ($6.81 in chips)
Seat 6: 79eaf66f ($5 in chips)
Hero: posts small blind $0.02
79eaf66f: posts big blind $0.05
*** HOLE CARDS ***
Dealt to 9ad9efcc 
Dealt to 6b01355c 
Dealt to b57f88ab 
Dealt to 832c3754 
Dealt to Hero [4d 9c]
Dealt to 79eaf66f 
9ad9efcc: raises $0.1 to $0.15
6b01355c: folds
b57f88ab: folds
832c3754: calls $0.15
Hero: folds
79eaf66f: calls $0.1
*** FLOP *** [5c 9s 7h]
79eaf66f: checks
9ad9efcc: bets $0.16
832c3754: calls $0.16
79eaf66f: folds
*** TURN *** [5c 9s 7h] [4s]
9ad9efcc: checks
832c3754: checks
*** RIVER *** [5c 9s 7h 4s] [6c]
9ad9efcc: checks
832c3754: checks
9ad9efcc: shows [5d Ah] (Pair of Fives)
832c3754: shows [2h 2c] (Pair of Twos)
*** SHOWDOWN ***
9ad9efcc collected $0.75 from pot
*** SUMMARY ***
Total pot $0.79 | Rake $0.04 | Jackpot $0 | Bingo $0 | Fortune $0
Board [5c 9s 7h 4s 6c]
Seat 1: 9ad9efcc showed [5d Ah] and won ($0.75) with Pair of Fives
Seat 2: 6b01355c folded before Flop (didn't bet)
Seat 3: b57f88ab folded before Flop (didn't bet)
Seat 4: 832c3754 (button) showed [2h 2c] and lost with Pair of Twos
Seat 5: Hero (small blind) folded before Flop
Seat 6: 79eaf66f (big blind) folded on the Flop


Poker Hand #HD1181511591: Hold'em No Limit  ($0.02/$0.05) - 2023/03/29 21:25:16
Table 'NLHBlue66' 6-max Seat #3 is the button
Seat 1: 9ad9efcc ($2.25 in chips)
Seat 2: 6b01355c ($5.03 in chips)
Seat 3: b57f88ab ($5.07 in chips)
Seat 4: 832c3754 ($5.26 in chips)
Seat 5: Hero ($6.16 in chips)
Seat 6: 79eaf66f ($5 in chips)
832c3754: posts small blind $0.02
Hero: posts big blind $0.05
*** HOLE CARDS ***
Dealt to 9ad9efcc 
Dealt to 6b01355c 
Dealt to b57f88ab 
Dealt to 832c3754 
Dealt to Hero [6s 7s]
Dealt to 79eaf66f 
79eaf66f: folds
9ad9efcc: raises $0.05 to $0.1
6b01355c: folds
b57f88ab: folds
832c3754: folds
Hero: calls $0.05
*** FLOP *** [Ts Qh 2s]
Hero: checks
9ad9efcc: bets $0.08
Hero: calls $0.08
*** TURN *** [Ts Qh 2s] [Qs]
Hero: checks
9ad9efcc: checks
*** RIVER *** [Ts Qh 2s Qs] [7c]
Hero: bets $0.57
9ad9efcc: calls $0.57
Hero: shows [6s 7s] (Queen High Flush)
9ad9efcc: shows [Td Jc] (Pair of Queens and Pair of Tens)
*** SHOWDOWN ***
Hero collected $1.4 from pot
*** SUMMARY ***
Total pot $1.52 | Rake $0.07 | Jackpot $0.05 | Bingo $0 | Fortune $0
Board [Ts Qh 2s Qs 7c]
Seat 1: 9ad9efcc showed [Td Jc] and lost with Pair of Queens and Pair of Tens
Seat 2: 6b01355c folded before Flop (didn't bet)
Seat 3: b57f88ab (button) folded before Flop (didn't bet)
Seat 4: 832c3754 (small blind) folded before Flop
Seat 5: Hero (big blind) showed [6s 7s] and won ($1.4) with Queen High Flush
Seat 6: 79eaf66f folded before Flop (didn't bet)


Poker Hand #HD1181511568: Hold'em No Limit  ($0.02/$0.05) - 2023/03/29 21:25:06
Table 'NLHBlue66' 6-max Seat #2 is the button
Seat 1: 9ad9efcc ($2.25 in chips)
Seat 2: 6b01355c ($5.03 in chips)
Seat 3: b57f88ab ($5.09 in chips)
Seat 4: 832c3754 ($5.24 in chips)
Seat 5: Hero ($6.16 in chips)
Seat 6: 79eaf66f ($5 in chips)
b57f88ab: posts small blind $0.02
832c3754: posts big blind $0.05
*** HOLE CARDS ***
Dealt to 9ad9efcc 
Dealt to 6b01355c 
Dealt to b57f88ab 
Dealt to 832c3754 
Dealt to Hero [8s Qc]
Dealt to 79eaf66f 
Hero: folds
79eaf66f: folds
9ad9efcc: folds
6b01355c: folds
b57f88ab: folds
Uncalled bet ($0.03) returned to 832c3754
*** SHOWDOWN ***
832c3754 collected $0.04 from pot
*** SUMMARY ***
Total pot $0.04 | Rake $0 | Jackpot $0 | Bingo $0 | Fortune $0
Seat 1: 9ad9efcc folded before Flop (didn't bet)
Seat 2: 6b01355c (button) folded before Flop (didn't bet)
Seat 3: b57f88ab (small blind) folded before Flop
Seat 4: 832c3754 (big blind) collected ($0.04)
Seat 5: Hero folded before Flop (didn't bet)
Seat 6: 79eaf66f folded before Flop (didn't bet)


Poker Hand #HD1181511539: Hold'em No Limit  ($0.02/$0.05) - 2023/03/29 21:24:53
Table 'NLHBlue66' 6-max Seat #1 is the button
Seat 1: 9ad9efcc ($2.25 in chips)
Seat 2: 6b01355c ($5.05 in chips)
Seat 3: b57f88ab ($5.14 in chips)
Seat 4: 832c3754 ($5.17 in chips)
Seat 5: Hero ($6.16 in chips)
Seat 6: 79eaf66f ($5 in chips)
6b01355c: posts small blind $0.02
b57f88ab: posts big blind $0.05
*** HOLE CARDS ***
Dealt to 9ad9efcc 
Dealt to 6b01355c 
Dealt to b57f88ab 
Dealt to 832c3754 
Dealt to Hero [6h 9c]
Dealt to 79eaf66f 
832c3754: raises $0.07 to $0.12
Hero: folds
79eaf66f: folds
9ad9efcc: folds
6b01355c: folds
b57f88ab: folds
Uncalled bet ($0.07) returned to 832c3754
*** SHOWDOWN ***
832c3754 collected $0.12 from pot
*** SUMMARY ***
Total pot $0.12 | Rake $0 | Jackpot $0 | Bingo $0 | Fortune $0
Seat 1: 9ad9efcc (button) folded before Flop (didn't bet)
Seat 2: 6b01355c (small blind) folded before Flop
Seat 3: b57f88ab (big blind) folded before Flop
Seat 4: 832c3754 collected ($0.12)
Seat 5: Hero folded before Flop (didn't bet)
Seat 6: 79eaf66f folded before Flop (didn't bet)


Poker Hand #HD1181511490: Hold'em No Limit  ($0.02/$0.05) - 2023/03/29 21:24:29
Table 'NLHBlue66' 6-max Seat #6 is the button
Seat 1: 9ad9efcc ($2.27 in chips)
Seat 2: 6b01355c ($5 in chips)
Seat 3: b57f88ab ($5.14 in chips)
Seat 4: 832c3754 ($5.1 in chips)
Seat 5: Hero ($6.16 in chips)
Seat 6: 79eaf66f ($5 in chips)
9ad9efcc: posts small blind $0.02
6b01355c: posts big blind $0.05
*** HOLE CARDS ***
Dealt to 9ad9efcc 
Dealt to 6b01355c 
Dealt to b57f88ab 
Dealt to 832c3754 
Dealt to Hero [3c 6s]
Dealt to 79eaf66f 
b57f88ab: folds
832c3754: raises $0.07 to $0.12
Hero: folds
79eaf66f: folds
9ad9efcc: folds
6b01355c: folds
Uncalled bet ($0.07) returned to 832c3754
*** SHOWDOWN ***
832c3754 collected $0.12 from pot
*** SUMMARY ***
Total pot $0.12 | Rake $0 | Jackpot $0 | Bingo $0 | Fortune $0
Seat 1: 9ad9efcc (small blind) folded before Flop
Seat 2: 6b01355c (big blind) folded before Flop
Seat 3: b57f88ab folded before Flop (didn't bet)
Seat 4: 832c3754 collected ($0.12)
Seat 5: Hero folded before Flop (didn't bet)
Seat 6: 79eaf66f (button) folded before Flop (didn't bet)


Poker Hand #HD1181511465: Hold'em No Limit  ($0.02/$0.05) - 2023/03/29 21:24:15
Table 'NLHBlue66' 6-max Seat #5 is the button
Seat 1: 9ad9efcc ($2.32 in chips)
Seat 3: b57f88ab ($5.07 in chips)
Seat 4: 832c3754 ($5.1 in chips)
Seat 5: Hero ($6.16 in chips)
Seat 6: 79eaf66f ($5 in chips)
79eaf66f: posts small blind $0.02
9ad9efcc: posts big blind $0.05
*** HOLE CARDS ***
Dealt to 9ad9efcc 
Dealt to b57f88ab 
Dealt to 832c3754 
Dealt to Hero [8s 3d]
Dealt to 79eaf66f 
b57f88ab: raises $0.08 to $0.13
832c3754: folds
Hero: folds
79eaf66f: folds
9ad9efcc: folds
Uncalled bet ($0.08) returned to b57f88ab
*** SHOWDOWN ***
b57f88ab collected $0.12 from pot
*** SUMMARY ***
Total pot $0.12 | Rake $0 | Jackpot $0 | Bingo $0 | Fortune $0
Seat 1: 9ad9efcc (big blind) folded before Flop
Seat 3: b57f88ab collected ($0.12)
Seat 4: 832c3754 folded before Flop (didn't bet)
Seat 5: Hero (button) folded before Flop (didn't bet)
Seat 6: 79eaf66f (small blind) folded before Flop


Poker Hand #HD1181511432: Hold'em No Limit  ($0.02/$0.05) - 2023/03/29 21:24:01
Table 'NLHBlue66' 6-max Seat #4 is the button
Seat 1: 9ad9efcc ($2.32 in chips)
Seat 2: 993f1f71 ($1.16 in chips)
Seat 3: b57f88ab ($5 in chips)
Seat 4: 832c3754 ($5.1 in chips)
Seat 5: Hero ($6.18 in chips)
Seat 6: 79eaf66f ($5 in chips)
Hero: posts small blind $0.02
79eaf66f: posts big blind $0.05
*** HOLE CARDS ***
Dealt to 9ad9efcc 
Dealt to 993f1f71 
Dealt to b57f88ab 
Dealt to 832c3754 
Dealt to Hero [3h 2d]
Dealt to 79eaf66f 
9ad9efcc: folds
993f1f71: folds
b57f88ab: raises $0.1 to $0.15
832c3754: folds
Hero: folds
79eaf66f: folds
Uncalled bet ($0.1) returned to b57f88ab
*** SHOWDOWN ***
b57f88ab collected $0.12 from pot
*** SUMMARY ***
Total pot $0.12 | Rake $0 | Jackpot $0 | Bingo $0 | Fortune $0
Seat 1: 9ad9efcc folded before Flop (didn't bet)
Seat 2: 993f1f71 folded before Flop (didn't bet)
Seat 3: b57f88ab collected ($0.12)
Seat 4: 832c3754 (button) folded before Flop (didn't bet)
Seat 5: Hero (small blind) folded before Flop
Seat 6: 79eaf66f (big blind) folded before Flop


Poker Hand #HD1181511406: Hold'em No Limit  ($0.02/$0.05) - 2023/03/29 21:23:48
Table 'NLHBlue66' 6-max Seat #3 is the button
Seat 1: 9ad9efcc ($2.25 in chips)
Seat 2: 993f1f71 ($1.16 in chips)
Seat 3: b57f88ab ($5 in chips)
Seat 4: 832c3754 ($5.12 in chips)
Seat 5: Hero ($6.23 in chips)
Seat 6: 79eaf66f ($5 in chips)
832c3754: posts small blind $0.02
Hero: posts big blind $0.05
*** HOLE CARDS ***
Dealt to 9ad9efcc 
Dealt to 993f1f71 
Dealt to b57f88ab 
Dealt to 832c3754 
Dealt to Hero [8h 9s]
Dealt to 79eaf66f 
79eaf66f: folds
9ad9efcc: raises $0.1 to $0.15
993f1f71: folds
b57f88ab: folds
832c3754: folds
Hero: folds
Uncalled bet ($0.1) returned to 9ad9efcc
*** SHOWDOWN ***
9ad9efcc collected $0.12 from pot
*** SUMMARY ***
Total pot $0.12 | Rake $0 | Jackpot $0 | Bingo $0 | Fortune $0
Seat 1: 9ad9efcc collected ($0.12)
Seat 2: 993f1f71 folded before Flop (didn't bet)
Seat 3: b57f88ab (button) folded before Flop (didn't bet)
Seat 4: 832c3754 (small blind) folded before Flop
Seat 5: Hero (big blind) folded before Flop
Seat 6: 79eaf66f folded before Flop (didn't bet)


Poker Hand #HD1181511331: Hold'em No Limit  ($0.02/$0.05) - 2023/03/29 21:23:09
Table 'NLHBlue66' 6-max Seat #2 is the button
Seat 1: 9ad9efcc ($2.25 in chips)
Seat 2: 993f1f71 ($1.21 in chips)
Seat 3: b57f88ab ($5 in chips)
Seat 4: 832c3754 ($5.05 in chips)
Seat 5: Hero ($6.23 in chips)
Seat 6: 79eaf66f ($5 in chips)
b57f88ab: posts small blind $0.02
832c3754: posts big blind $0.05
*** HOLE CARDS ***
Dealt to 9ad9efcc 
Dealt to 993f1f71 
Dealt to b57f88ab 
Dealt to 832c3754 
Dealt to Hero [7d Ah]
Dealt to 79eaf66f 
Hero: folds
79eaf66f: folds
9ad9efcc: folds
993f1f71: calls $0.05
b57f88ab: folds
832c3754: checks
*** FLOP *** [5d 9s Kd]
832c3754: checks
993f1f71: checks
*** TURN *** [5d 9s Kd] [5s]
832c3754: checks
993f1f71: checks
*** RIVER *** [5d 9s Kd 5s] [7s]
832c3754: checks
993f1f71: checks
832c3754: shows [8c 7c] (Pair of Sevens and Pair of Fives)
993f1f71: shows [6c Qh] (Pair of Fives)
*** SHOWDOWN ***
832c3754 collected $0.12 from pot
*** SUMMARY ***
Total pot $0.12 | Rake $0 | Jackpot $0 | Bingo $0 | Fortune $0
Board [5d 9s Kd 5s 7s]
Seat 1: 9ad9efcc folded before Flop (didn't bet)
Seat 2: 993f1f71 (button) showed [6c Qh] and lost with Pair of Fives
Seat 3: b57f88ab (small blind) folded before Flop
Seat 4: 832c3754 (big blind) showed [8c 7c] and won ($0.12) with Pair of Sevens and Pair of Fives
Seat 5: Hero folded before Flop (didn't bet)
Seat 6: 79eaf66f folded before Flop (didn't bet)


Poker Hand #HD1181511275: Hold'em No Limit  ($0.02/$0.05) - 2023/03/29 21:22:40
Table 'NLHBlue66' 6-max Seat #1 is the button
Seat 1: 9ad9efcc ($2.06 in chips)
Seat 2: 993f1f71 ($1.31 in chips)
Seat 3: b57f88ab ($5 in chips)
Seat 4: 832c3754 ($5.05 in chips)
Seat 5: Hero ($6.23 in chips)
Seat 6: 79eaf66f ($5 in chips)
993f1f71: posts small blind $0.02
b57f88ab: posts big blind $0.05
*** HOLE CARDS ***
Dealt to 9ad9efcc 
Dealt to 993f1f71 
Dealt to b57f88ab 
Dealt to 832c3754 
Dealt to Hero [Qc 6c]
Dealt to 79eaf66f 
832c3754: folds
Hero: folds
79eaf66f: folds
9ad9efcc: raises $0.05 to $0.1
993f1f71: calls $0.08
b57f88ab: calls $0.05
*** FLOP *** [7c Qs 6h]
993f1f71: checks
b57f88ab: checks
9ad9efcc: bets $0.1
993f1f71: folds
b57f88ab: folds
Uncalled bet ($0.1) returned to 9ad9efcc
*** SHOWDOWN ***
9ad9efcc collected $0.29 from pot
*** SUMMARY ***
Total pot $0.3 | Rake $0.01 | Jackpot $0 | Bingo $0 | Fortune $0
Board [7c Qs 6h]
Seat 1: 9ad9efcc (button) won ($0.29)
Seat 2: 993f1f71 (small blind) folded on the Flop
Seat 3: b57f88ab (big blind) folded on the Flop
Seat 4: 832c3754 folded before Flop (didn't bet)
Seat 5: Hero folded before Flop (didn't bet)
Seat 6: 79eaf66f folded before Flop (didn't bet)


Poker Hand #HD1181511213: Hold'em No Limit  ($0.02/$0.05) - 2023/03/29 21:22:10
Table 'NLHBlue66' 6-max Seat #6 is the button
Seat 1: 9ad9efcc ($2.08 in chips)
Seat 2: 993f1f71 ($1.43 in chips)
Seat 4: 832c3754 ($5.05 in chips)
Seat 5: Hero ($6.1 in chips)
Seat 6: 79eaf66f ($5 in chips)
9ad9efcc: posts small blind $0.02
993f1f71: posts big blind $0.05
*** HOLE CARDS ***
Dealt to 9ad9efcc 
Dealt to 993f1f71 
Dealt to 832c3754 
Dealt to Hero [8c Ac]
Dealt to 79eaf66f 
832c3754: folds
Hero: raises $0.07 to $0.12
79eaf66f: folds
9ad9efcc: folds
993f1f71: calls $0.07
*** FLOP *** [Qs 2c Ah]
993f1f71: checks
Hero: bets $0.13
993f1f71: folds
Uncalled bet ($0.13) returned to Hero
*** SHOWDOWN ***
Hero collected $0.25 from pot
*** SUMMARY ***
Total pot $0.26 | Rake $0.01 | Jackpot $0 | Bingo $0 | Fortune $0
Board [Qs 2c Ah]
Seat 1: 9ad9efcc (small blind) folded before Flop
Seat 2: 993f1f71 (big blind) folded on the Flop
Seat 4: 832c3754 folded before Flop (didn't bet)
Seat 5: Hero won ($0.25)
Seat 6: 79eaf66f (button) folded before Flop (didn't bet)


Poker Hand #HD1181511119: Hold'em No Limit  ($0.02/$0.05) - 2023/03/29 21:21:28
Table 'NLHBlue66' 6-max Seat #5 is the button
Seat 1: 9ad9efcc ($1.71 in chips)
Seat 2: 993f1f71 ($1.82 in chips)
Seat 4: 832c3754 ($5.05 in chips)
Seat 5: Hero ($6.1 in chips)
Seat 6: 79eaf66f ($5 in chips)
79eaf66f: posts small blind $0.02
9ad9efcc: posts big blind $0.05
*** HOLE CARDS ***
Dealt to 9ad9efcc 
Dealt to 993f1f71 
Dealt to 832c3754 
Dealt to Hero [5h 3c]
Dealt to 79eaf66f 
993f1f71: calls $0.05
832c3754: folds
Hero: folds
79eaf66f: folds
9ad9efcc: raises $0.06 to $0.11
993f1f71: calls $0.06
*** FLOP *** [Kd Kh 6h]
9ad9efcc: checks
993f1f71: checks
*** TURN *** [Kd Kh 6h] [Qc]
9ad9efcc: bets $0.08
993f1f71: calls $0.08
*** RIVER *** [Kd Kh 6h Qc] [9c]
9ad9efcc: bets $0.2
993f1f71: calls $0.2
9ad9efcc: shows [Ks 8c] (Three Kings)
993f1f71: shows [Qd Th] (Pair of Kings and Pair of Queens)
*** SHOWDOWN ***
9ad9efcc collected $0.76 from pot
*** SUMMARY ***
Total pot $0.8 | Rake $0.04 | Jackpot $0 | Bingo $0 | Fortune $0
Board [Kd Kh 6h Qc 9c]
Seat 1: 9ad9efcc (big blind) showed [Ks 8c] and won ($0.76) with Three Kings
Seat 2: 993f1f71 showed [Qd Th] and lost with Pair of Kings and Pair of Queens
Seat 4: 832c3754 folded before Flop (didn't bet)
Seat 5: Hero (button) folded before Flop (didn't bet)
Seat 6: 79eaf66f (small blind) folded before Flop


Poker Hand #HD1181511025: Hold'em No Limit  ($0.02/$0.05) - 2023/03/29 21:20:39
Table 'NLHBlue66' 6-max Seat #4 is the button
Seat 1: 9ad9efcc ($1.71 in chips)
Seat 2: 993f1f71 ($1.81 in chips)
Seat 4: 832c3754 ($5.05 in chips)
Seat 5: Hero ($6.12 in chips)
Seat 6: 79eaf66f ($5 in chips)
Hero: posts small blind $0.02
79eaf66f: posts big blind $0.05
993f1f71: posts big blind $0.05
*** HOLE CARDS ***
Dealt to 9ad9efcc 
Dealt to 993f1f71 
Dealt to 832c3754 
Dealt to Hero [3h 9d]
Dealt to 79eaf66f 
9ad9efcc: folds
993f1f71: checks
832c3754: raises $0.17 to $0.22
Hero: folds
79eaf66f: folds
993f1f71: calls $0.17
*** FLOP *** [7c 3s 5c]
993f1f71: checks
832c3754: checks
*** TURN *** [7c 3s 5c] [2d]
993f1f71: checks
832c3754: checks
*** RIVER *** [7c 3s 5c 2d] [4s]
993f1f71: checks
832c3754: bets $0.4
993f1f71: calls $0.4
832c3754: shows [Qs Ad] (Fives-High Straight)
993f1f71: shows [Qh Ac] (Fives-High Straight)
*** SHOWDOWN ***
993f1f71 collected $0.63 from pot
832c3754 collected $0.62 from pot
*** SUMMARY ***
Total pot $1.31 | Rake $0.06 | Jackpot $0 | Bingo $0 | Fortune $0
Board [7c 3s 5c 2d 4s]
Seat 1: 9ad9efcc folded before Flop (didn't bet)
Seat 2: 993f1f71 showed [Qh Ac] and won ($0.63) with Fives-High Straight
Seat 4: 832c3754 (button) showed [Qs Ad] and won ($0.62) with Fives-High Straight
Seat 5: Hero (small blind) folded before Flop
Seat 6: 79eaf66f (big blind) folded before Flop


Poker Hand #HD1181510984: Hold'em No Limit  ($0.02/$0.05) - 2023/03/29 21:20:22
Table 'NLHBlue66' 6-max Seat #1 is the button
Seat 1: 9ad9efcc ($1.71 in chips)
Seat 4: 832c3754 ($5 in chips)
Seat 5: Hero ($6.17 in chips)
832c3754: posts small blind $0.02
Hero: posts big blind $0.05
*** HOLE CARDS ***
Dealt to 9ad9efcc 
Dealt to 832c3754 
Dealt to Hero [Ks 4c]
9ad9efcc: folds
832c3754: raises $0.07 to $0.12
Hero: folds
Uncalled bet ($0.07) returned to 832c3754
*** SHOWDOWN ***
832c3754 collected $0.1 from pot
*** SUMMARY ***
Total pot $0.1 | Rake $0 | Jackpot $0 | Bingo $0 | Fortune $0
Seat 1: 9ad9efcc (button) folded before Flop (didn't bet)
Seat 4: 832c3754 (small blind) collected ($0.1)
Seat 5: Hero (big blind) folded before Flop


Poker Hand #HD1181510946: Hold'em No Limit  ($0.02/$0.05) - 2023/03/29 21:20:02
Table 'NLHBlue66' 6-max Seat #6 is the button
Seat 1: 9ad9efcc ($1.73 in chips)
Seat 4: 832c3754 ($5 in chips)
Seat 5: Hero ($6.1 in chips)
Seat 6: 2421c45c ($5.51 in chips)
9ad9efcc: posts small blind $0.02
832c3754: posts big blind $0.05
*** HOLE CARDS ***
Dealt to 9ad9efcc 
Dealt to 832c3754 
Dealt to Hero [Tc Td]
Dealt to 2421c45c 
Hero: raises $0.07 to $0.12
2421c45c: folds
9ad9efcc: folds
832c3754: folds
Uncalled bet ($0.07) returned to Hero
*** SHOWDOWN ***
Hero collected $0.12 from pot
*** SUMMARY ***
Total pot $0.12 | Rake $0 | Jackpot $0 | Bingo $0 | Fortune $0
Seat 1: 9ad9efcc (small blind) folded before Flop
Seat 4: 832c3754 (big blind) folded before Flop
Seat 5: Hero collected ($0.12)
Seat 6: 2421c45c (button) folded before Flop (didn't bet)


Poker Hand #HD1181510866: Hold'em No Limit  ($0.02/$0.05) - 2023/03/29 21:19:13
Table 'NLHBlue66' 6-max Seat #5 is the button
Seat 1: 9ad9efcc ($1.78 in chips)
Seat 4: 832c3754 ($5 in chips)
Seat 5: Hero ($6.51 in chips)
Seat 6: 2421c45c ($5.09 in chips)
2421c45c: posts small blind $0.02
9ad9efcc: posts big blind $0.05
*** HOLE CARDS ***
Dealt to 9ad9efcc 
Dealt to 832c3754 
Dealt to Hero [Js As]
Dealt to 2421c45c 
832c3754: folds
Hero: raises $0.07 to $0.12
2421c45c: raises $0.29 to $0.41
9ad9efcc: folds
Hero: calls $0.29
*** FLOP *** [2c Tc 4h]
2421c45c: bets $0.5
Hero: folds
Uncalled bet ($0.5) returned to 2421c45c
*** SHOWDOWN ***
2421c45c collected $0.83 from pot
*** SUMMARY ***
Total pot $0.87 | Rake $0.04 | Jackpot $0 | Bingo $0 | Fortune $0
Board [2c Tc 4h]
Seat 1: 9ad9efcc (big blind) folded before Flop
Seat 4: 832c3754 folded before Flop (didn't bet)
Seat 5: Hero (button) folded on the Flop
Seat 6: 2421c45c (small blind) won ($0.83)


Poker Hand #HD1181510810: Hold'em No Limit  ($0.02/$0.05) - 2023/03/29 21:18:47
Table 'NLHBlue66' 6-max Seat #4 is the button
Seat 1: 9ad9efcc ($1.93 in chips)
Seat 4: 832c3754 ($5 in chips)
Seat 5: Hero ($6.32 in chips)
Seat 6: 2421c45c ($5.14 in chips)
Hero: posts small blind $0.02
2421c45c: posts big blind $0.05
*** HOLE CARDS ***
Dealt to 9ad9efcc 
Dealt to 832c3754 
Dealt to Hero [Qh Ac]
Dealt to 2421c45c 
9ad9efcc: raises $0.1 to $0.15
832c3754: folds
Hero: raises $0.47 to $0.62
2421c45c: folds
9ad9efcc: folds
Uncalled bet ($0.47) returned to Hero
*** SHOWDOWN ***
Hero collected $0.34 from pot
*** SUMMARY ***
Total pot $0.35 | Rake $0.01 | Jackpot $0 | Bingo $0 | Fortune $0
Seat 1: 9ad9efcc folded before Flop
Seat 4: 832c3754 (button) folded before Flop (didn't bet)
Seat 5: Hero (small blind) collected ($0.34)
Seat 6: 2421c45c (big blind) folded before Flop


Poker Hand #HD1181510789: Hold'em No Limit  ($0.02/$0.05) - 2023/03/29 21:18:34
Table 'NLHBlue66' 6-max Seat #1 is the button
Seat 1: 9ad9efcc ($1.86 in chips)
Seat 4: 832c3754 ($5 in chips)
Seat 5: Hero ($6.37 in chips)
Seat 6: 2421c45c ($5.14 in chips)
832c3754: posts small blind $0.02
Hero: posts big blind $0.05
*** HOLE CARDS ***
Dealt to 9ad9efcc 
Dealt to 832c3754 
Dealt to Hero [3d Td]
Dealt to 2421c45c 
2421c45c: folds
9ad9efcc: raises $0.1 to $0.15
832c3754: folds
Hero: folds
Uncalled bet ($0.1) returned to 9ad9efcc
*** SHOWDOWN ***
9ad9efcc collected $0.12 from pot
*** SUMMARY ***
Total pot $0.12 | Rake $0 | Jackpot $0 | Bingo $0 | Fortune $0
Seat 1: 9ad9efcc (button) collected ($0.12)
Seat 4: 832c3754 (small blind) folded before Flop
Seat 5: Hero (big blind) folded before Flop
Seat 6: 2421c45c folded before Flop (didn't bet)


Poker Hand #HD1181510719: Hold'em No Limit  ($0.02/$0.05) - 2023/03/29 21:18:00
Table 'NLHBlue66' 6-max Seat #6 is the button
Seat 1: 9ad9efcc ($1.88 in chips)
Seat 4: 832c3754 ($5 in chips)
Seat 5: Hero ($6.37 in chips)
Seat 6: 2421c45c ($5 in chips)
9ad9efcc: posts small blind $0.02
832c3754: posts big blind $0.05
*** HOLE CARDS ***
Dealt to 9ad9efcc 
Dealt to 832c3754 
Dealt to Hero [6s 8c]
Dealt to 2421c45c 
Hero: folds
2421c45c: raises $0.08 to $0.13
9ad9efcc: folds
832c3754: calls $0.08
*** FLOP *** [6d 7s Kd]
832c3754: checks
2421c45c: bets $0.16
832c3754: folds
Uncalled bet ($0.16) returned to 2421c45c
*** SHOWDOWN ***
2421c45c collected $0.27 from pot
*** SUMMARY ***
Total pot $0.28 | Rake $0.01 | Jackpot $0 | Bingo $0 | Fortune $0
Board [6d 7s Kd]
Seat 1: 9ad9efcc (small blind) folded before Flop
Seat 4: 832c3754 (big blind) folded on the Flop
Seat 5: Hero folded before Flop (didn't bet)
Seat 6: 2421c45c (button) won ($0.27)


Poker Hand #HD1181510708: Hold'em No Limit  ($0.02/$0.05) - 2023/03/29 21:17:51
Table 'NLHBlue66' 6-max Seat #5 is the button
Seat 1: 9ad9efcc ($1.86 in chips)
Seat 4: 832c3754 ($5 in chips)
Seat 5: Hero ($6.37 in chips)
Seat 6: 2421c45c ($5 in chips)
2421c45c: posts small blind $0.02
9ad9efcc: posts big blind $0.05
*** HOLE CARDS ***
Dealt to 9ad9efcc 
Dealt to 832c3754 
Dealt to Hero [7d Kh]
Dealt to 2421c45c 
832c3754: folds
Hero: folds
2421c45c: folds
Uncalled bet ($0.03) returned to 9ad9efcc
*** SHOWDOWN ***
9ad9efcc collected $0.04 from pot
*** SUMMARY ***
Total pot $0.04 | Rake $0 | Jackpot $0 | Bingo $0 | Fortune $0
Seat 1: 9ad9efcc (big blind) collected ($0.04)
Seat 4: 832c3754 folded before Flop (didn't bet)
Seat 5: Hero (button) folded before Flop (didn't bet)
Seat 6: 2421c45c (small blind) folded before Flop


Poker Hand #HD1181510595: Hold'em No Limit  ($0.02/$0.05) - 2023/03/29 21:16:52
Table 'NLHBlue66' 6-max Seat #4 is the button
Seat 1: 9ad9efcc ($1.86 in chips)
Seat 4: 832c3754 ($5 in chips)
Seat 5: Hero ($5.44 in chips)
Seat 6: 2421c45c ($5 in chips)
Hero: posts small blind $0.02
2421c45c: posts big blind $0.05
*** HOLE CARDS ***
Dealt to 9ad9efcc 
Dealt to 832c3754 
Dealt to Hero [5c Ah]
Dealt to 2421c45c 
9ad9efcc: folds
832c3754: folds
Hero: raises $0.09 to $0.14
2421c45c: calls $0.09
*** FLOP *** [8d Ac 6d]
Hero: bets $0.1
2421c45c: calls $0.1
*** TURN *** [8d Ac 6d] [2s]
Hero: bets $0.24
2421c45c: calls $0.24
*** RIVER *** [8d Ac 6d 2s] [5s]
Hero: checks
2421c45c: bets $0.6
Hero: raises $0.86 to $1.46
2421c45c: folds
Uncalled bet ($0.86) returned to Hero
*** SHOWDOWN ***
Hero collected $2.01 from pot
*** SUMMARY ***
Total pot $2.16 | Rake $0.1 | Jackpot $0.05 | Bingo $0 | Fortune $0
Board [8d Ac 6d 2s 5s]
Seat 1: 9ad9efcc folded before Flop (didn't bet)
Seat 4: 832c3754 (button) folded before Flop (didn't bet)
Seat 5: Hero (small blind) won ($2.01)
Seat 6: 2421c45c (big blind) folded on the River


Poker Hand #HD1181510467: Hold'em No Limit  ($0.02/$0.05) - 2023/03/29 21:15:38
Table 'NLHBlue66' 6-max Seat #1 is the button
Seat 1: 9ad9efcc ($2.01 in chips)
Seat 4: 832c3754 ($5.32 in chips)
Seat 5: Hero ($5 in chips)
832c3754: posts small blind $0.02
Hero: posts big blind $0.05
*** HOLE CARDS ***
Dealt to 9ad9efcc 
Dealt to 832c3754 
Dealt to Hero [Td Kh]
9ad9efcc: raises $0.1 to $0.15
832c3754: calls $0.13
Hero: calls $0.1
*** FLOP *** [Th 6c Kc]
832c3754: bets $0.18
Hero: raises $0.54 to $0.72
9ad9efcc: folds
832c3754: folds
Uncalled bet ($0.54) returned to Hero
*** SHOWDOWN ***
Hero collected $0.77 from pot
*** SUMMARY ***
Total pot $0.81 | Rake $0.04 | Jackpot $0 | Bingo $0 | Fortune $0
Board [Th 6c Kc]
Seat 1: 9ad9efcc (button) folded on the Flop
Seat 4: 832c3754 (small blind) folded on the Flop
Seat 5: Hero (big blind) won ($0.77)


