Poker Hand #HD1205736061: Hold'em No Limit  ($0.02/$0.05) - 2023/04/16 20:01:27
Table 'NLHBlue44' 6-max Seat #5 is the button
Seat 1: ca05a803 ($5.15 in chips)
Seat 2: Hero ($5.37 in chips)
Seat 3: 87e538b0 ($5.05 in chips)
Seat 4: 8200d36c ($16.76 in chips)
Seat 5: 2dc220b ($9.5 in chips)
Seat 6: 428456c9 ($5.5 in chips)
428456c9: posts small blind $0.02
ca05a803: posts big blind $0.05
*** HOLE CARDS ***
Dealt to ca05a803 
Dealt to Hero [5h 7h]
Dealt to 87e538b0 
Dealt to 8200d36c 
Dealt to 2dc220b 
Dealt to 428456c9 
Hero: folds
87e538b0: folds
8200d36c: raises $0.05 to $0.1
2dc220b: folds
428456c9: folds
ca05a803: calls $0.05
*** FLOP *** [4d 6c 7c]
ca05a803: checks
8200d36c: bets $0.11
ca05a803: folds
Uncalled bet ($0.11) returned to 8200d36c
*** SHOWDOWN ***
8200d36c collected $0.21 from pot
*** SUMMARY ***
Total pot $0.22 | Rake $0.01 | Jackpot $0 | Bingo $0 | Fortune $0
Board [4d 6c 7c]
Seat 1: ca05a803 (big blind) folded on the Flop
Seat 2: Hero folded before Flop (didn't bet)
Seat 3: 87e538b0 folded before Flop (didn't bet)
Seat 4: 8200d36c won ($0.21)
Seat 5: 2dc220b (button) folded before Flop (didn't bet)
Seat 6: 428456c9 (small blind) folded before Flop


Poker Hand #HD1205735952: Hold'em No Limit  ($0.02/$0.05) - 2023/04/16 20:00:14
Table 'NLHBlue44' 6-max Seat #4 is the button
Seat 1: ca05a803 ($5.15 in chips)
Seat 2: Hero ($5.37 in chips)
Seat 3: 87e538b0 ($5.05 in chips)
Seat 4: 8200d36c ($21.76 in chips)
Seat 5: 2dc220b ($5 in chips)
Seat 6: 428456c9 ($5.55 in chips)
2dc220b: posts small blind $0.02
428456c9: posts big blind $0.05
*** HOLE CARDS ***
Dealt to ca05a803 
Dealt to Hero [3d 4d]
Dealt to 87e538b0 
Dealt to 8200d36c 
Dealt to 2dc220b 
Dealt to 428456c9 
ca05a803: folds
Hero: folds
87e538b0: folds
8200d36c: raises $0.1 to $0.15
2dc220b: raises $0.45 to $0.6
428456c9: folds
8200d36c: calls $0.45
*** FLOP *** [3s Jh 9c]
2dc220b: bets $0.42
8200d36c: calls $0.42
*** TURN *** [3s Jh 9c] [6h]
2dc220b: checks
8200d36c: bets $2.09
2dc220b: raises $1.89 to $3.98 and is all-in
8200d36c: calls $1.89
2dc220b: shows [Jd Jc] (Three Jacks)
8200d36c: shows [8h 7h] (Jack-High)
*** FIRST RIVER *** [3s Jh 9c 6h] [Kd]
*** SECOND RIVER *** [3s Jh 9c 6h] [8d]
*** FIRST SHOWDOWN ***
2dc220b collected $4.75 from pot
*** SECOND SHOWDOWN ***
2dc220b collected $4.75 from pot
*** SUMMARY ***
Total pot $10.05 | Rake $0.5 | Jackpot $0.05 | Bingo $0 | Fortune $0
Hand was run two times
FIRST Board [3s Jh 9c 6h Kd]
SECOND Board [8d]
Seat 1: ca05a803 folded before Flop (didn't bet)
Seat 2: Hero folded before Flop (didn't bet)
Seat 3: 87e538b0 folded before Flop (didn't bet)
Seat 4: 8200d36c (button) showed [8h 7h] and lost with King-High, and lost
Seat 5: 2dc220b (small blind) showed [Jd Jc] and won ($4.75) with Three Jacks, and won ($4.75)
Seat 6: 428456c9 (big blind) folded before Flop


Poker Hand #HD1205735932: Hold'em No Limit  ($0.02/$0.05) - 2023/04/16 20:00:01
Table 'NLHBlue44' 6-max Seat #3 is the button
Seat 1: ca05a803 ($5.15 in chips)
Seat 2: Hero ($5.37 in chips)
Seat 3: 87e538b0 ($5.05 in chips)
Seat 4: 8200d36c ($21.71 in chips)
Seat 5: 2dc220b ($5 in chips)
Seat 6: 428456c9 ($5.55 in chips)
8200d36c: posts small blind $0.02
2dc220b: posts big blind $0.05
*** HOLE CARDS ***
Dealt to ca05a803 
Dealt to Hero [9d 4s]
Dealt to 87e538b0 
Dealt to 8200d36c 
Dealt to 2dc220b 
Dealt to 428456c9 
428456c9: folds
ca05a803: folds
Hero: folds
87e538b0: folds
8200d36c: raises $0.05 to $0.1
2dc220b: folds
Uncalled bet ($0.05) returned to 8200d36c
*** SHOWDOWN ***
8200d36c collected $0.1 from pot
*** SUMMARY ***
Total pot $0.1 | Rake $0 | Jackpot $0 | Bingo $0 | Fortune $0
Seat 1: ca05a803 folded before Flop (didn't bet)
Seat 2: Hero folded before Flop (didn't bet)
Seat 3: 87e538b0 (button) folded before Flop (didn't bet)
Seat 4: 8200d36c (small blind) collected ($0.1)
Seat 5: 2dc220b (big blind) folded before Flop
Seat 6: 428456c9 folded before Flop (didn't bet)


Poker Hand #HD1205735906: Hold'em No Limit  ($0.02/$0.05) - 2023/04/16 19:59:42
Table 'NLHBlue44' 6-max Seat #2 is the button
Seat 1: ca05a803 ($5.15 in chips)
Seat 2: Hero ($5.37 in chips)
Seat 3: 87e538b0 ($5 in chips)
Seat 4: 8200d36c ($21.76 in chips)
Seat 5: 2dc220b ($5 in chips)
Seat 6: 428456c9 ($5.55 in chips)
87e538b0: posts small blind $0.02
8200d36c: posts big blind $0.05
*** HOLE CARDS ***
Dealt to ca05a803 
Dealt to Hero [Qh 8s]
Dealt to 87e538b0 
Dealt to 8200d36c 
Dealt to 2dc220b 
Dealt to 428456c9 
2dc220b: folds
428456c9: folds
ca05a803: folds
Hero: folds
87e538b0: raises $0.09 to $0.14
8200d36c: folds
Uncalled bet ($0.09) returned to 87e538b0
*** SHOWDOWN ***
87e538b0 collected $0.1 from pot
*** SUMMARY ***
Total pot $0.1 | Rake $0 | Jackpot $0 | Bingo $0 | Fortune $0
Seat 1: ca05a803 folded before Flop (didn't bet)
Seat 2: Hero (button) folded before Flop (didn't bet)
Seat 3: 87e538b0 (small blind) collected ($0.1)
Seat 4: 8200d36c (big blind) folded before Flop
Seat 5: 2dc220b folded before Flop (didn't bet)
Seat 6: 428456c9 folded before Flop (didn't bet)


Poker Hand #HD1205735833: Hold'em No Limit  ($0.02/$0.05) - 2023/04/16 19:59:02
Table 'NLHBlue44' 6-max Seat #1 is the button
Seat 1: ca05a803 ($5.15 in chips)
Seat 2: Hero ($5 in chips)
Seat 3: 87e538b0 ($5 in chips)
Seat 4: 8200d36c ($21.96 in chips)
Seat 5: 2dc220b ($5 in chips)
Seat 6: 428456c9 ($5.55 in chips)
Hero: posts small blind $0.02
87e538b0: posts big blind $0.05
*** HOLE CARDS ***
Dealt to ca05a803 
Dealt to Hero [9h 9c]
Dealt to 87e538b0 
Dealt to 8200d36c 
Dealt to 2dc220b 
Dealt to 428456c9 
8200d36c: raises $0.15 to $0.2
2dc220b: folds
428456c9: folds
ca05a803: folds
Hero: calls $0.18
87e538b0: calls $0.15
*** FLOP *** [9s Qd Jh]
Hero: checks
87e538b0: checks
8200d36c: checks
*** TURN *** [9s Qd Jh] [5h]
Hero: bets $0.45
87e538b0: folds
8200d36c: folds
Uncalled bet ($0.45) returned to Hero
*** SHOWDOWN ***
Hero collected $0.57 from pot
*** SUMMARY ***
Total pot $0.6 | Rake $0.03 | Jackpot $0 | Bingo $0 | Fortune $0
Board [9s Qd Jh 5h]
Seat 1: ca05a803 (button) folded before Flop (didn't bet)
Seat 2: Hero (small blind) won ($0.57)
Seat 3: 87e538b0 (big blind) folded on the Turn
Seat 4: 8200d36c folded on the Turn
Seat 5: 2dc220b folded before Flop (didn't bet)
Seat 6: 428456c9 folded before Flop (didn't bet)


Poker Hand #HD1205735814: Hold'em No Limit  ($0.02/$0.05) - 2023/04/16 19:58:47
Table 'NLHBlue44' 6-max Seat #6 is the button
Seat 1: ca05a803 ($5.17 in chips)
Seat 2: Hero ($5 in chips)
Seat 3: 87e538b0 ($5 in chips)
Seat 4: 8200d36c ($21.89 in chips)
Seat 5: 2dc220b ($5 in chips)
Seat 6: 428456c9 ($5.55 in chips)
ca05a803: posts small blind $0.02
Hero: posts big blind $0.05
*** HOLE CARDS ***
Dealt to ca05a803 
Dealt to Hero [5s 9h]
Dealt to 87e538b0 
Dealt to 8200d36c 
Dealt to 2dc220b 
Dealt to 428456c9 
87e538b0: folds
8200d36c: raises $0.1 to $0.15
2dc220b: folds
428456c9: folds
ca05a803: folds
Hero: folds
Uncalled bet ($0.1) returned to 8200d36c
*** SHOWDOWN ***
8200d36c collected $0.12 from pot
*** SUMMARY ***
Total pot $0.12 | Rake $0 | Jackpot $0 | Bingo $0 | Fortune $0
Seat 1: ca05a803 (small blind) folded before Flop
Seat 2: Hero (big blind) folded before Flop
Seat 3: 87e538b0 folded before Flop (didn't bet)
Seat 4: 8200d36c collected ($0.12)
Seat 5: 2dc220b folded before Flop (didn't bet)
Seat 6: 428456c9 (button) folded before Flop (didn't bet)


Poker Hand #HD1205735805: Hold'em No Limit  ($0.02/$0.05) - 2023/04/16 19:58:37
Table 'NLHBlue44' 6-max Seat #5 is the button
Seat 1: ca05a803 ($5.22 in chips)
Seat 2: Hero ($5 in chips)
Seat 4: 8200d36c ($21.82 in chips)
Seat 5: 2dc220b ($5 in chips)
Seat 6: 428456c9 ($5.57 in chips)
428456c9: posts small blind $0.02
ca05a803: posts big blind $0.05
*** HOLE CARDS ***
Dealt to ca05a803 
Dealt to Hero [Qs 4s]
Dealt to 8200d36c 
Dealt to 2dc220b 
Dealt to 428456c9 
Hero: folds
8200d36c: raises $0.05 to $0.1
2dc220b: folds
428456c9: folds
ca05a803: folds
Uncalled bet ($0.05) returned to 8200d36c
*** SHOWDOWN ***
8200d36c collected $0.12 from pot
*** SUMMARY ***
Total pot $0.12 | Rake $0 | Jackpot $0 | Bingo $0 | Fortune $0
Seat 1: ca05a803 (big blind) folded before Flop
Seat 2: Hero folded before Flop (didn't bet)
Seat 4: 8200d36c collected ($0.12)
Seat 5: 2dc220b (button) folded before Flop (didn't bet)
Seat 6: 428456c9 (small blind) folded before Flop


Poker Hand #HD1205735752: Hold'em No Limit  ($0.02/$0.05) - 2023/04/16 19:58:01
Table 'NLHBlue44' 6-max Seat #4 is the button
Seat 1: ca05a803 ($5 in chips)
Seat 2: Hero ($5 in chips)
Seat 4: 8200d36c ($21.99 in chips)
Seat 5: 2dc220b ($5 in chips)
Seat 6: 428456c9 ($5.62 in chips)
2dc220b: posts small blind $0.02
428456c9: posts big blind $0.05
*** HOLE CARDS ***
Dealt to ca05a803 
Dealt to Hero [2h 5d]
Dealt to 8200d36c 
Dealt to 2dc220b 
Dealt to 428456c9 
ca05a803: raises $0.06 to $0.11
Hero: folds
8200d36c: raises $0.06 to $0.17
2dc220b: folds
428456c9: folds
ca05a803: raises $0.63 to $0.8
8200d36c: folds
Uncalled bet ($0.63) returned to ca05a803
*** SHOWDOWN ***
ca05a803 collected $0.39 from pot
*** SUMMARY ***
Total pot $0.41 | Rake $0.02 | Jackpot $0 | Bingo $0 | Fortune $0
Seat 1: ca05a803 collected ($0.39)
Seat 2: Hero folded before Flop (didn't bet)
Seat 4: 8200d36c (button) folded before Flop
Seat 5: 2dc220b (small blind) folded before Flop
Seat 6: 428456c9 (big blind) folded before Flop


Poker Hand #HD1205635586: Hold'em No Limit  ($0.02/$0.05) - 2023/04/16 19:56:13
Table 'NLHBlue44' 6-max Seat #2 is the button
Seat 1: ca05a803 ($5 in chips)
Seat 2: Hero ($5.15 in chips)
Seat 3: 87e538b0 ($5 in chips)
Seat 4: 8200d36c ($20.08 in chips)
Seat 5: 2dc220b ($5 in chips)
Seat 6: 428456c9 ($5.62 in chips)
87e538b0: posts small blind $0.02
8200d36c: posts big blind $0.05
*** HOLE CARDS ***
Dealt to ca05a803 
Dealt to Hero [Ac 4d]
Dealt to 87e538b0 
Dealt to 8200d36c 
Dealt to 2dc220b 
Dealt to 428456c9 
2dc220b: folds
428456c9: folds
ca05a803: folds
Hero: raises $0.07 to $0.12
87e538b0: folds
8200d36c: calls $0.07
*** FLOP *** [5d 3h 9h]
8200d36c: bets $0.13
Hero: raises $0.23 to $0.36
8200d36c: raises $0.23 to $0.59
Hero: calls $0.23
*** TURN *** [5d 3h 9h] [6c]
8200d36c: bets $1.44
Hero: calls $1.44
*** RIVER *** [5d 3h 9h 6c] [Js]
8200d36c: bets $2.16
Hero: folds
Uncalled bet ($2.16) returned to 8200d36c
*** SHOWDOWN ***
8200d36c collected $4.06 from pot
*** SUMMARY ***
Total pot $4.32 | Rake $0.21 | Jackpot $0.05 | Bingo $0 | Fortune $0
Board [5d 3h 9h 6c Js]
Seat 1: ca05a803 folded before Flop (didn't bet)
Seat 2: Hero (button) folded on the River
Seat 3: 87e538b0 (small blind) folded before Flop
Seat 4: 8200d36c (big blind) won ($4.06)
Seat 5: 2dc220b folded before Flop (didn't bet)
Seat 6: 428456c9 folded before Flop (didn't bet)


Poker Hand #HD1205635442: Hold'em No Limit  ($0.02/$0.05) - 2023/04/16 19:54:36
Table 'NLHBlue44' 6-max Seat #1 is the button
Seat 1: ca05a803 ($5.16 in chips)
Seat 2: Hero ($5.17 in chips)
Seat 3: 87e538b0 ($5 in chips)
Seat 4: 8200d36c ($19.46 in chips)
Seat 5: 2dc220b ($5 in chips)
Seat 6: 428456c9 ($5.62 in chips)
Hero: posts small blind $0.02
87e538b0: posts big blind $0.05
*** HOLE CARDS ***
Dealt to ca05a803 
Dealt to Hero [3d 7h]
Dealt to 87e538b0 
Dealt to 8200d36c 
Dealt to 2dc220b 
Dealt to 428456c9 
8200d36c: calls $0.05
2dc220b: folds
428456c9: folds
ca05a803: raises $0.15 to $0.2
Hero: folds
87e538b0: folds
8200d36c: raises $0.15 to $0.35
ca05a803: calls $0.15
*** FLOP *** [4h Js 6c]
8200d36c: bets $0.26
ca05a803: calls $0.26
*** TURN *** [4h Js 6c] [5c]
8200d36c: bets $0.8
ca05a803: folds
Uncalled bet ($0.8) returned to 8200d36c
*** SHOWDOWN ***
8200d36c collected $1.23 from pot
*** SUMMARY ***
Total pot $1.29 | Rake $0.06 | Jackpot $0 | Bingo $0 | Fortune $0
Board [4h Js 6c 5c]
Seat 1: ca05a803 (button) folded on the Turn
Seat 2: Hero (small blind) folded before Flop
Seat 3: 87e538b0 (big blind) folded before Flop
Seat 4: 8200d36c won ($1.23)
Seat 5: 2dc220b folded before Flop (didn't bet)
Seat 6: 428456c9 folded before Flop (didn't bet)


Poker Hand #HD1205635380: Hold'em No Limit  ($0.02/$0.05) - 2023/04/16 19:53:50
Table 'NLHBlue44' 6-max Seat #6 is the button
Seat 1: ca05a803 ($5.04 in chips)
Seat 2: Hero ($5.3 in chips)
Seat 4: 8200d36c ($19.46 in chips)
Seat 5: 2dc220b ($5 in chips)
Seat 6: 428456c9 ($5.62 in chips)
ca05a803: posts small blind $0.02
Hero: posts big blind $0.05
*** HOLE CARDS ***
Dealt to ca05a803 
Dealt to Hero [5h As]
Dealt to 8200d36c 
Dealt to 2dc220b 
Dealt to 428456c9 
8200d36c: folds
2dc220b: folds
428456c9: folds
ca05a803: raises $0.08 to $0.13
Hero: calls $0.08
*** FLOP *** [Ks Jh 7d]
ca05a803: bets $0.09
Hero: folds
Uncalled bet ($0.09) returned to ca05a803
*** SHOWDOWN ***
ca05a803 collected $0.25 from pot
*** SUMMARY ***
Total pot $0.26 | Rake $0.01 | Jackpot $0 | Bingo $0 | Fortune $0
Board [Ks Jh 7d]
Seat 1: ca05a803 (small blind) won ($0.25)
Seat 2: Hero (big blind) folded on the Flop
Seat 4: 8200d36c folded before Flop (didn't bet)
Seat 5: 2dc220b folded before Flop (didn't bet)
Seat 6: 428456c9 (button) folded before Flop (didn't bet)


Poker Hand #HD1205635349: Hold'em No Limit  ($0.02/$0.05) - 2023/04/16 19:53:30
Table 'NLHBlue44' 6-max Seat #5 is the button
Seat 1: ca05a803 ($5.09 in chips)
Seat 2: Hero ($5.3 in chips)
Seat 4: 8200d36c ($19.39 in chips)
Seat 5: 2dc220b ($5 in chips)
Seat 6: 428456c9 ($5.64 in chips)
428456c9: posts small blind $0.02
ca05a803: posts big blind $0.05
*** HOLE CARDS ***
Dealt to ca05a803 
Dealt to Hero [Kc 3d]
Dealt to 8200d36c 
Dealt to 2dc220b 
Dealt to 428456c9 
Hero: folds
8200d36c: raises $0.15 to $0.2
2dc220b: folds
428456c9: folds
ca05a803: folds
Uncalled bet ($0.15) returned to 8200d36c
*** SHOWDOWN ***
8200d36c collected $0.12 from pot
*** SUMMARY ***
Total pot $0.12 | Rake $0 | Jackpot $0 | Bingo $0 | Fortune $0
Seat 1: ca05a803 (big blind) folded before Flop
Seat 2: Hero folded before Flop (didn't bet)
Seat 4: 8200d36c collected ($0.12)
Seat 5: 2dc220b (button) folded before Flop (didn't bet)
Seat 6: 428456c9 (small blind) folded before Flop


Poker Hand #HD1205635269: Hold'em No Limit  ($0.02/$0.05) - 2023/04/16 19:52:39
Table 'NLHBlue44' 6-max Seat #4 is the button
Seat 1: ca05a803 ($5.26 in chips)
Seat 2: Hero ($5.3 in chips)
Seat 4: 8200d36c ($19.17 in chips)
Seat 5: 2dc220b ($5 in chips)
Seat 6: 428456c9 ($5.69 in chips)
2dc220b: posts small blind $0.02
428456c9: posts big blind $0.05
*** HOLE CARDS ***
Dealt to ca05a803 
Dealt to Hero [9d 3d]
Dealt to 8200d36c 
Dealt to 2dc220b 
Dealt to 428456c9 
ca05a803: raises $0.06 to $0.11
Hero: folds
8200d36c: raises $0.06 to $0.17
2dc220b: folds
428456c9: folds
ca05a803: calls $0.06
*** FLOP *** [5h Jd 9h]
ca05a803: checks
8200d36c: bets $0.41
ca05a803: folds
Uncalled bet ($0.41) returned to 8200d36c
*** SHOWDOWN ***
8200d36c collected $0.39 from pot
*** SUMMARY ***
Total pot $0.41 | Rake $0.02 | Jackpot $0 | Bingo $0 | Fortune $0
Board [5h Jd 9h]
Seat 1: ca05a803 folded on the Flop
Seat 2: Hero folded before Flop (didn't bet)
Seat 4: 8200d36c (button) won ($0.39)
Seat 5: 2dc220b (small blind) folded before Flop
Seat 6: 428456c9 (big blind) folded before Flop


Poker Hand #HD1205635159: Hold'em No Limit  ($0.02/$0.05) - 2023/04/16 19:51:26
Table 'NLHBlue44' 6-max Seat #2 is the button
Seat 1: ca05a803 ($5.05 in chips)
Seat 2: Hero ($5.3 in chips)
Seat 4: 8200d36c ($19.28 in chips)
Seat 5: 2dc220b ($5 in chips)
Seat 6: 428456c9 ($5.69 in chips)
8200d36c: posts small blind $0.02
2dc220b: posts big blind $0.05
*** HOLE CARDS ***
Dealt to ca05a803 
Dealt to Hero [Qc Th]
Dealt to 8200d36c 
Dealt to 2dc220b 
Dealt to 428456c9 
428456c9: folds
ca05a803: raises $0.06 to $0.11
Hero: folds
8200d36c: calls $0.09
2dc220b: calls $0.06
*** FLOP *** [8c 9c 9h]
8200d36c: checks
2dc220b: checks
ca05a803: checks
*** TURN *** [8c 9c 9h] [Jd]
8200d36c: checks
2dc220b: checks
ca05a803: checks
*** RIVER *** [8c 9c 9h Jd] [3d]
8200d36c: checks
2dc220b: checks
ca05a803: checks
8200d36c: shows [5s 3c] (Pair of Nines and Pair of Treys)
2dc220b: shows [7c 7d] (Pair of Nines and Pair of Sevens)
ca05a803: shows [8s Ts] (Pair of Nines and Pair of Eights)
*** SHOWDOWN ***
ca05a803 collected $0.32 from pot
*** SUMMARY ***
Total pot $0.33 | Rake $0.01 | Jackpot $0 | Bingo $0 | Fortune $0
Board [8c 9c 9h Jd 3d]
Seat 1: ca05a803 showed [8s Ts] and won ($0.32) with Pair of Nines and Pair of Eights
Seat 2: Hero (button) folded before Flop (didn't bet)
Seat 4: 8200d36c (small blind) showed [5s 3c] and lost with Pair of Nines and Pair of Treys
Seat 5: 2dc220b (big blind) showed [7c 7d] and lost with Pair of Nines and Pair of Sevens
Seat 6: 428456c9 folded before Flop (didn't bet)


Poker Hand #HD1205635139: Hold'em No Limit  ($0.02/$0.05) - 2023/04/16 19:51:12
Table 'NLHBlue44' 6-max Seat #1 is the button
Seat 1: ca05a803 ($5.05 in chips)
Seat 2: Hero ($5.25 in chips)
Seat 4: 8200d36c ($19.33 in chips)
Seat 5: 2dc220b ($5 in chips)
Seat 6: 428456c9 ($5.69 in chips)
Hero: posts small blind $0.02
8200d36c: posts big blind $0.05
*** HOLE CARDS ***
Dealt to ca05a803 
Dealt to Hero [Ac 2d]
Dealt to 8200d36c 
Dealt to 2dc220b 
Dealt to 428456c9 
2dc220b: folds
428456c9: folds
ca05a803: folds
Hero: raises $0.05 to $0.1
8200d36c: folds
Uncalled bet ($0.05) returned to Hero
*** SHOWDOWN ***
Hero collected $0.1 from pot
*** SUMMARY ***
Total pot $0.1 | Rake $0 | Jackpot $0 | Bingo $0 | Fortune $0
Seat 1: ca05a803 (button) folded before Flop (didn't bet)
Seat 2: Hero (small blind) collected ($0.1)
Seat 4: 8200d36c (big blind) folded before Flop
Seat 5: 2dc220b folded before Flop (didn't bet)
Seat 6: 428456c9 folded before Flop (didn't bet)


Poker Hand #HD1205635108: Hold'em No Limit  ($0.02/$0.05) - 2023/04/16 19:50:52
Table 'NLHBlue44' 6-max Seat #6 is the button
Seat 1: ca05a803 ($5 in chips)
Seat 2: Hero ($5.3 in chips)
Seat 3: 87e538b0 ($5 in chips)
Seat 5: 2dc220b ($5 in chips)
Seat 6: 428456c9 ($5.69 in chips)
ca05a803: posts small blind $0.02
Hero: posts big blind $0.05
*** HOLE CARDS ***
Dealt to ca05a803 
Dealt to Hero [5d 9s]
Dealt to 87e538b0 
Dealt to 2dc220b 
Dealt to 428456c9 
87e538b0: folds
2dc220b: folds
428456c9: folds
ca05a803: raises $0.08 to $0.13
Hero: folds
Uncalled bet ($0.08) returned to ca05a803
*** SHOWDOWN ***
ca05a803 collected $0.1 from pot
*** SUMMARY ***
Total pot $0.1 | Rake $0 | Jackpot $0 | Bingo $0 | Fortune $0
Seat 1: ca05a803 (small blind) collected ($0.1)
Seat 2: Hero (big blind) folded before Flop
Seat 3: 87e538b0 folded before Flop (didn't bet)
Seat 5: 2dc220b folded before Flop (didn't bet)
Seat 6: 428456c9 (button) folded before Flop (didn't bet)


Poker Hand #HD1205635067: Hold'em No Limit  ($0.02/$0.05) - 2023/04/16 19:50:29
Table 'NLHBlue44' 6-max Seat #5 is the button
Seat 1: ca05a803 ($5 in chips)
Seat 2: Hero ($5.3 in chips)
Seat 4: 8200d36c ($19.33 in chips)
Seat 5: 2dc220b ($5 in chips)
Seat 6: 428456c9 ($5.64 in chips)
428456c9: posts small blind $0.02
ca05a803: posts big blind $0.05
*** HOLE CARDS ***
Dealt to ca05a803 
Dealt to Hero [8h 4h]
Dealt to 8200d36c 
Dealt to 2dc220b 
Dealt to 428456c9 
Hero: folds
8200d36c: folds
2dc220b: folds
428456c9: raises $0.1 to $0.15
ca05a803: folds
Uncalled bet ($0.1) returned to 428456c9
*** SHOWDOWN ***
428456c9 collected $0.1 from pot
*** SUMMARY ***
Total pot $0.1 | Rake $0 | Jackpot $0 | Bingo $0 | Fortune $0
Seat 1: ca05a803 (big blind) folded before Flop
Seat 2: Hero folded before Flop (didn't bet)
Seat 4: 8200d36c folded before Flop (didn't bet)
Seat 5: 2dc220b (button) folded before Flop (didn't bet)
Seat 6: 428456c9 (small blind) collected ($0.1)


Poker Hand #HD1205635024: Hold'em No Limit  ($0.02/$0.05) - 2023/04/16 19:50:04
Table 'NLHBlue44' 6-max Seat #4 is the button
Seat 1: ca05a803 ($5 in chips)
Seat 2: Hero ($5.3 in chips)
Seat 3: 87e538b0 ($5 in chips)
Seat 4: 8200d36c ($19.33 in chips)
Seat 5: 2dc220b ($5 in chips)
Seat 6: 428456c9 ($5.62 in chips)
2dc220b: posts small blind $0.02
428456c9: posts big blind $0.05
*** HOLE CARDS ***
Dealt to ca05a803 
Dealt to Hero [3h As]
Dealt to 87e538b0 
Dealt to 8200d36c 
Dealt to 2dc220b 
Dealt to 428456c9 
ca05a803: folds
Hero: folds
87e538b0: folds
8200d36c: folds
2dc220b: folds
Uncalled bet ($0.03) returned to 428456c9
*** SHOWDOWN ***
428456c9 collected $0.04 from pot
*** SUMMARY ***
Total pot $0.04 | Rake $0 | Jackpot $0 | Bingo $0 | Fortune $0
Seat 1: ca05a803 folded before Flop (didn't bet)
Seat 2: Hero folded before Flop (didn't bet)
Seat 3: 87e538b0 folded before Flop (didn't bet)
Seat 4: 8200d36c (button) folded before Flop (didn't bet)
Seat 5: 2dc220b (small blind) folded before Flop
Seat 6: 428456c9 (big blind) collected ($0.04)


Poker Hand #HD1205634960: Hold'em No Limit  ($0.02/$0.05) - 2023/04/16 19:49:22
Table 'NLHBlue44' 6-max Seat #3 is the button
Seat 1: ca05a803 ($5 in chips)
Seat 2: Hero ($5.3 in chips)
Seat 3: 87e538b0 ($5 in chips)
Seat 4: 8200d36c ($19.28 in chips)
Seat 5: 2dc220b ($5 in chips)
Seat 6: 428456c9 ($5.62 in chips)
8200d36c: posts small blind $0.02
2dc220b: posts big blind $0.05
*** HOLE CARDS ***
Dealt to ca05a803 
Dealt to Hero [7d 9s]
Dealt to 87e538b0 
Dealt to 8200d36c 
Dealt to 2dc220b 
Dealt to 428456c9 
428456c9: folds
ca05a803: folds
Hero: folds
87e538b0: folds
8200d36c: calls $0.03
2dc220b: checks
*** FLOP *** [9h Kd 2d]
8200d36c: checks
2dc220b: checks
*** TURN *** [9h Kd 2d] [Ah]
8200d36c: bets $0.1
2dc220b: folds
Uncalled bet ($0.1) returned to 8200d36c
*** SHOWDOWN ***
8200d36c collected $0.1 from pot
*** SUMMARY ***
Total pot $0.1 | Rake $0 | Jackpot $0 | Bingo $0 | Fortune $0
Board [9h Kd 2d Ah]
Seat 1: ca05a803 folded before Flop (didn't bet)
Seat 2: Hero folded before Flop (didn't bet)
Seat 3: 87e538b0 (button) folded before Flop (didn't bet)
Seat 4: 8200d36c (small blind) won ($0.1)
Seat 5: 2dc220b (big blind) folded on the Turn
Seat 6: 428456c9 folded before Flop (didn't bet)


Poker Hand #HD1205634832: Hold'em No Limit  ($0.02/$0.05) - 2023/04/16 19:48:02
Table 'NLHBlue44' 6-max Seat #2 is the button
Seat 1: ca05a803 ($5 in chips)
Seat 2: Hero ($5.3 in chips)
Seat 3: 87e538b0 ($5.02 in chips)
Seat 4: 8200d36c ($19.33 in chips)
Seat 5: 2dc220b ($5 in chips)
Seat 6: 428456c9 ($5.55 in chips)
87e538b0: posts small blind $0.02
8200d36c: posts big blind $0.05
*** HOLE CARDS ***
Dealt to ca05a803 
Dealt to Hero [2h Qh]
Dealt to 87e538b0 
Dealt to 8200d36c 
Dealt to 2dc220b 
Dealt to 428456c9 
2dc220b: folds
428456c9: raises $0.1 to $0.15
ca05a803: folds
Hero: folds
87e538b0: folds
8200d36c: folds
Uncalled bet ($0.1) returned to 428456c9
*** SHOWDOWN ***
428456c9 collected $0.12 from pot
*** SUMMARY ***
Total pot $0.12 | Rake $0 | Jackpot $0 | Bingo $0 | Fortune $0
Seat 1: ca05a803 folded before Flop (didn't bet)
Seat 2: Hero (button) folded before Flop (didn't bet)
Seat 3: 87e538b0 (small blind) folded before Flop
Seat 4: 8200d36c (big blind) folded before Flop
Seat 5: 2dc220b folded before Flop (didn't bet)
Seat 6: 428456c9 collected ($0.12)


Poker Hand #HD1205634810: Hold'em No Limit  ($0.02/$0.05) - 2023/04/16 19:47:51
Table 'NLHBlue44' 6-max Seat #1 is the button
Seat 1: ca05a803 ($5 in chips)
Seat 2: Hero ($5.32 in chips)
Seat 3: 87e538b0 ($5 in chips)
Seat 4: 8200d36c ($19.33 in chips)
Seat 5: 2dc220b ($5 in chips)
Seat 6: 428456c9 ($5.55 in chips)
Hero: posts small blind $0.02
87e538b0: posts big blind $0.05
*** HOLE CARDS ***
Dealt to ca05a803 
Dealt to Hero [3h 6c]
Dealt to 87e538b0 
Dealt to 8200d36c 
Dealt to 2dc220b 
Dealt to 428456c9 
8200d36c: folds
2dc220b: folds
428456c9: folds
ca05a803: folds
Hero: folds
Uncalled bet ($0.03) returned to 87e538b0
*** SHOWDOWN ***
87e538b0 collected $0.04 from pot
*** SUMMARY ***
Total pot $0.04 | Rake $0 | Jackpot $0 | Bingo $0 | Fortune $0
Seat 1: ca05a803 (button) folded before Flop (didn't bet)
Seat 2: Hero (small blind) folded before Flop
Seat 3: 87e538b0 (big blind) collected ($0.04)
Seat 4: 8200d36c folded before Flop (didn't bet)
Seat 5: 2dc220b folded before Flop (didn't bet)
Seat 6: 428456c9 folded before Flop (didn't bet)


Poker Hand #HD1205634796: Hold'em No Limit  ($0.02/$0.05) - 2023/04/16 19:47:42
Table 'NLHBlue44' 6-max Seat #6 is the button
Seat 1: ca05a803 ($5 in chips)
Seat 2: Hero ($5.3 in chips)
Seat 3: 87e538b0 ($5 in chips)
Seat 4: 8200d36c ($19.33 in chips)
Seat 5: 2dc220b ($5 in chips)
Seat 6: 428456c9 ($5.55 in chips)
ca05a803: posts small blind $0.02
Hero: posts big blind $0.05
*** HOLE CARDS ***
Dealt to ca05a803 
Dealt to Hero [2c 3h]
Dealt to 87e538b0 
Dealt to 8200d36c 
Dealt to 2dc220b 
Dealt to 428456c9 
87e538b0: folds
8200d36c: folds
2dc220b: folds
428456c9: folds
ca05a803: folds
Uncalled bet ($0.03) returned to Hero
*** SHOWDOWN ***
Hero collected $0.04 from pot
*** SUMMARY ***
Total pot $0.04 | Rake $0 | Jackpot $0 | Bingo $0 | Fortune $0
Seat 1: ca05a803 (small blind) folded before Flop
Seat 2: Hero (big blind) collected ($0.04)
Seat 3: 87e538b0 folded before Flop (didn't bet)
Seat 4: 8200d36c folded before Flop (didn't bet)
Seat 5: 2dc220b folded before Flop (didn't bet)
Seat 6: 428456c9 (button) folded before Flop (didn't bet)


Poker Hand #HD1205634777: Hold'em No Limit  ($0.02/$0.05) - 2023/04/16 19:47:27
Table 'NLHBlue44' 6-max Seat #5 is the button
Seat 1: ca05a803 ($5 in chips)
Seat 2: Hero ($5.3 in chips)
Seat 3: 87e538b0 ($5 in chips)
Seat 4: 8200d36c ($19.26 in chips)
Seat 5: 2dc220b ($5 in chips)
Seat 6: 428456c9 ($5.57 in chips)
428456c9: posts small blind $0.02
ca05a803: posts big blind $0.05
*** HOLE CARDS ***
Dealt to ca05a803 
Dealt to Hero [5d 6h]
Dealt to 87e538b0 
Dealt to 8200d36c 
Dealt to 2dc220b 
Dealt to 428456c9 
Hero: folds
87e538b0: folds
8200d36c: raises $0.1 to $0.15
2dc220b: folds
428456c9: folds
ca05a803: folds
Uncalled bet ($0.1) returned to 8200d36c
*** SHOWDOWN ***
8200d36c collected $0.12 from pot
*** SUMMARY ***
Total pot $0.12 | Rake $0 | Jackpot $0 | Bingo $0 | Fortune $0
Seat 1: ca05a803 (big blind) folded before Flop
Seat 2: Hero folded before Flop (didn't bet)
Seat 3: 87e538b0 folded before Flop (didn't bet)
Seat 4: 8200d36c collected ($0.12)
Seat 5: 2dc220b (button) folded before Flop (didn't bet)
Seat 6: 428456c9 (small blind) folded before Flop


Poker Hand #HD1205634691: Hold'em No Limit  ($0.02/$0.05) - 2023/04/16 19:46:32
Table 'NLHBlue44' 6-max Seat #4 is the button
Seat 1: ca05a803 ($5 in chips)
Seat 2: Hero ($5.58 in chips)
Seat 3: 87e538b0 ($5 in chips)
Seat 4: 8200d36c ($18.94 in chips)
Seat 5: 2dc220b ($5 in chips)
Seat 6: 428456c9 ($5.62 in chips)
2dc220b: posts small blind $0.02
428456c9: posts big blind $0.05
*** HOLE CARDS ***
Dealt to ca05a803 
Dealt to Hero [2h 2d]
Dealt to 87e538b0 
Dealt to 8200d36c 
Dealt to 2dc220b 
Dealt to 428456c9 
ca05a803: folds
Hero: raises $0.07 to $0.12
87e538b0: folds
8200d36c: calls $0.12
2dc220b: folds
428456c9: folds
*** FLOP *** [3d 9c 7d]
Hero: checks
8200d36c: bets $0.16
Hero: calls $0.16
*** TURN *** [3d 9c 7d] [Ah]
Hero: checks
8200d36c: bets $0.45
Hero: folds
Uncalled bet ($0.45) returned to 8200d36c
*** SHOWDOWN ***
8200d36c collected $0.6 from pot
*** SUMMARY ***
Total pot $0.63 | Rake $0.03 | Jackpot $0 | Bingo $0 | Fortune $0
Board [3d 9c 7d Ah]
Seat 1: ca05a803 folded before Flop (didn't bet)
Seat 2: Hero folded on the Turn
Seat 3: 87e538b0 folded before Flop (didn't bet)
Seat 4: 8200d36c (button) won ($0.6)
Seat 5: 2dc220b (small blind) folded before Flop
Seat 6: 428456c9 (big blind) folded before Flop


Poker Hand #HD1205634597: Hold'em No Limit  ($0.02/$0.05) - 2023/04/16 19:45:28
Table 'NLHBlue44' 6-max Seat #3 is the button
Seat 1: ca05a803 ($5 in chips)
Seat 2: Hero ($5 in chips)
Seat 3: 87e538b0 ($5 in chips)
Seat 4: 8200d36c ($19.53 in chips)
Seat 5: 2dc220b ($5 in chips)
Seat 6: 428456c9 ($5.62 in chips)
8200d36c: posts small blind $0.02
2dc220b: posts big blind $0.05
*** HOLE CARDS ***
Dealt to ca05a803 
Dealt to Hero [Kd Qh]
Dealt to 87e538b0 
Dealt to 8200d36c 
Dealt to 2dc220b 
Dealt to 428456c9 
428456c9: folds
ca05a803: folds
Hero: raises $0.07 to $0.12
87e538b0: folds
8200d36c: calls $0.1
2dc220b: folds
*** FLOP *** [9d 6h Qd]
8200d36c: checks
Hero: bets $0.16
8200d36c: calls $0.16
*** TURN *** [9d 6h Qd] [9s]
8200d36c: checks
Hero: bets $0.31
8200d36c: calls $0.31
*** RIVER *** [9d 6h Qd 9s] [3d]
8200d36c: checks
Hero: checks
8200d36c: shows [Jh Ad] (Pair of Nines)
Hero: shows [Kd Qh] (Pair of Queens and Pair of Nines)
*** SHOWDOWN ***
Hero collected $1.17 from pot
*** SUMMARY ***
Total pot $1.23 | Rake $0.06 | Jackpot $0 | Bingo $0 | Fortune $0
Board [9d 6h Qd 9s 3d]
Seat 1: ca05a803 folded before Flop (didn't bet)
Seat 2: Hero showed [Kd Qh] and won ($1.17) with Pair of Queens and Pair of Nines
Seat 3: 87e538b0 (button) folded before Flop (didn't bet)
Seat 4: 8200d36c (small blind) showed [Jh Ad] and lost with Pair of Nines
Seat 5: 2dc220b (big blind) folded before Flop
Seat 6: 428456c9 folded before Flop (didn't bet)


Poker Hand #HD1205634524: Hold'em No Limit  ($0.02/$0.05) - 2023/04/16 19:44:45
Table 'NLHBlue44' 6-max Seat #2 is the button
Seat 1: ca05a803 ($5 in chips)
Seat 2: Hero ($5 in chips)
Seat 3: 87e538b0 ($5.01 in chips)
Seat 4: 8200d36c ($19.35 in chips)
Seat 5: 2dc220b ($5 in chips)
Seat 6: 428456c9 ($5.62 in chips)
87e538b0: posts small blind $0.02
8200d36c: posts big blind $0.05
*** HOLE CARDS ***
Dealt to ca05a803 
Dealt to Hero [2s 4s]
Dealt to 87e538b0 
Dealt to 8200d36c 
Dealt to 2dc220b 
Dealt to 428456c9 
2dc220b: folds
428456c9: folds
ca05a803: raises $0.06 to $0.11
Hero: folds
87e538b0: folds
8200d36c: raises $0.06 to $0.17
ca05a803: calls $0.06
*** FLOP *** [Ks 4d Jh]
8200d36c: bets $0.18
ca05a803: folds
Uncalled bet ($0.18) returned to 8200d36c
*** SHOWDOWN ***
8200d36c collected $0.35 from pot
*** SUMMARY ***
Total pot $0.36 | Rake $0.01 | Jackpot $0 | Bingo $0 | Fortune $0
Board [Ks 4d Jh]
Seat 1: ca05a803 folded on the Flop
Seat 2: Hero (button) folded before Flop (didn't bet)
Seat 3: 87e538b0 (small blind) folded before Flop
Seat 4: 8200d36c (big blind) won ($0.35)
Seat 5: 2dc220b folded before Flop (didn't bet)
Seat 6: 428456c9 folded before Flop (didn't bet)


Poker Hand #HD1205634441: Hold'em No Limit  ($0.02/$0.05) - 2023/04/16 19:43:51
Table 'NLHBlue44' 6-max Seat #1 is the button
Seat 1: ca05a803 ($5 in chips)
Seat 2: Hero ($5.24 in chips)
Seat 3: 87e538b0 ($5.06 in chips)
Seat 4: 8200d36c ($14.61 in chips)
Seat 5: 2dc220b ($5 in chips)
Seat 6: 428456c9 ($5.62 in chips)
Hero: posts small blind $0.02
87e538b0: posts big blind $0.05
*** HOLE CARDS ***
Dealt to ca05a803 
Dealt to Hero [Qd Qc]
Dealt to 87e538b0 
Dealt to 8200d36c 
Dealt to 2dc220b 
Dealt to 428456c9 
8200d36c: raises $0.05 to $0.1
2dc220b: folds
428456c9: folds
ca05a803: folds
Hero: raises $0.38 to $0.48
87e538b0: folds
8200d36c: calls $0.38
*** FLOP *** [Tc 3c 5s]
Hero: bets $0.76
8200d36c: calls $0.76
*** TURN *** [Tc 3c 5s] [6h]
Hero: bets $4 and is all-in
8200d36c: calls $4
Hero: shows [Qd Qc] (Pair of Queens)
8200d36c: shows [2c 4c] (Sixes-High Straight)
*** RIVER *** [Tc 3c 5s 6h] [Jd]
*** SHOWDOWN ***
8200d36c collected $9.98 from pot
*** SUMMARY ***
Total pot $10.53 | Rake $0.5 | Jackpot $0.05 | Bingo $0 | Fortune $0
Board [Tc 3c 5s 6h Jd]
Seat 1: ca05a803 (button) folded before Flop (didn't bet)
Seat 2: Hero (small blind) showed [Qd Qc] and lost with Pair of Queens
Seat 3: 87e538b0 (big blind) folded before Flop
Seat 4: 8200d36c showed [2c 4c] and won ($9.98) with Sixes-High Straight
Seat 5: 2dc220b folded before Flop (didn't bet)
Seat 6: 428456c9 folded before Flop (didn't bet)


Poker Hand #HD1205634355: Hold'em No Limit  ($0.02/$0.05) - 2023/04/16 19:42:49
Table 'NLHBlue44' 6-max Seat #6 is the button
Seat 1: ca05a803 ($5 in chips)
Seat 2: Hero ($5.29 in chips)
Seat 3: 87e538b0 ($5.06 in chips)
Seat 4: 8200d36c ($14.23 in chips)
Seat 5: 2dc220b ($5 in chips)
Seat 6: 428456c9 ($5.62 in chips)
ca05a803: posts small blind $0.02
Hero: posts big blind $0.05
*** HOLE CARDS ***
Dealt to ca05a803 
Dealt to Hero [4s 2c]
Dealt to 87e538b0 
Dealt to 8200d36c 
Dealt to 2dc220b 
Dealt to 428456c9 
87e538b0: folds
8200d36c: raises $0.1 to $0.15
2dc220b: calls $0.15
428456c9: folds
ca05a803: folds
Hero: folds
*** FLOP *** [Kh Jc Jd]
8200d36c: checks
2dc220b: checks
*** TURN *** [Kh Jc Jd] [4c]
8200d36c: bets $0.19
2dc220b: calls $0.19
*** RIVER *** [Kh Jc Jd 4c] [8s]
8200d36c: bets $1.25
2dc220b: folds
Uncalled bet ($1.25) returned to 8200d36c
*** SHOWDOWN ***
8200d36c collected $0.72 from pot
*** SUMMARY ***
Total pot $0.75 | Rake $0.03 | Jackpot $0 | Bingo $0 | Fortune $0
Board [Kh Jc Jd 4c 8s]
Seat 1: ca05a803 (small blind) folded before Flop
Seat 2: Hero (big blind) folded before Flop
Seat 3: 87e538b0 folded before Flop (didn't bet)
Seat 4: 8200d36c won ($0.72)
Seat 5: 2dc220b folded on the River
Seat 6: 428456c9 (button) folded before Flop (didn't bet)


Poker Hand #HD1205634285: Hold'em No Limit  ($0.02/$0.05) - 2023/04/16 19:42:03
Table 'NLHBlue44' 6-max Seat #5 is the button
Seat 1: ca05a803 ($5.02 in chips)
Seat 2: Hero ($5.29 in chips)
Seat 3: 87e538b0 ($5.18 in chips)
Seat 4: 8200d36c ($14.05 in chips)
Seat 5: 2dc220b ($5 in chips)
Seat 6: 428456c9 ($5.64 in chips)
428456c9: posts small blind $0.02
ca05a803: posts big blind $0.05
*** HOLE CARDS ***
Dealt to ca05a803 
Dealt to Hero [9h 3d]
Dealt to 87e538b0 
Dealt to 8200d36c 
Dealt to 2dc220b 
Dealt to 428456c9 
Hero: folds
87e538b0: raises $0.07 to $0.12
8200d36c: calls $0.12
2dc220b: folds
428456c9: folds
ca05a803: folds
*** FLOP *** [Qh 5c Qd]
87e538b0: checks
8200d36c: bets $0.24
87e538b0: folds
Uncalled bet ($0.24) returned to 8200d36c
*** SHOWDOWN ***
8200d36c collected $0.3 from pot
*** SUMMARY ***
Total pot $0.31 | Rake $0.01 | Jackpot $0 | Bingo $0 | Fortune $0
Board [Qh 5c Qd]
Seat 1: ca05a803 (big blind) folded before Flop
Seat 2: Hero folded before Flop (didn't bet)
Seat 3: 87e538b0 folded on the Flop
Seat 4: 8200d36c won ($0.3)
Seat 5: 2dc220b (button) folded before Flop (didn't bet)
Seat 6: 428456c9 (small blind) folded before Flop


Poker Hand #HD1205634215: Hold'em No Limit  ($0.02/$0.05) - 2023/04/16 19:41:23
Table 'NLHBlue44' 6-max Seat #4 is the button
Seat 1: ca05a803 ($5.12 in chips)
Seat 2: Hero ($5.29 in chips)
Seat 3: 87e538b0 ($5.18 in chips)
Seat 4: 8200d36c ($13.89 in chips)
Seat 5: 2dc220b ($5.02 in chips)
Seat 6: 428456c9 ($5.69 in chips)
2dc220b: posts small blind $0.02
428456c9: posts big blind $0.05
*** HOLE CARDS ***
Dealt to ca05a803 
Dealt to Hero [7h Td]
Dealt to 87e538b0 
Dealt to 8200d36c 
Dealt to 2dc220b 
Dealt to 428456c9 
ca05a803: raises $0.05 to $0.1
Hero: folds
87e538b0: folds
8200d36c: calls $0.1
2dc220b: folds
428456c9: folds
*** FLOP *** [9c 7s 8c]
ca05a803: checks
8200d36c: bets $0.14
ca05a803: folds
Uncalled bet ($0.14) returned to 8200d36c
*** SHOWDOWN ***
8200d36c collected $0.26 from pot
*** SUMMARY ***
Total pot $0.27 | Rake $0.01 | Jackpot $0 | Bingo $0 | Fortune $0
Board [9c 7s 8c]
Seat 1: ca05a803 folded on the Flop
Seat 2: Hero folded before Flop (didn't bet)
Seat 3: 87e538b0 folded before Flop (didn't bet)
Seat 4: 8200d36c (button) won ($0.26)
Seat 5: 2dc220b (small blind) folded before Flop
Seat 6: 428456c9 (big blind) folded before Flop


Poker Hand #HD1205634182: Hold'em No Limit  ($0.02/$0.05) - 2023/04/16 19:41:00
Table 'NLHBlue44' 6-max Seat #3 is the button
Seat 1: ca05a803 ($5.12 in chips)
Seat 2: Hero ($5.41 in chips)
Seat 3: 87e538b0 ($5 in chips)
Seat 4: 8200d36c ($13.91 in chips)
Seat 5: 2dc220b ($5.07 in chips)
Seat 6: 428456c9 ($5.69 in chips)
8200d36c: posts small blind $0.02
2dc220b: posts big blind $0.05
*** HOLE CARDS ***
Dealt to ca05a803 
Dealt to Hero [Ts Ac]
Dealt to 87e538b0 
Dealt to 8200d36c 
Dealt to 2dc220b 
Dealt to 428456c9 
428456c9: folds
ca05a803: folds
Hero: raises $0.07 to $0.12
87e538b0: raises $0.26 to $0.38
8200d36c: folds
2dc220b: folds
Hero: folds
Uncalled bet ($0.26) returned to 87e538b0
*** SHOWDOWN ***
87e538b0 collected $0.3 from pot
*** SUMMARY ***
Total pot $0.31 | Rake $0.01 | Jackpot $0 | Bingo $0 | Fortune $0
Seat 1: ca05a803 folded before Flop (didn't bet)
Seat 2: Hero folded before Flop
Seat 3: 87e538b0 (button) collected ($0.3)
Seat 4: 8200d36c (small blind) folded before Flop
Seat 5: 2dc220b (big blind) folded before Flop
Seat 6: 428456c9 folded before Flop (didn't bet)


Poker Hand #HD1205634167: Hold'em No Limit  ($0.02/$0.05) - 2023/04/16 19:40:50
Table 'NLHBlue44' 6-max Seat #2 is the button
Seat 1: ca05a803 ($5.12 in chips)
Seat 2: Hero ($5.41 in chips)
Seat 3: 87e538b0 ($5.02 in chips)
Seat 4: 8200d36c ($13.89 in chips)
Seat 5: 2dc220b ($5.07 in chips)
Seat 6: 428456c9 ($5.69 in chips)
87e538b0: posts small blind $0.02
8200d36c: posts big blind $0.05
*** HOLE CARDS ***
Dealt to ca05a803 
Dealt to Hero [4c 9h]
Dealt to 87e538b0 
Dealt to 8200d36c 
Dealt to 2dc220b 
Dealt to 428456c9 
2dc220b: folds
428456c9: folds
ca05a803: folds
Hero: folds
87e538b0: folds
Uncalled bet ($0.03) returned to 8200d36c
*** SHOWDOWN ***
8200d36c collected $0.04 from pot
*** SUMMARY ***
Total pot $0.04 | Rake $0 | Jackpot $0 | Bingo $0 | Fortune $0
Seat 1: ca05a803 folded before Flop (didn't bet)
Seat 2: Hero (button) folded before Flop (didn't bet)
Seat 3: 87e538b0 (small blind) folded before Flop
Seat 4: 8200d36c (big blind) collected ($0.04)
Seat 5: 2dc220b folded before Flop (didn't bet)
Seat 6: 428456c9 folded before Flop (didn't bet)


Poker Hand #HD1205634131: Hold'em No Limit  ($0.02/$0.05) - 2023/04/16 19:40:25
Table 'NLHBlue44' 6-max Seat #1 is the button
Seat 1: ca05a803 ($5.12 in chips)
Seat 2: Hero ($5.43 in chips)
Seat 3: 87e538b0 ($5.07 in chips)
Seat 4: 8200d36c ($13.89 in chips)
Seat 5: 2dc220b ($5 in chips)
Seat 6: 428456c9 ($5.69 in chips)
Hero: posts small blind $0.02
87e538b0: posts big blind $0.05
*** HOLE CARDS ***
Dealt to ca05a803 
Dealt to Hero [2s 2h]
Dealt to 87e538b0 
Dealt to 8200d36c 
Dealt to 2dc220b 
Dealt to 428456c9 
8200d36c: folds
2dc220b: raises $0.08 to $0.13
428456c9: folds
ca05a803: folds
Hero: folds
87e538b0: folds
Uncalled bet ($0.08) returned to 2dc220b
*** SHOWDOWN ***
2dc220b collected $0.12 from pot
*** SUMMARY ***
Total pot $0.12 | Rake $0 | Jackpot $0 | Bingo $0 | Fortune $0
Seat 1: ca05a803 (button) folded before Flop (didn't bet)
Seat 2: Hero (small blind) folded before Flop
Seat 3: 87e538b0 (big blind) folded before Flop
Seat 4: 8200d36c folded before Flop (didn't bet)
Seat 5: 2dc220b collected ($0.12)
Seat 6: 428456c9 folded before Flop (didn't bet)


Poker Hand #HD1205634097: Hold'em No Limit  ($0.02/$0.05) - 2023/04/16 19:40:04
Table 'NLHBlue44' 6-max Seat #6 is the button
Seat 1: ca05a803 ($5.14 in chips)
Seat 2: Hero ($5.48 in chips)
Seat 3: 87e538b0 ($5 in chips)
Seat 4: 8200d36c ($13.89 in chips)
Seat 5: 2dc220b ($5 in chips)
Seat 6: 428456c9 ($5.69 in chips)
ca05a803: posts small blind $0.02
Hero: posts big blind $0.05
*** HOLE CARDS ***
Dealt to ca05a803 
Dealt to Hero [2d Kc]
Dealt to 87e538b0 
Dealt to 8200d36c 
Dealt to 2dc220b 
Dealt to 428456c9 
87e538b0: raises $0.07 to $0.12
8200d36c: folds
2dc220b: folds
428456c9: folds
ca05a803: folds
Hero: folds
Uncalled bet ($0.07) returned to 87e538b0
*** SHOWDOWN ***
87e538b0 collected $0.12 from pot
*** SUMMARY ***
Total pot $0.12 | Rake $0 | Jackpot $0 | Bingo $0 | Fortune $0
Seat 1: ca05a803 (small blind) folded before Flop
Seat 2: Hero (big blind) folded before Flop
Seat 3: 87e538b0 collected ($0.12)
Seat 4: 8200d36c folded before Flop (didn't bet)
Seat 5: 2dc220b folded before Flop (didn't bet)
Seat 6: 428456c9 (button) folded before Flop (didn't bet)


Poker Hand #HD1205634064: Hold'em No Limit  ($0.02/$0.05) - 2023/04/16 19:39:38
Table 'NLHBlue44' 6-max Seat #5 is the button
Seat 1: ca05a803 ($5.19 in chips)
Seat 2: Hero ($5.48 in chips)
Seat 3: 87e538b0 ($5 in chips)
Seat 4: 8200d36c ($13.82 in chips)
Seat 5: 2dc220b ($5 in chips)
Seat 6: 428456c9 ($5.71 in chips)
428456c9: posts small blind $0.02
ca05a803: posts big blind $0.05
*** HOLE CARDS ***
Dealt to ca05a803 
Dealt to Hero [5c Qd]
Dealt to 87e538b0 
Dealt to 8200d36c 
Dealt to 2dc220b 
Dealt to 428456c9 
Hero: folds
87e538b0: folds
8200d36c: raises $0.1 to $0.15
2dc220b: folds
428456c9: folds
ca05a803: folds
Uncalled bet ($0.1) returned to 8200d36c
*** SHOWDOWN ***
8200d36c collected $0.12 from pot
*** SUMMARY ***
Total pot $0.12 | Rake $0 | Jackpot $0 | Bingo $0 | Fortune $0
Seat 1: ca05a803 (big blind) folded before Flop
Seat 2: Hero folded before Flop (didn't bet)
Seat 3: 87e538b0 folded before Flop (didn't bet)
Seat 4: 8200d36c collected ($0.12)
Seat 5: 2dc220b (button) folded before Flop (didn't bet)
Seat 6: 428456c9 (small blind) folded before Flop


Poker Hand #HD1205633995: Hold'em No Limit  ($0.02/$0.05) - 2023/04/16 19:38:51
Table 'NLHBlue44' 6-max Seat #4 is the button
Seat 1: ca05a803 ($5.19 in chips)
Seat 2: Hero ($5.48 in chips)
Seat 3: 87e538b0 ($5 in chips)
Seat 4: 8200d36c ($11.2 in chips)
Seat 5: 2dc220b ($5 in chips)
Seat 6: 428456c9 ($5.76 in chips)
2dc220b: posts small blind $0.02
428456c9: posts big blind $0.05
*** HOLE CARDS ***
Dealt to ca05a803 
Dealt to Hero [6d 8h]
Dealt to 87e538b0 
Dealt to 8200d36c 
Dealt to 2dc220b 
Dealt to 428456c9 
ca05a803: folds
Hero: folds
87e538b0: raises $0.07 to $0.12
8200d36c: calls $0.12
2dc220b: folds
428456c9: folds
*** FLOP *** [Ts As Ks]
87e538b0: bets $0.26
8200d36c: calls $0.26
*** TURN *** [Ts As Ks] [Td]
87e538b0: bets $0.69
8200d36c: calls $0.69
*** RIVER *** [Ts As Ks Td] [9d]
87e538b0: bets $1.82
8200d36c: calls $1.82
87e538b0: shows [Jc Qd] (Aces-High Straight)
8200d36c: shows [3s 9s] (Ace High Flush)
*** SHOWDOWN ***
8200d36c collected $5.51 from pot
*** SUMMARY ***
Total pot $5.85 | Rake $0.29 | Jackpot $0.05 | Bingo $0 | Fortune $0
Board [Ts As Ks Td 9d]
Seat 1: ca05a803 folded before Flop (didn't bet)
Seat 2: Hero folded before Flop (didn't bet)
Seat 3: 87e538b0 showed [Jc Qd] and lost with Aces-High Straight
Seat 4: 8200d36c (button) showed [3s 9s] and won ($5.51) with Ace High Flush
Seat 5: 2dc220b (small blind) folded before Flop
Seat 6: 428456c9 (big blind) folded before Flop


Poker Hand #HD1205633966: Hold'em No Limit  ($0.02/$0.05) - 2023/04/16 19:38:31
Table 'NLHBlue44' 6-max Seat #3 is the button
Seat 1: ca05a803 ($5.19 in chips)
Seat 2: Hero ($5.48 in chips)
Seat 3: 87e538b0 ($5 in chips)
Seat 4: 8200d36c ($11.15 in chips)
Seat 5: 2dc220b ($5 in chips)
Seat 6: 428456c9 ($5.76 in chips)
8200d36c: posts small blind $0.02
2dc220b: posts big blind $0.05
*** HOLE CARDS ***
Dealt to ca05a803 
Dealt to Hero [7c Jc]
Dealt to 87e538b0 
Dealt to 8200d36c 
Dealt to 2dc220b 
Dealt to 428456c9 
428456c9: folds
ca05a803: folds
Hero: folds
87e538b0: folds
8200d36c: raises $0.1 to $0.15
2dc220b: folds
Uncalled bet ($0.1) returned to 8200d36c
*** SHOWDOWN ***
8200d36c collected $0.1 from pot
*** SUMMARY ***
Total pot $0.1 | Rake $0 | Jackpot $0 | Bingo $0 | Fortune $0
Seat 1: ca05a803 folded before Flop (didn't bet)
Seat 2: Hero folded before Flop (didn't bet)
Seat 3: 87e538b0 (button) folded before Flop (didn't bet)
Seat 4: 8200d36c (small blind) collected ($0.1)
Seat 5: 2dc220b (big blind) folded before Flop
Seat 6: 428456c9 folded before Flop (didn't bet)


Poker Hand #HD1205633915: Hold'em No Limit  ($0.02/$0.05) - 2023/04/16 19:37:54
Table 'NLHBlue44' 6-max Seat #2 is the button
Seat 1: ca05a803 ($5.19 in chips)
Seat 2: Hero ($5.48 in chips)
Seat 3: 87e538b0 ($5 in chips)
Seat 4: 8200d36c ($11.35 in chips)
Seat 5: 2dc220b ($5 in chips)
Seat 6: 428456c9 ($5.56 in chips)
87e538b0: posts small blind $0.02
8200d36c: posts big blind $0.05
*** HOLE CARDS ***
Dealt to ca05a803 
Dealt to Hero [8h Js]
Dealt to 87e538b0 
Dealt to 8200d36c 
Dealt to 2dc220b 
Dealt to 428456c9 
2dc220b: folds
428456c9: raises $0.1 to $0.15
ca05a803: folds
Hero: folds
87e538b0: folds
8200d36c: calls $0.1
*** FLOP *** [Td 2h Ts]
8200d36c: bets $0.05
428456c9: calls $0.05
*** TURN *** [Td 2h Ts] [Qh]
8200d36c: checks
428456c9: bets $0.21
8200d36c: folds
Uncalled bet ($0.21) returned to 428456c9
*** SHOWDOWN ***
428456c9 collected $0.4 from pot
*** SUMMARY ***
Total pot $0.42 | Rake $0.02 | Jackpot $0 | Bingo $0 | Fortune $0
Board [Td 2h Ts Qh]
Seat 1: ca05a803 folded before Flop (didn't bet)
Seat 2: Hero (button) folded before Flop (didn't bet)
Seat 3: 87e538b0 (small blind) folded before Flop
Seat 4: 8200d36c (big blind) folded on the Turn
Seat 5: 2dc220b folded before Flop (didn't bet)
Seat 6: 428456c9 won ($0.4)


Poker Hand #HD1205633874: Hold'em No Limit  ($0.02/$0.05) - 2023/04/16 19:37:26
Table 'NLHBlue44' 6-max Seat #1 is the button
Seat 1: ca05a803 ($5.19 in chips)
Seat 2: Hero ($5 in chips)
Seat 3: 87e538b0 ($5 in chips)
Seat 4: 8200d36c ($11.83 in chips)
Seat 5: 2dc220b ($5 in chips)
Seat 6: 428456c9 ($5.56 in chips)
Hero: posts small blind $0.02
87e538b0: posts big blind $0.05
*** HOLE CARDS ***
Dealt to ca05a803 
Dealt to Hero [Ks Ah]
Dealt to 87e538b0 
Dealt to 8200d36c 
Dealt to 2dc220b 
Dealt to 428456c9 
8200d36c: raises $0.05 to $0.1
2dc220b: folds
428456c9: folds
ca05a803: folds
Hero: raises $0.38 to $0.48
87e538b0: folds
8200d36c: calls $0.38
*** FLOP *** [Kd 2s Qc]
Hero: bets $0.51
8200d36c: folds
Uncalled bet ($0.51) returned to Hero
*** SHOWDOWN ***
Hero collected $0.96 from pot
*** SUMMARY ***
Total pot $1.01 | Rake $0.05 | Jackpot $0 | Bingo $0 | Fortune $0
Board [Kd 2s Qc]
Seat 1: ca05a803 (button) folded before Flop (didn't bet)
Seat 2: Hero (small blind) won ($0.96)
Seat 3: 87e538b0 (big blind) folded before Flop
Seat 4: 8200d36c folded on the Flop
Seat 5: 2dc220b folded before Flop (didn't bet)
Seat 6: 428456c9 folded before Flop (didn't bet)


Poker Hand #HD1205633832: Hold'em No Limit  ($0.02/$0.05) - 2023/04/16 19:36:56
Table 'NLHBlue44' 6-max Seat #6 is the button
Seat 1: ca05a803 ($5 in chips)
Seat 2: Hero ($5 in chips)
Seat 4: 8200d36c ($11.98 in chips)
Seat 5: 2dc220b ($5 in chips)
Seat 6: 428456c9 ($5.56 in chips)
ca05a803: posts small blind $0.02
Hero: posts big blind $0.05
*** HOLE CARDS ***
Dealt to ca05a803 
Dealt to Hero [6h 9d]
Dealt to 8200d36c 
Dealt to 2dc220b 
Dealt to 428456c9 
8200d36c: raises $0.1 to $0.15
2dc220b: folds
428456c9: folds
ca05a803: raises $0.42 to $0.57
Hero: folds
8200d36c: folds
Uncalled bet ($0.42) returned to ca05a803
*** SHOWDOWN ***
ca05a803 collected $0.34 from pot
*** SUMMARY ***
Total pot $0.35 | Rake $0.01 | Jackpot $0 | Bingo $0 | Fortune $0
Seat 1: ca05a803 (small blind) collected ($0.34)
Seat 2: Hero (big blind) folded before Flop
Seat 4: 8200d36c folded before Flop
Seat 5: 2dc220b folded before Flop (didn't bet)
Seat 6: 428456c9 (button) folded before Flop (didn't bet)


Poker Hand #HD1205633764: Hold'em No Limit  ($0.02/$0.05) - 2023/04/16 19:36:09
Table 'NLHBlue44' 6-max Seat #5 is the button
Seat 1: ca05a803 ($5 in chips)
Seat 2: Hero ($5 in chips)
Seat 4: 8200d36c ($11.82 in chips)
Seat 5: 2dc220b ($5 in chips)
Seat 6: 428456c9 ($5.58 in chips)
428456c9: posts small blind $0.02
ca05a803: posts big blind $0.05
*** HOLE CARDS ***
Dealt to ca05a803 
Dealt to Hero [Th 6d]
Dealt to 8200d36c 
Dealt to 2dc220b 
Dealt to 428456c9 
Hero: folds
8200d36c: raises $0.1 to $0.15
2dc220b: folds
428456c9: folds
ca05a803: calls $0.1
*** FLOP *** [9h Ad 9d]
ca05a803: checks
8200d36c: bets $0.16
ca05a803: folds
Uncalled bet ($0.16) returned to 8200d36c
*** SHOWDOWN ***
8200d36c collected $0.31 from pot
*** SUMMARY ***
Total pot $0.32 | Rake $0.01 | Jackpot $0 | Bingo $0 | Fortune $0
Board [9h Ad 9d]
Seat 1: ca05a803 (big blind) folded on the Flop
Seat 2: Hero folded before Flop (didn't bet)
Seat 4: 8200d36c won ($0.31)
Seat 5: 2dc220b (button) folded before Flop (didn't bet)
Seat 6: 428456c9 (small blind) folded before Flop


Poker Hand #HD1205633683: Hold'em No Limit  ($0.02/$0.05) - 2023/04/16 19:35:07
Table 'NLHBlue44' 6-max Seat #4 is the button
Seat 1: ca05a803 ($5 in chips)
Seat 2: Hero ($5 in chips)
Seat 4: 8200d36c ($11.6 in chips)
Seat 5: 2dc220b ($5.02 in chips)
Seat 6: 428456c9 ($5.63 in chips)
2dc220b: posts small blind $0.02
428456c9: posts big blind $0.05
*** HOLE CARDS ***
Dealt to ca05a803 
Dealt to Hero [Ts Jc]
Dealt to 8200d36c 
Dealt to 2dc220b 
Dealt to 428456c9 
ca05a803: raises $0.06 to $0.11
Hero: folds
8200d36c: raises $0.06 to $0.17
2dc220b: folds
428456c9: folds
ca05a803: calls $0.06
*** FLOP *** [Ks 3h 6h]
ca05a803: checks
8200d36c: bets $0.31
ca05a803: folds
Uncalled bet ($0.31) returned to 8200d36c
*** SHOWDOWN ***
8200d36c collected $0.39 from pot
*** SUMMARY ***
Total pot $0.41 | Rake $0.02 | Jackpot $0 | Bingo $0 | Fortune $0
Board [Ks 3h 6h]
Seat 1: ca05a803 folded on the Flop
Seat 2: Hero folded before Flop (didn't bet)
Seat 4: 8200d36c (button) won ($0.39)
Seat 5: 2dc220b (small blind) folded before Flop
Seat 6: 428456c9 (big blind) folded before Flop


Poker Hand #HD1205633662: Hold'em No Limit  ($0.02/$0.05) - 2023/04/16 19:34:53
Table 'NLHBlue44' 6-max Seat #2 is the button
Seat 1: ca05a803 ($5 in chips)
Seat 2: Hero ($5 in chips)
Seat 4: 8200d36c ($11.55 in chips)
Seat 5: 2dc220b ($5.07 in chips)
Seat 6: 428456c9 ($5.63 in chips)
8200d36c: posts small blind $0.02
2dc220b: posts big blind $0.05
*** HOLE CARDS ***
Dealt to ca05a803 
Dealt to Hero [5s Ad]
Dealt to 8200d36c 
Dealt to 2dc220b 
Dealt to 428456c9 
428456c9: folds
ca05a803: folds
Hero: folds
8200d36c: raises $0.05 to $0.1
2dc220b: folds
Uncalled bet ($0.05) returned to 8200d36c
*** SHOWDOWN ***
8200d36c collected $0.1 from pot
*** SUMMARY ***
Total pot $0.1 | Rake $0 | Jackpot $0 | Bingo $0 | Fortune $0
Seat 1: ca05a803 folded before Flop (didn't bet)
Seat 2: Hero (button) folded before Flop (didn't bet)
Seat 4: 8200d36c (small blind) collected ($0.1)
Seat 5: 2dc220b (big blind) folded before Flop
Seat 6: 428456c9 folded before Flop (didn't bet)


Poker Hand #HD1205633520: Hold'em No Limit  ($0.02/$0.05) - 2023/04/16 19:33:15
Table 'NLHBlue44' 6-max Seat #1 is the button
Seat 1: ca05a803 ($5.05 in chips)
Seat 2: Hero ($5 in chips)
Seat 4: 8200d36c ($11.18 in chips)
Seat 5: 2dc220b ($5.07 in chips)
Seat 6: 428456c9 ($5.63 in chips)
Hero: posts small blind $0.02
8200d36c: posts big blind $0.05
*** HOLE CARDS ***
Dealt to ca05a803 
Dealt to Hero [7h 9d]
Dealt to 8200d36c 
Dealt to 2dc220b 
Dealt to 428456c9 
2dc220b: folds
428456c9: folds
ca05a803: raises $0.07 to $0.12
Hero: folds
8200d36c: raises $0.07 to $0.19
ca05a803: calls $0.07
*** FLOP *** [9s As 2s]
8200d36c: checks
ca05a803: checks
*** TURN *** [9s As 2s] [3h]
8200d36c: bets $0.2
ca05a803: calls $0.2
*** RIVER *** [9s As 2s 3h] [Kd]
8200d36c: bets $0.8
ca05a803: folds
Uncalled bet ($0.8) returned to 8200d36c
*** SHOWDOWN ***
8200d36c collected $0.76 from pot
*** SUMMARY ***
Total pot $0.8 | Rake $0.04 | Jackpot $0 | Bingo $0 | Fortune $0
Board [9s As 2s 3h Kd]
Seat 1: ca05a803 (button) folded on the River
Seat 2: Hero (small blind) folded before Flop
Seat 4: 8200d36c (big blind) won ($0.76)
Seat 5: 2dc220b folded before Flop (didn't bet)
Seat 6: 428456c9 folded before Flop (didn't bet)


Poker Hand #HD1205633488: Hold'em No Limit  ($0.02/$0.05) - 2023/04/16 19:32:51
Table 'NLHBlue44' 6-max Seat #6 is the button
Seat 1: ca05a803 ($5 in chips)
Seat 2: Hero ($5 in chips)
Seat 4: 8200d36c ($11.18 in chips)
Seat 5: 2dc220b ($5.07 in chips)
Seat 6: 428456c9 ($5.63 in chips)
ca05a803: posts small blind $0.02
Hero: posts big blind $0.05
*** HOLE CARDS ***
Dealt to ca05a803 
Dealt to Hero [Ts 2s]
Dealt to 8200d36c 
Dealt to 2dc220b 
Dealt to 428456c9 
8200d36c: folds
2dc220b: folds
428456c9: folds
ca05a803: raises $0.08 to $0.13
Hero: folds
Uncalled bet ($0.08) returned to ca05a803
*** SHOWDOWN ***
ca05a803 collected $0.1 from pot
*** SUMMARY ***
Total pot $0.1 | Rake $0 | Jackpot $0 | Bingo $0 | Fortune $0
Seat 1: ca05a803 (small blind) collected ($0.1)
Seat 2: Hero (big blind) folded before Flop
Seat 4: 8200d36c folded before Flop (didn't bet)
Seat 5: 2dc220b folded before Flop (didn't bet)
Seat 6: 428456c9 (button) folded before Flop (didn't bet)


Poker Hand #HD1205633473: Hold'em No Limit  ($0.02/$0.05) - 2023/04/16 19:32:37
Table 'NLHBlue44' 6-max Seat #5 is the button
Seat 1: ca05a803 ($5 in chips)
Seat 2: Hero ($5 in chips)
Seat 4: 8200d36c ($11.18 in chips)
Seat 5: 2dc220b ($5 in chips)
Seat 6: 428456c9 ($5.65 in chips)
428456c9: posts small blind $0.02
ca05a803: posts big blind $0.05
*** HOLE CARDS ***
Dealt to ca05a803 
Dealt to Hero [Qh 8s]
Dealt to 8200d36c 
Dealt to 2dc220b 
Dealt to 428456c9 
Hero: folds
8200d36c: folds
2dc220b: raises $0.08 to $0.13
428456c9: folds
ca05a803: folds
Uncalled bet ($0.08) returned to 2dc220b
*** SHOWDOWN ***
2dc220b collected $0.12 from pot
*** SUMMARY ***
Total pot $0.12 | Rake $0 | Jackpot $0 | Bingo $0 | Fortune $0
Seat 1: ca05a803 (big blind) folded before Flop
Seat 2: Hero folded before Flop (didn't bet)
Seat 4: 8200d36c folded before Flop (didn't bet)
Seat 5: 2dc220b (button) collected ($0.12)
Seat 6: 428456c9 (small blind) folded before Flop


Poker Hand #HD1205633458: Hold'em No Limit  ($0.02/$0.05) - 2023/04/16 19:32:29
Table 'NLHBlue44' 6-max Seat #4 is the button
Seat 2: Hero ($5 in chips)
Seat 4: 8200d36c ($11.11 in chips)
Seat 5: 2dc220b ($5 in chips)
Seat 6: 428456c9 ($5.7 in chips)
2dc220b: posts small blind $0.02
428456c9: posts big blind $0.05
*** HOLE CARDS ***
Dealt to Hero [2c 8s]
Dealt to 8200d36c 
Dealt to 2dc220b 
Dealt to 428456c9 
Hero: folds
8200d36c: raises $0.05 to $0.1
2dc220b: folds
428456c9: folds
Uncalled bet ($0.05) returned to 8200d36c
*** SHOWDOWN ***
8200d36c collected $0.12 from pot
*** SUMMARY ***
Total pot $0.12 | Rake $0 | Jackpot $0 | Bingo $0 | Fortune $0
Seat 2: Hero folded before Flop (didn't bet)
Seat 4: 8200d36c (button) collected ($0.12)
Seat 5: 2dc220b (small blind) folded before Flop
Seat 6: 428456c9 (big blind) folded before Flop


Poker Hand #HD1205633434: Hold'em No Limit  ($0.02/$0.05) - 2023/04/16 19:32:13
Table 'NLHBlue44' 6-max Seat #2 is the button
Seat 2: Hero ($5 in chips)
Seat 4: 8200d36c ($11.06 in chips)
Seat 5: 2dc220b ($5 in chips)
Seat 6: 428456c9 ($5.7 in chips)
8200d36c: posts small blind $0.02
2dc220b: posts big blind $0.05
*** HOLE CARDS ***
Dealt to Hero [9h 3h]
Dealt to 8200d36c 
Dealt to 2dc220b 
Dealt to 428456c9 
428456c9: folds
Hero: folds
8200d36c: raises $0.15 to $0.2
2dc220b: folds
Uncalled bet ($0.15) returned to 8200d36c
*** SHOWDOWN ***
8200d36c collected $0.1 from pot
*** SUMMARY ***
Total pot $0.1 | Rake $0 | Jackpot $0 | Bingo $0 | Fortune $0
Seat 2: Hero (button) folded before Flop (didn't bet)
Seat 4: 8200d36c (small blind) collected ($0.1)
Seat 5: 2dc220b (big blind) folded before Flop
Seat 6: 428456c9 folded before Flop (didn't bet)


Poker Hand #HD1205633396: Hold'em No Limit  ($0.02/$0.05) - 2023/04/16 19:31:47
Table 'NLHBlue44' 6-max Seat #6 is the button
Seat 2: Hero ($5.02 in chips)
Seat 4: 8200d36c ($10.9 in chips)
Seat 5: 2dc220b ($5 in chips)
Seat 6: 428456c9 ($5.85 in chips)
Hero: posts small blind $0.02
8200d36c: posts big blind $0.05
*** HOLE CARDS ***
Dealt to Hero [7c 9d]
Dealt to 8200d36c 
Dealt to 2dc220b 
Dealt to 428456c9 
2dc220b: folds
428456c9: raises $0.1 to $0.15
Hero: folds
8200d36c: calls $0.1
*** FLOP *** [4d Qs 9h]
8200d36c: bets $0.24
428456c9: folds
Uncalled bet ($0.24) returned to 8200d36c
*** SHOWDOWN ***
8200d36c collected $0.31 from pot
*** SUMMARY ***
Total pot $0.32 | Rake $0.01 | Jackpot $0 | Bingo $0 | Fortune $0
Board [4d Qs 9h]
Seat 2: Hero (small blind) folded before Flop
Seat 4: 8200d36c (big blind) won ($0.31)
Seat 5: 2dc220b folded before Flop (didn't bet)
Seat 6: 428456c9 (button) folded on the Flop


Poker Hand #HD1205633378: Hold'em No Limit  ($0.02/$0.05) - 2023/04/16 19:31:36
Table 'NLHBlue44' 6-max Seat #5 is the button
Seat 2: Hero ($5 in chips)
Seat 4: 8200d36c ($10.9 in chips)
Seat 5: 2dc220b ($5 in chips)
Seat 6: 428456c9 ($5.87 in chips)
428456c9: posts small blind $0.02
Hero: posts big blind $0.05
*** HOLE CARDS ***
Dealt to Hero [Kc 4s]
Dealt to 8200d36c 
Dealt to 2dc220b 
Dealt to 428456c9 
8200d36c: folds
2dc220b: folds
428456c9: folds
Uncalled bet ($0.03) returned to Hero
*** SHOWDOWN ***
Hero collected $0.04 from pot
*** SUMMARY ***
Total pot $0.04 | Rake $0 | Jackpot $0 | Bingo $0 | Fortune $0
Seat 2: Hero (big blind) collected ($0.04)
Seat 4: 8200d36c folded before Flop (didn't bet)
Seat 5: 2dc220b (button) folded before Flop (didn't bet)
Seat 6: 428456c9 (small blind) folded before Flop


Poker Hand #HD1205633360: Hold'em No Limit  ($0.02/$0.05) - 2023/04/16 19:31:21
Table 'NLHBlue44' 6-max Seat #4 is the button
Seat 2: Hero ($5 in chips)
Seat 4: 8200d36c ($10.9 in chips)
Seat 5: 2dc220b ($5 in chips)
Seat 6: 428456c9 ($5.85 in chips)
2dc220b: posts small blind $0.02
428456c9: posts big blind $0.05
*** HOLE CARDS ***
Dealt to Hero [9d 4d]
Dealt to 8200d36c 
Dealt to 2dc220b 
Dealt to 428456c9 
Hero: folds
8200d36c: folds
2dc220b: folds
Uncalled bet ($0.03) returned to 428456c9
*** SHOWDOWN ***
428456c9 collected $0.04 from pot
*** SUMMARY ***
Total pot $0.04 | Rake $0 | Jackpot $0 | Bingo $0 | Fortune $0
Seat 2: Hero folded before Flop (didn't bet)
Seat 4: 8200d36c (button) folded before Flop (didn't bet)
Seat 5: 2dc220b (small blind) folded before Flop
Seat 6: 428456c9 (big blind) collected ($0.04)


Poker Hand #HD1205633315: Hold'em No Limit  ($0.02/$0.05) - 2023/04/16 19:30:48
Table 'NLHBlue44' 6-max Seat #2 is the button
Seat 2: Hero ($5 in chips)
Seat 4: 8200d36c ($11.33 in chips)
Seat 5: 2dc220b ($5 in chips)
Seat 6: 428456c9 ($5 in chips)
8200d36c: posts small blind $0.02
2dc220b: posts big blind $0.05
*** HOLE CARDS ***
Dealt to Hero [Ah Qh]
Dealt to 8200d36c 
Dealt to 2dc220b 
Dealt to 428456c9 
428456c9: raises $0.1 to $0.15
Hero: raises $0.28 to $0.43
8200d36c: calls $0.41
2dc220b: folds
428456c9: raises $1.72 to $2.15
Hero: folds
8200d36c: folds
Uncalled bet ($1.72) returned to 428456c9
*** SHOWDOWN ***
428456c9 collected $1.28 from pot
*** SUMMARY ***
Total pot $1.34 | Rake $0.06 | Jackpot $0 | Bingo $0 | Fortune $0
Seat 2: Hero (button) folded before Flop
Seat 4: 8200d36c (small blind) folded before Flop
Seat 5: 2dc220b (big blind) folded before Flop
Seat 6: 428456c9 collected ($1.28)


Poker Hand #HD1205633284: Hold'em No Limit  ($0.02/$0.05) - 2023/04/16 19:30:28
Table 'NLHBlue44' 6-max Seat #6 is the button
Seat 2: Hero ($5 in chips)
Seat 4: 8200d36c ($11.31 in chips)
Seat 5: 2dc220b ($5 in chips)
Seat 6: 428456c9 ($5 in chips)
Hero: posts small blind $0.02
8200d36c: posts big blind $0.05
*** HOLE CARDS ***
Dealt to Hero [4h Jd]
Dealt to 8200d36c 
Dealt to 2dc220b 
Dealt to 428456c9 
2dc220b: folds
428456c9: folds
Hero: folds
Uncalled bet ($0.03) returned to 8200d36c
*** SHOWDOWN ***
8200d36c collected $0.04 from pot
*** SUMMARY ***
Total pot $0.04 | Rake $0 | Jackpot $0 | Bingo $0 | Fortune $0
Seat 2: Hero (small blind) folded before Flop
Seat 4: 8200d36c (big blind) collected ($0.04)
Seat 5: 2dc220b folded before Flop (didn't bet)
Seat 6: 428456c9 (button) folded before Flop (didn't bet)


Poker Hand #HD1205633275: Hold'em No Limit  ($0.02/$0.05) - 2023/04/16 19:30:17
Table 'NLHBlue44' 6-max Seat #5 is the button
Seat 2: Hero ($5 in chips)
Seat 4: 8200d36c ($11.24 in chips)
Seat 5: 2dc220b ($5 in chips)
Seat 6: 428456c9 ($5.02 in chips)
428456c9: posts small blind $0.02
Hero: posts big blind $0.05
*** HOLE CARDS ***
Dealt to Hero [7c 5h]
Dealt to 8200d36c 
Dealt to 2dc220b 
Dealt to 428456c9 
8200d36c: raises $0.1 to $0.15
2dc220b: folds
428456c9: folds
Hero: folds
Uncalled bet ($0.1) returned to 8200d36c
*** SHOWDOWN ***
8200d36c collected $0.12 from pot
*** SUMMARY ***
Total pot $0.12 | Rake $0 | Jackpot $0 | Bingo $0 | Fortune $0
Seat 2: Hero (big blind) folded before Flop
Seat 4: 8200d36c collected ($0.12)
Seat 5: 2dc220b (button) folded before Flop (didn't bet)
Seat 6: 428456c9 (small blind) folded before Flop


Poker Hand #HD1205633259: Hold'em No Limit  ($0.02/$0.05) - 2023/04/16 19:30:06
Table 'NLHBlue44' 6-max Seat #4 is the button
Seat 2: Hero ($5 in chips)
Seat 4: 8200d36c ($11.24 in chips)
Seat 5: 2dc220b ($5 in chips)
Seat 6: 428456c9 ($5 in chips)
2dc220b: posts small blind $0.02
428456c9: posts big blind $0.05
*** HOLE CARDS ***
Dealt to Hero [5s 2s]
Dealt to 8200d36c 
Dealt to 2dc220b 
Dealt to 428456c9 
Hero: folds
8200d36c: folds
2dc220b: folds
Uncalled bet ($0.03) returned to 428456c9
*** SHOWDOWN ***
428456c9 collected $0.04 from pot
*** SUMMARY ***
Total pot $0.04 | Rake $0 | Jackpot $0 | Bingo $0 | Fortune $0
Seat 2: Hero folded before Flop (didn't bet)
Seat 4: 8200d36c (button) folded before Flop (didn't bet)
Seat 5: 2dc220b (small blind) folded before Flop
Seat 6: 428456c9 (big blind) collected ($0.04)


Poker Hand #HD1205633195: Hold'em No Limit  ($0.02/$0.05) - 2023/04/16 19:29:26
Table 'NLHBlue44' 6-max Seat #3 is the button
Seat 2: Hero ($5.07 in chips)
Seat 3: 18cf0a2e ($6.1 in chips)
Seat 4: 8200d36c ($10.88 in chips)
Seat 5: 2dc220b ($5 in chips)
Seat 6: 428456c9 ($5 in chips)
8200d36c: posts small blind $0.02
2dc220b: posts big blind $0.05
*** HOLE CARDS ***
Dealt to Hero [7d 7s]
Dealt to 18cf0a2e 
Dealt to 8200d36c 
Dealt to 2dc220b 
Dealt to 428456c9 
428456c9: folds
Hero: raises $0.07 to $0.12
18cf0a2e: folds
8200d36c: raises $0.07 to $0.19
2dc220b: folds
Hero: calls $0.07
*** FLOP *** [2s As Qd]
8200d36c: bets $0.15
Hero: calls $0.15
*** TURN *** [2s As Qd] [Kd]
8200d36c: bets $0.55
Hero: folds
Uncalled bet ($0.55) returned to 8200d36c
*** SHOWDOWN ***
8200d36c collected $0.7 from pot
*** SUMMARY ***
Total pot $0.73 | Rake $0.03 | Jackpot $0 | Bingo $0 | Fortune $0
Board [2s As Qd Kd]
Seat 2: Hero folded on the Turn
Seat 3: 18cf0a2e (button) folded before Flop (didn't bet)
Seat 4: 8200d36c (small blind) won ($0.7)
Seat 5: 2dc220b (big blind) folded before Flop
Seat 6: 428456c9 folded before Flop (didn't bet)


Poker Hand #HD1205633173: Hold'em No Limit  ($0.02/$0.05) - 2023/04/16 19:29:13
Table 'NLHBlue44' 6-max Seat #2 is the button
Seat 2: Hero ($5 in chips)
Seat 3: 18cf0a2e ($6.12 in chips)
Seat 4: 8200d36c ($10.93 in chips)
Seat 6: 428456c9 ($5 in chips)
18cf0a2e: posts small blind $0.02
8200d36c: posts big blind $0.05
*** HOLE CARDS ***
Dealt to Hero [Th 9h]
Dealt to 18cf0a2e 
Dealt to 8200d36c 
Dealt to 428456c9 
428456c9: folds
Hero: raises $0.07 to $0.12
18cf0a2e: folds
8200d36c: folds
Uncalled bet ($0.07) returned to Hero
*** SHOWDOWN ***
Hero collected $0.12 from pot
*** SUMMARY ***
Total pot $0.12 | Rake $0 | Jackpot $0 | Bingo $0 | Fortune $0
Seat 2: Hero (button) collected ($0.12)
Seat 3: 18cf0a2e (small blind) folded before Flop
Seat 4: 8200d36c (big blind) folded before Flop
Seat 6: 428456c9 folded before Flop (didn't bet)


Poker Hand #HD1205633093: Hold'em No Limit  ($0.02/$0.05) - 2023/04/16 19:28:06
Table 'NLHBlue44' 6-max Seat #6 is the button
Seat 1: 65b8fe6b ($10.43 in chips)
Seat 2: Hero ($8.07 in chips)
Seat 3: 18cf0a2e ($6.12 in chips)
Seat 4: 8200d36c ($5.74 in chips)
Seat 6: 428456c9 ($5 in chips)
65b8fe6b: posts small blind $0.02
Hero: posts big blind $0.05
8200d36c: posts big blind $0.05
8200d36c: posts missed blind $0.02
*** HOLE CARDS ***
Dealt to 65b8fe6b 
Dealt to Hero [Kc Qh]
Dealt to 18cf0a2e 
Dealt to 8200d36c 
Dealt to 428456c9 
18cf0a2e: folds
8200d36c: checks
428456c9: folds
65b8fe6b: folds
Hero: raises $0.19 to $0.24
8200d36c: calls $0.19
*** FLOP *** [Kd 6s Kh]
Hero: bets $0.19
8200d36c: calls $0.19
*** TURN *** [Kd 6s Kh] [7s]
Hero: bets $0.36
8200d36c: raises $0.36 to $0.72
Hero: raises $1.2 to $1.92
8200d36c: calls $1.2
*** RIVER *** [Kd 6s Kh 7s] [4s]
Hero: checks
8200d36c: bets $3.37 and is all-in
Hero: calls $3.37
8200d36c: shows [8s 2s] (Eight High Flush)
Hero: shows [Kc Qh] (Three Kings)
*** SHOWDOWN ***
8200d36c collected $10.93 from pot
*** SUMMARY ***
Total pot $11.48 | Rake $0.5 | Jackpot $0.05 | Bingo $0 | Fortune $0
Board [Kd 6s Kh 7s 4s]
Seat 1: 65b8fe6b (small blind) folded before Flop
Seat 2: Hero (big blind) showed [Kc Qh] and lost with Three Kings
Seat 3: 18cf0a2e folded before Flop (didn't bet)
Seat 4: 8200d36c showed [8s 2s] and won ($10.93) with Eight High Flush
Seat 6: 428456c9 (button) folded before Flop (didn't bet)


Poker Hand #HD1205633052: Hold'em No Limit  ($0.02/$0.05) - 2023/04/16 19:27:41
Table 'NLHBlue44' 6-max Seat #3 is the button
Seat 1: 65b8fe6b ($10.48 in chips)
Seat 2: Hero ($8 in chips)
Seat 3: 18cf0a2e ($6.12 in chips)
Seat 6: 428456c9 ($5 in chips)
428456c9: posts small blind $0.02
65b8fe6b: posts big blind $0.05
*** HOLE CARDS ***
Dealt to 65b8fe6b 
Dealt to Hero [Ks As]
Dealt to 18cf0a2e 
Dealt to 428456c9 
Hero: raises $0.07 to $0.12
18cf0a2e: folds
428456c9: folds
65b8fe6b: folds
Uncalled bet ($0.07) returned to Hero
*** SHOWDOWN ***
Hero collected $0.12 from pot
*** SUMMARY ***
Total pot $0.12 | Rake $0 | Jackpot $0 | Bingo $0 | Fortune $0
Seat 1: 65b8fe6b (big blind) folded before Flop
Seat 2: Hero collected ($0.12)
Seat 3: 18cf0a2e (button) folded before Flop (didn't bet)
Seat 6: 428456c9 (small blind) folded before Flop


Poker Hand #HD1205632986: Hold'em No Limit  ($0.02/$0.05) - 2023/04/16 19:26:54
Table 'NLHBlue44' 6-max Seat #2 is the button
Seat 1: 65b8fe6b ($10.48 in chips)
Seat 2: Hero ($8.22 in chips)
Seat 3: 18cf0a2e ($5.87 in chips)
Seat 6: 428456c9 ($5 in chips)
18cf0a2e: posts small blind $0.02
428456c9: posts big blind $0.05
*** HOLE CARDS ***
Dealt to 65b8fe6b 
Dealt to Hero [Qd Jd]
Dealt to 18cf0a2e 
Dealt to 428456c9 
65b8fe6b: folds
Hero: raises $0.07 to $0.12
18cf0a2e: calls $0.1
428456c9: folds
*** FLOP *** [9s 7c 3c]
18cf0a2e: checks
Hero: checks
*** TURN *** [9s 7c 3c] [7h]
18cf0a2e: bets $0.1
Hero: calls $0.1
*** RIVER *** [9s 7c 3c 7h] [As]
18cf0a2e: checks
Hero: checks
18cf0a2e: shows [8d 8c] (Pair of Eights and Pair of Sevens)
Hero: shows [Qd Jd] (Pair of Sevens)
*** SHOWDOWN ***
18cf0a2e collected $0.47 from pot
*** SUMMARY ***
Total pot $0.49 | Rake $0.02 | Jackpot $0 | Bingo $0 | Fortune $0
Board [9s 7c 3c 7h As]
Seat 1: 65b8fe6b folded before Flop (didn't bet)
Seat 2: Hero (button) showed [Qd Jd] and lost with Pair of Sevens
Seat 3: 18cf0a2e (small blind) showed [8d 8c] and won ($0.47) with Pair of Eights and Pair of Sevens
Seat 6: 428456c9 (big blind) folded before Flop


Poker Hand #HD1205632980: Hold'em No Limit  ($0.02/$0.05) - 2023/04/16 19:26:48
Table 'NLHBlue44' 6-max Seat #1 is the button
Seat 1: 65b8fe6b ($10.48 in chips)
Seat 2: Hero ($8.24 in chips)
Seat 3: 18cf0a2e ($5.85 in chips)
Hero: posts small blind $0.02
18cf0a2e: posts big blind $0.05
*** HOLE CARDS ***
Dealt to 65b8fe6b 
Dealt to Hero [5c Qh]
Dealt to 18cf0a2e 
65b8fe6b: folds
Hero: folds
Uncalled bet ($0.03) returned to 18cf0a2e
*** SHOWDOWN ***
18cf0a2e collected $0.04 from pot
*** SUMMARY ***
Total pot $0.04 | Rake $0 | Jackpot $0 | Bingo $0 | Fortune $0
Seat 1: 65b8fe6b (button) folded before Flop (didn't bet)
Seat 2: Hero (small blind) folded before Flop
Seat 3: 18cf0a2e (big blind) collected ($0.04)


Poker Hand #HD1205632911: Hold'em No Limit  ($0.02/$0.05) - 2023/04/16 19:26:07
Table 'NLHBlue44' 6-max Seat #3 is the button
Seat 1: 65b8fe6b ($10.48 in chips)
Seat 2: Hero ($8.36 in chips)
Seat 3: 18cf0a2e ($5.67 in chips)
Seat 4: 8200d36c ($5.76 in chips)
Seat 5: 92adae06 ($5 in chips)
Seat 6: 65b1af9f ($5 in chips)
8200d36c: posts small blind $0.02
92adae06: posts big blind $0.05
*** HOLE CARDS ***
Dealt to 65b8fe6b 
Dealt to Hero [Kd Jh]
Dealt to 18cf0a2e 
Dealt to 8200d36c 
Dealt to 92adae06 
Dealt to 65b1af9f 
65b1af9f: folds
65b8fe6b: folds
Hero: raises $0.07 to $0.12
18cf0a2e: raises $0.24 to $0.36
8200d36c: folds
92adae06: folds
Hero: folds
Uncalled bet ($0.24) returned to 18cf0a2e
*** SHOWDOWN ***
18cf0a2e collected $0.3 from pot
*** SUMMARY ***
Total pot $0.31 | Rake $0.01 | Jackpot $0 | Bingo $0 | Fortune $0
Seat 1: 65b8fe6b folded before Flop (didn't bet)
Seat 2: Hero folded before Flop
Seat 3: 18cf0a2e (button) collected ($0.3)
Seat 4: 8200d36c (small blind) folded before Flop
Seat 5: 92adae06 (big blind) folded before Flop
Seat 6: 65b1af9f folded before Flop (didn't bet)


Poker Hand #HD1205632848: Hold'em No Limit  ($0.02/$0.05) - 2023/04/16 19:25:22
Table 'NLHBlue44' 6-max Seat #2 is the button
Seat 1: 65b8fe6b ($10.19 in chips)
Seat 2: Hero ($8.36 in chips)
Seat 3: 18cf0a2e ($5.69 in chips)
Seat 4: 8200d36c ($5.81 in chips)
Seat 5: 92adae06 ($5 in chips)
Seat 6: 65b1af9f ($5 in chips)
18cf0a2e: posts small blind $0.02
8200d36c: posts big blind $0.05
*** HOLE CARDS ***
Dealt to 65b8fe6b 
Dealt to Hero [4h 8d]
Dealt to 18cf0a2e 
Dealt to 8200d36c 
Dealt to 92adae06 
Dealt to 65b1af9f 
92adae06: folds
65b1af9f: raises $0.08 to $0.13
65b8fe6b: calls $0.13
Hero: folds
18cf0a2e: folds
8200d36c: folds
*** FLOP *** [3c 2h 7h]
65b1af9f: checks
65b8fe6b: bets $0.11
65b1af9f: calls $0.11
*** TURN *** [3c 2h 7h] [8h]
65b1af9f: checks
65b8fe6b: bets $0.28
65b1af9f: folds
Uncalled bet ($0.28) returned to 65b8fe6b
*** SHOWDOWN ***
65b8fe6b collected $0.53 from pot
*** SUMMARY ***
Total pot $0.55 | Rake $0.02 | Jackpot $0 | Bingo $0 | Fortune $0
Board [3c 2h 7h 8h]
Seat 1: 65b8fe6b won ($0.53)
Seat 2: Hero (button) folded before Flop (didn't bet)
Seat 3: 18cf0a2e (small blind) folded before Flop
Seat 4: 8200d36c (big blind) folded before Flop
Seat 5: 92adae06 folded before Flop (didn't bet)
Seat 6: 65b1af9f folded on the Turn


Poker Hand #HD1205632814: Hold'em No Limit  ($0.02/$0.05) - 2023/04/16 19:25:02
Table 'NLHBlue44' 6-max Seat #1 is the button
Seat 1: 65b8fe6b ($10.12 in chips)
Seat 2: Hero ($8.38 in chips)
Seat 3: 18cf0a2e ($5.74 in chips)
Seat 4: 8200d36c ($5.81 in chips)
Seat 5: 92adae06 ($5 in chips)
Seat 6: 65b1af9f ($5 in chips)
Hero: posts small blind $0.02
18cf0a2e: posts big blind $0.05
*** HOLE CARDS ***
Dealt to 65b8fe6b 
Dealt to Hero [8h 5d]
Dealt to 18cf0a2e 
Dealt to 8200d36c 
Dealt to 92adae06 
Dealt to 65b1af9f 
8200d36c: folds
92adae06: folds
65b1af9f: folds
65b8fe6b: raises $0.1 to $0.15
Hero: folds
18cf0a2e: folds
Uncalled bet ($0.1) returned to 65b8fe6b
*** SHOWDOWN ***
65b8fe6b collected $0.12 from pot
*** SUMMARY ***
Total pot $0.12 | Rake $0 | Jackpot $0 | Bingo $0 | Fortune $0
Seat 1: 65b8fe6b (button) collected ($0.12)
Seat 2: Hero (small blind) folded before Flop
Seat 3: 18cf0a2e (big blind) folded before Flop
Seat 4: 8200d36c folded before Flop (didn't bet)
Seat 5: 92adae06 folded before Flop (didn't bet)
Seat 6: 65b1af9f folded before Flop (didn't bet)


Poker Hand #HD1205632790: Hold'em No Limit  ($0.02/$0.05) - 2023/04/16 19:24:48
Table 'NLHBlue44' 6-max Seat #6 is the button
Seat 1: 65b8fe6b ($10.14 in chips)
Seat 2: Hero ($8.36 in chips)
Seat 3: 18cf0a2e ($5.74 in chips)
Seat 4: 8200d36c ($5.81 in chips)
Seat 5: 92adae06 ($1.58 in chips)
Seat 6: 65b1af9f ($5 in chips)
65b8fe6b: posts small blind $0.02
Hero: posts big blind $0.05
*** HOLE CARDS ***
Dealt to 65b8fe6b 
Dealt to Hero [3d Td]
Dealt to 18cf0a2e 
Dealt to 8200d36c 
Dealt to 92adae06 
Dealt to 65b1af9f 
18cf0a2e: folds
8200d36c: folds
92adae06: folds
65b1af9f: folds
65b8fe6b: folds
Uncalled bet ($0.03) returned to Hero
*** SHOWDOWN ***
Hero collected $0.04 from pot
*** SUMMARY ***
Total pot $0.04 | Rake $0 | Jackpot $0 | Bingo $0 | Fortune $0
Seat 1: 65b8fe6b (small blind) folded before Flop
Seat 2: Hero (big blind) collected ($0.04)
Seat 3: 18cf0a2e folded before Flop (didn't bet)
Seat 4: 8200d36c folded before Flop (didn't bet)
Seat 5: 92adae06 folded before Flop (didn't bet)
Seat 6: 65b1af9f (button) folded before Flop (didn't bet)


Poker Hand #HD1205632697: Hold'em No Limit  ($0.02/$0.05) - 2023/04/16 19:23:45
Table 'NLHBlue44' 6-max Seat #5 is the button
Seat 1: 65b8fe6b ($10.19 in chips)
Seat 2: Hero ($8.36 in chips)
Seat 3: 18cf0a2e ($5.74 in chips)
Seat 4: 8200d36c ($5.91 in chips)
Seat 5: 92adae06 ($1.42 in chips)
Seat 6: 65b1af9f ($5 in chips)
65b1af9f: posts small blind $0.02
65b8fe6b: posts big blind $0.05
*** HOLE CARDS ***
Dealt to 65b8fe6b 
Dealt to Hero [Th 8s]
Dealt to 18cf0a2e 
Dealt to 8200d36c 
Dealt to 92adae06 
Dealt to 65b1af9f 
Hero: folds
18cf0a2e: folds
8200d36c: raises $0.05 to $0.1
92adae06: calls $0.1
65b1af9f: folds
65b8fe6b: folds
*** FLOP *** [Qd 2c 8d]
8200d36c: checks
92adae06: checks
*** TURN *** [Qd 2c 8d] [Js]
8200d36c: checks
92adae06: bets $0.2
8200d36c: folds
Uncalled bet ($0.2) returned to 92adae06
*** SHOWDOWN ***
92adae06 collected $0.26 from pot
*** SUMMARY ***
Total pot $0.27 | Rake $0.01 | Jackpot $0 | Bingo $0 | Fortune $0
Board [Qd 2c 8d Js]
Seat 1: 65b8fe6b (big blind) folded before Flop
Seat 2: Hero folded before Flop (didn't bet)
Seat 3: 18cf0a2e folded before Flop (didn't bet)
Seat 4: 8200d36c folded on the Turn
Seat 5: 92adae06 (button) won ($0.26)
Seat 6: 65b1af9f (small blind) folded before Flop


Poker Hand #HD1205632635: Hold'em No Limit  ($0.02/$0.05) - 2023/04/16 19:23:01
Table 'NLHBlue44' 6-max Seat #4 is the button
Seat 1: 65b8fe6b ($10.19 in chips)
Seat 2: Hero ($8.36 in chips)
Seat 3: 18cf0a2e ($5 in chips)
Seat 4: 8200d36c ($6.71 in chips)
Seat 5: 92adae06 ($1.44 in chips)
Seat 6: 65b1af9f ($5 in chips)
92adae06: posts small blind $0.02
65b1af9f: posts big blind $0.05
*** HOLE CARDS ***
Dealt to 65b8fe6b 
Dealt to Hero [6d 9d]
Dealt to 18cf0a2e 
Dealt to 8200d36c 
Dealt to 92adae06 
Dealt to 65b1af9f 
65b8fe6b: folds
Hero: folds
18cf0a2e: raises $0.08 to $0.13
8200d36c: raises $0.25 to $0.38
92adae06: folds
65b1af9f: folds
18cf0a2e: calls $0.25
*** FLOP *** [4c Ad Ks]
18cf0a2e: checks
8200d36c: checks
*** TURN *** [4c Ad Ks] [Kd]
18cf0a2e: checks
8200d36c: checks
*** RIVER *** [4c Ad Ks Kd] [3d]
18cf0a2e: bets $0.42
8200d36c: calls $0.42
18cf0a2e: shows [Ac Qd] (Pair of Aces and Pair of Kings)
8200d36c: shows [Js Jd] (Pair of Kings and Pair of Jacks)
*** SHOWDOWN ***
18cf0a2e collected $1.54 from pot
*** SUMMARY ***
Total pot $1.67 | Rake $0.08 | Jackpot $0.05 | Bingo $0 | Fortune $0
Board [4c Ad Ks Kd 3d]
Seat 1: 65b8fe6b folded before Flop (didn't bet)
Seat 2: Hero folded before Flop (didn't bet)
Seat 3: 18cf0a2e showed [Ac Qd] and won ($1.54) with Pair of Aces and Pair of Kings
Seat 4: 8200d36c (button) showed [Js Jd] and lost with Pair of Kings and Pair of Jacks
Seat 5: 92adae06 (small blind) folded before Flop
Seat 6: 65b1af9f (big blind) folded before Flop


Poker Hand #HD1205632541: Hold'em No Limit  ($0.02/$0.05) - 2023/04/16 19:22:00
Table 'NLHBlue44' 6-max Seat #3 is the button
Seat 1: 65b8fe6b ($10.19 in chips)
Seat 2: Hero ($5 in chips)
Seat 3: 18cf0a2e ($5 in chips)
Seat 4: 8200d36c ($7.19 in chips)
Seat 5: 92adae06 ($4.72 in chips)
8200d36c: posts small blind $0.02
92adae06: posts big blind $0.05
*** HOLE CARDS ***
Dealt to 65b8fe6b 
Dealt to Hero [Kd Ks]
Dealt to 18cf0a2e 
Dealt to 8200d36c 
Dealt to 92adae06 
65b8fe6b: folds
Hero: raises $0.07 to $0.12
18cf0a2e: folds
8200d36c: calls $0.1
92adae06: calls $0.07
*** FLOP *** [2c Kh 3s]
8200d36c: bets $0.36
92adae06: calls $0.36
Hero: calls $0.36
*** TURN *** [2c Kh 3s] [4s]
8200d36c: checks
92adae06: checks
Hero: bets $1.08
8200d36c: folds
92adae06: calls $1.08
*** RIVER *** [2c Kh 3s 4s] [6h]
92adae06: checks
Hero: bets $1.72
92adae06: calls $1.72
Hero: shows [Kd Ks] (Three Kings)
92adae06: shows [Kc Jc] (Pair of Kings)
*** SHOWDOWN ***
Hero collected $6.64 from pot
*** SUMMARY ***
Total pot $7.04 | Rake $0.35 | Jackpot $0.05 | Bingo $0 | Fortune $0
Board [2c Kh 3s 4s 6h]
Seat 1: 65b8fe6b folded before Flop (didn't bet)
Seat 2: Hero showed [Kd Ks] and won ($6.64) with Three Kings
Seat 3: 18cf0a2e (button) folded before Flop (didn't bet)
Seat 4: 8200d36c (small blind) folded on the Turn
Seat 5: 92adae06 (big blind) showed [Kc Jc] and lost with Pair of Kings


Poker Hand #HD1205632474: Hold'em No Limit  ($0.02/$0.05) - 2023/04/16 19:21:22
Table 'NLHBlue44' 6-max Seat #2 is the button
Seat 1: 65b8fe6b ($10.12 in chips)
Seat 2: Hero ($5 in chips)
Seat 3: 18cf0a2e ($5 in chips)
Seat 4: 8200d36c ($7.24 in chips)
Seat 5: 92adae06 ($4.72 in chips)
18cf0a2e: posts small blind $0.02
8200d36c: posts big blind $0.05
*** HOLE CARDS ***
Dealt to 65b8fe6b 
Dealt to Hero [Kc 5c]
Dealt to 18cf0a2e 
Dealt to 8200d36c 
Dealt to 92adae06 
92adae06: folds
65b8fe6b: raises $0.1 to $0.15
Hero: folds
18cf0a2e: folds
8200d36c: folds
Uncalled bet ($0.1) returned to 65b8fe6b
*** SHOWDOWN ***
65b8fe6b collected $0.12 from pot
*** SUMMARY ***
Total pot $0.12 | Rake $0 | Jackpot $0 | Bingo $0 | Fortune $0
Seat 1: 65b8fe6b collected ($0.12)
Seat 2: Hero (button) folded before Flop (didn't bet)
Seat 3: 18cf0a2e (small blind) folded before Flop
Seat 4: 8200d36c (big blind) folded before Flop
Seat 5: 92adae06 folded before Flop (didn't bet)


Poker Hand #HD1205632447: Hold'em No Limit  ($0.02/$0.05) - 2023/04/16 19:21:06
Table 'NLHBlue44' 6-max Seat #1 is the button
Seat 1: 65b8fe6b ($10.05 in chips)
Seat 2: Hero ($5 in chips)
Seat 3: 18cf0a2e ($5 in chips)
Seat 4: 8200d36c ($7.24 in chips)
Seat 5: 92adae06 ($4.72 in chips)
Hero: posts small blind $0.02
18cf0a2e: posts big blind $0.05
*** HOLE CARDS ***
Dealt to 65b8fe6b 
Dealt to Hero [Kd 8c]
Dealt to 18cf0a2e 
Dealt to 8200d36c 
Dealt to 92adae06 
8200d36c: folds
92adae06: folds
65b8fe6b: raises $0.1 to $0.15
Hero: folds
18cf0a2e: folds
Uncalled bet ($0.1) returned to 65b8fe6b
*** SHOWDOWN ***
65b8fe6b collected $0.12 from pot
*** SUMMARY ***
Total pot $0.12 | Rake $0 | Jackpot $0 | Bingo $0 | Fortune $0
Seat 1: 65b8fe6b (button) collected ($0.12)
Seat 2: Hero (small blind) folded before Flop
Seat 3: 18cf0a2e (big blind) folded before Flop
Seat 4: 8200d36c folded before Flop (didn't bet)
Seat 5: 92adae06 folded before Flop (didn't bet)


Poker Hand #HD1205632389: Hold'em No Limit  ($0.02/$0.05) - 2023/04/16 19:20:25
Table 'NLHBlue44' 6-max Seat #5 is the button
Seat 1: 65b8fe6b ($9.86 in chips)
Seat 2: Hero ($5 in chips)
Seat 3: 18cf0a2e ($5 in chips)
Seat 4: 8200d36c ($7.34 in chips)
Seat 5: 92adae06 ($4.72 in chips)
Seat 6: f6c16b02 ($5 in chips)
f6c16b02: posts small blind $0.02
65b8fe6b: posts big blind $0.05
*** HOLE CARDS ***
Dealt to 65b8fe6b 
Dealt to Hero [5c 2h]
Dealt to 18cf0a2e 
Dealt to 8200d36c 
Dealt to 92adae06 
Dealt to f6c16b02 
Hero: folds
18cf0a2e: folds
8200d36c: raises $0.05 to $0.1
92adae06: folds
f6c16b02: calls $0.08
65b8fe6b: raises $0.3 to $0.4
8200d36c: folds
f6c16b02: folds
Uncalled bet ($0.3) returned to 65b8fe6b
*** SHOWDOWN ***
65b8fe6b collected $0.29 from pot
*** SUMMARY ***
Total pot $0.3 | Rake $0.01 | Jackpot $0 | Bingo $0 | Fortune $0
Seat 1: 65b8fe6b (big blind) collected ($0.29)
Seat 2: Hero folded before Flop (didn't bet)
Seat 3: 18cf0a2e folded before Flop (didn't bet)
Seat 4: 8200d36c folded before Flop
Seat 5: 92adae06 (button) folded before Flop (didn't bet)
Seat 6: f6c16b02 (small blind) folded before Flop


Poker Hand #HD1205632347: Hold'em No Limit  ($0.02/$0.05) - 2023/04/16 19:19:54
Table 'NLHBlue44' 6-max Seat #4 is the button
Seat 1: 65b8fe6b ($9.86 in chips)
Seat 2: Hero ($5 in chips)
Seat 3: 18cf0a2e ($5 in chips)
Seat 4: 8200d36c ($7.34 in chips)
Seat 5: 92adae06 ($4.67 in chips)
Seat 6: f6c16b02 ($5 in chips)
92adae06: posts small blind $0.02
f6c16b02: posts big blind $0.05
*** HOLE CARDS ***
Dealt to 65b8fe6b 
Dealt to Hero [6d 5c]
Dealt to 18cf0a2e 
Dealt to 8200d36c 
Dealt to 92adae06 
Dealt to f6c16b02 
65b8fe6b: folds
Hero: folds
18cf0a2e: folds
8200d36c: folds
92adae06: raises $0.1 to $0.15
f6c16b02: folds
Uncalled bet ($0.1) returned to 92adae06
*** SHOWDOWN ***
92adae06 collected $0.1 from pot
*** SUMMARY ***
Total pot $0.1 | Rake $0 | Jackpot $0 | Bingo $0 | Fortune $0
Seat 1: 65b8fe6b folded before Flop (didn't bet)
Seat 2: Hero folded before Flop (didn't bet)
Seat 3: 18cf0a2e folded before Flop (didn't bet)
Seat 4: 8200d36c (button) folded before Flop (didn't bet)
Seat 5: 92adae06 (small blind) collected ($0.1)
Seat 6: f6c16b02 (big blind) folded before Flop


Poker Hand #HD1205632236: Hold'em No Limit  ($0.02/$0.05) - 2023/04/16 19:18:46
Table 'NLHBlue44' 6-max Seat #3 is the button
Seat 1: 65b8fe6b ($9.86 in chips)
Seat 2: Hero ($5 in chips)
Seat 3: 18cf0a2e ($5 in chips)
Seat 4: 8200d36c ($5.88 in chips)
Seat 5: 92adae06 ($5 in chips)
Seat 6: f6c16b02 ($5 in chips)
8200d36c: posts small blind $0.02
92adae06: posts big blind $0.05
*** HOLE CARDS ***
Dealt to 65b8fe6b 
Dealt to Hero [7s 8d]
Dealt to 18cf0a2e 
Dealt to 8200d36c 
Dealt to 92adae06 
Dealt to f6c16b02 
f6c16b02: folds
65b8fe6b: folds
Hero: folds
18cf0a2e: raises $0.08 to $0.13
8200d36c: calls $0.11
92adae06: calls $0.08
*** FLOP *** [7c 5h 4c]
8200d36c: bets $0.2
92adae06: calls $0.2
18cf0a2e: calls $0.2
*** TURN *** [7c 5h 4c] [Td]
8200d36c: bets $0.99
92adae06: folds
18cf0a2e: calls $0.99
*** RIVER *** [7c 5h 4c Td] [Ts]
8200d36c: checks
18cf0a2e: checks
8200d36c: shows [4d 3d] (Pair of Tens and Pair of Fours)
18cf0a2e: shows [Qc 9c] (Pair of Tens)
*** SHOWDOWN ***
8200d36c collected $2.78 from pot
*** SUMMARY ***
Total pot $2.97 | Rake $0.14 | Jackpot $0.05 | Bingo $0 | Fortune $0
Board [7c 5h 4c Td Ts]
Seat 1: 65b8fe6b folded before Flop (didn't bet)
Seat 2: Hero folded before Flop (didn't bet)
Seat 3: 18cf0a2e (button) showed [Qc 9c] and lost with Pair of Tens
Seat 4: 8200d36c (small blind) showed [4d 3d] and won ($2.78) with Pair of Tens and Pair of Fours
Seat 5: 92adae06 (big blind) folded on the Turn
Seat 6: f6c16b02 folded before Flop (didn't bet)


Poker Hand #HD1205632163: Hold'em No Limit  ($0.02/$0.05) - 2023/04/16 19:17:54
Table 'NLHBlue44' 6-max Seat #2 is the button
Seat 1: 65b8fe6b ($9.86 in chips)
Seat 2: Hero ($5 in chips)
Seat 3: 18cf0a2e ($5 in chips)
Seat 4: 8200d36c ($5.77 in chips)
Seat 5: 92adae06 ($5 in chips)
Seat 6: f6c16b02 ($5 in chips)
18cf0a2e: posts small blind $0.02
8200d36c: posts big blind $0.05
*** HOLE CARDS ***
Dealt to 65b8fe6b 
Dealt to Hero [Td Qh]
Dealt to 18cf0a2e 
Dealt to 8200d36c 
Dealt to 92adae06 
Dealt to f6c16b02 
92adae06: folds
f6c16b02: raises $0.05 to $0.1
65b8fe6b: folds
Hero: folds
18cf0a2e: folds
8200d36c: calls $0.05
*** FLOP *** [6h 2h 4h]
8200d36c: checks
f6c16b02: checks
*** TURN *** [6h 2h 4h] [8d]
8200d36c: checks
f6c16b02: checks
*** RIVER *** [6h 2h 4h 8d] [4c]
8200d36c: checks
f6c16b02: checks
8200d36c: shows [6d 7d] (Pair of Sixes and Pair of Fours)
f6c16b02: shows [Ad 9d] (Pair of Fours)
*** SHOWDOWN ***
8200d36c collected $0.21 from pot
*** SUMMARY ***
Total pot $0.22 | Rake $0.01 | Jackpot $0 | Bingo $0 | Fortune $0
Board [6h 2h 4h 8d 4c]
Seat 1: 65b8fe6b folded before Flop (didn't bet)
Seat 2: Hero (button) folded before Flop (didn't bet)
Seat 3: 18cf0a2e (small blind) folded before Flop
Seat 4: 8200d36c (big blind) showed [6d 7d] and won ($0.21) with Pair of Sixes and Pair of Fours
Seat 5: 92adae06 folded before Flop (didn't bet)
Seat 6: f6c16b02 showed [Ad 9d] and lost with Pair of Fours


Poker Hand #HD1205632107: Hold'em No Limit  ($0.02/$0.05) - 2023/04/16 19:17:17
Table 'NLHBlue44' 6-max Seat #1 is the button
Seat 1: 65b8fe6b ($9.6 in chips)
Seat 2: Hero ($5 in chips)
Seat 3: 18cf0a2e ($5 in chips)
Seat 4: 8200d36c ($5.87 in chips)
Seat 5: 92adae06 ($5 in chips)
Seat 6: f6c16b02 ($5 in chips)
Hero: posts small blind $0.02
18cf0a2e: posts big blind $0.05
*** HOLE CARDS ***
Dealt to 65b8fe6b 
Dealt to Hero [8s 4d]
Dealt to 18cf0a2e 
Dealt to 8200d36c 
Dealt to 92adae06 
Dealt to f6c16b02 
8200d36c: raises $0.05 to $0.1
92adae06: folds
f6c16b02: calls $0.1
65b8fe6b: raises $0.37 to $0.47
Hero: folds
18cf0a2e: folds
8200d36c: folds
f6c16b02: folds
Uncalled bet ($0.37) returned to 65b8fe6b
*** SHOWDOWN ***
65b8fe6b collected $0.36 from pot
*** SUMMARY ***
Total pot $0.37 | Rake $0.01 | Jackpot $0 | Bingo $0 | Fortune $0
Seat 1: 65b8fe6b (button) collected ($0.36)
Seat 2: Hero (small blind) folded before Flop
Seat 3: 18cf0a2e (big blind) folded before Flop
Seat 4: 8200d36c folded before Flop
Seat 5: 92adae06 folded before Flop (didn't bet)
Seat 6: f6c16b02 folded before Flop


Poker Hand #HD1205631991: Hold'em No Limit  ($0.02/$0.05) - 2023/04/16 19:16:06
Table 'NLHBlue44' 6-max Seat #6 is the button
Seat 1: 65b8fe6b ($9.62 in chips)
Seat 2: Hero ($5 in chips)
Seat 3: 18cf0a2e ($5 in chips)
Seat 4: 8200d36c ($5.29 in chips)
Seat 6: f6c16b02 ($5 in chips)
65b8fe6b: posts small blind $0.02
Hero: posts big blind $0.05
*** HOLE CARDS ***
Dealt to 65b8fe6b 
Dealt to Hero [5d Ah]
Dealt to 18cf0a2e 
Dealt to 8200d36c 
Dealt to f6c16b02 
18cf0a2e: folds
8200d36c: raises $0.05 to $0.1
f6c16b02: calls $0.1
65b8fe6b: folds
Hero: calls $0.05
*** FLOP *** [2s Th Kh]
Hero: checks
8200d36c: bets $0.2
f6c16b02: calls $0.2
Hero: calls $0.2
*** TURN *** [2s Th Kh] [Qc]
Hero: checks
8200d36c: checks
f6c16b02: checks
*** RIVER *** [2s Th Kh Qc] [8h]
Hero: checks
8200d36c: bets $0.46
f6c16b02: folds
Hero: folds
Uncalled bet ($0.46) returned to 8200d36c
*** SHOWDOWN ***
8200d36c collected $0.88 from pot
*** SUMMARY ***
Total pot $0.92 | Rake $0.04 | Jackpot $0 | Bingo $0 | Fortune $0
Board [2s Th Kh Qc 8h]
Seat 1: 65b8fe6b (small blind) folded before Flop
Seat 2: Hero (big blind) folded on the River
Seat 3: 18cf0a2e folded before Flop (didn't bet)
Seat 4: 8200d36c won ($0.88)
Seat 6: f6c16b02 (button) folded on the River


Poker Hand #HD1205631896: Hold'em No Limit  ($0.02/$0.05) - 2023/04/16 19:14:59
Table 'NLHBlue44' 6-max Seat #5 is the button
Seat 1: 65b8fe6b ($5.2 in chips)
Seat 2: Hero ($5 in chips)
Seat 3: 18cf0a2e ($5 in chips)
Seat 4: 8200d36c ($5.29 in chips)
Seat 5: 92adae06 ($4.94 in chips)
Seat 6: f6c16b02 ($5 in chips)
f6c16b02: posts small blind $0.02
65b8fe6b: posts big blind $0.05
*** HOLE CARDS ***
Dealt to 65b8fe6b 
Dealt to Hero [8h 5d]
Dealt to 18cf0a2e 
Dealt to 8200d36c 
Dealt to 92adae06 
Dealt to f6c16b02 
Hero: folds
18cf0a2e: folds
8200d36c: folds
92adae06: raises $0.05 to $0.1
f6c16b02: folds
65b8fe6b: raises $0.22 to $0.32
92adae06: calls $0.22
*** FLOP *** [Js Ts 6h]
65b8fe6b: bets $0.22
92adae06: calls $0.22
*** TURN *** [Js Ts 6h] [Kd]
65b8fe6b: checks
92adae06: bets $0.35
65b8fe6b: raises $0.9 to $1.25
92adae06: raises $3.15 to $4.4 and is all-in
65b8fe6b: calls $3.15
92adae06: shows [9d Qd] (Kings-High Straight)
65b8fe6b: shows [Ad Qs] (Aces-High Straight)
*** RIVER *** [Js Ts 6h Kd] [2d]
*** SHOWDOWN ***
65b8fe6b collected $9.36 from pot
*** SUMMARY ***
Total pot $9.9 | Rake $0.49 | Jackpot $0.05 | Bingo $0 | Fortune $0
Board [Js Ts 6h Kd 2d]
Seat 1: 65b8fe6b (big blind) showed [Ad Qs] and won ($9.36) with Aces-High Straight
Seat 2: Hero folded before Flop (didn't bet)
Seat 3: 18cf0a2e folded before Flop (didn't bet)
Seat 4: 8200d36c folded before Flop (didn't bet)
Seat 5: 92adae06 (button) showed [9d Qd] and lost with Kings-High Straight
Seat 6: f6c16b02 (small blind) folded before Flop


Poker Hand #HD1205631800: Hold'em No Limit  ($0.02/$0.05) - 2023/04/16 19:13:59
Table 'NLHBlue44' 6-max Seat #4 is the button
Seat 1: 65b8fe6b ($4.59 in chips)
Seat 2: Hero ($5 in chips)
Seat 3: 18cf0a2e ($5 in chips)
Seat 4: 8200d36c ($5.89 in chips)
Seat 5: 92adae06 ($4.96 in chips)
Seat 6: f6c16b02 ($5 in chips)
92adae06: posts small blind $0.02
f6c16b02: posts big blind $0.05
*** HOLE CARDS ***
Dealt to 65b8fe6b 
Dealt to Hero [4d Ts]
Dealt to 18cf0a2e 
Dealt to 8200d36c 
Dealt to 92adae06 
Dealt to f6c16b02 
65b8fe6b: raises $0.1 to $0.15
Hero: folds
18cf0a2e: folds
8200d36c: calls $0.15
92adae06: folds
f6c16b02: folds
*** FLOP *** [2h Jc 3h]
65b8fe6b: checks
8200d36c: bets $0.13
65b8fe6b: calls $0.13
*** TURN *** [2h Jc 3h] [9d]
65b8fe6b: checks
8200d36c: checks
*** RIVER *** [2h Jc 3h 9d] [4c]
65b8fe6b: bets $0.32
8200d36c: calls $0.32
65b8fe6b: shows [7d 7h] (Pair of Sevens)
8200d36c: shows [7c 6h] (Jack-High)
*** SHOWDOWN ***
65b8fe6b collected $1.21 from pot
*** SUMMARY ***
Total pot $1.27 | Rake $0.06 | Jackpot $0 | Bingo $0 | Fortune $0
Board [2h Jc 3h 9d 4c]
Seat 1: 65b8fe6b showed [7d 7h] and won ($1.21) with Pair of Sevens
Seat 2: Hero folded before Flop (didn't bet)
Seat 3: 18cf0a2e folded before Flop (didn't bet)
Seat 4: 8200d36c (button) showed [7c 6h] and lost with Jack-High
Seat 5: 92adae06 (small blind) folded before Flop
Seat 6: f6c16b02 (big blind) folded before Flop


Poker Hand #HD1205631776: Hold'em No Limit  ($0.02/$0.05) - 2023/04/16 19:13:45
Table 'NLHBlue44' 6-max Seat #3 is the button
Seat 1: 65b8fe6b ($4.52 in chips)
Seat 2: Hero ($5 in chips)
Seat 3: 18cf0a2e ($5 in chips)
Seat 4: 8200d36c ($5.91 in chips)
Seat 5: 92adae06 ($5.01 in chips)
Seat 6: f6c16b02 ($5 in chips)
8200d36c: posts small blind $0.02
92adae06: posts big blind $0.05
*** HOLE CARDS ***
Dealt to 65b8fe6b 
Dealt to Hero [As 5h]
Dealt to 18cf0a2e 
Dealt to 8200d36c 
Dealt to 92adae06 
Dealt to f6c16b02 
f6c16b02: folds
65b8fe6b: raises $0.1 to $0.15
Hero: folds
18cf0a2e: folds
8200d36c: folds
92adae06: folds
Uncalled bet ($0.1) returned to 65b8fe6b
*** SHOWDOWN ***
65b8fe6b collected $0.12 from pot
*** SUMMARY ***
Total pot $0.12 | Rake $0 | Jackpot $0 | Bingo $0 | Fortune $0
Seat 1: 65b8fe6b collected ($0.12)
Seat 2: Hero folded before Flop (didn't bet)
Seat 3: 18cf0a2e (button) folded before Flop (didn't bet)
Seat 4: 8200d36c (small blind) folded before Flop
Seat 5: 92adae06 (big blind) folded before Flop
Seat 6: f6c16b02 folded before Flop (didn't bet)


Poker Hand #HD1205631741: Hold'em No Limit  ($0.02/$0.05) - 2023/04/16 19:13:22
Table 'NLHBlue44' 6-max Seat #2 is the button
Seat 1: 65b8fe6b ($4.52 in chips)
Seat 2: Hero ($5 in chips)
Seat 3: 18cf0a2e ($5 in chips)
Seat 4: 8200d36c ($5.89 in chips)
Seat 5: 92adae06 ($5.01 in chips)
Seat 6: f6c16b02 ($5 in chips)
18cf0a2e: posts small blind $0.02
8200d36c: posts big blind $0.05
*** HOLE CARDS ***
Dealt to 65b8fe6b 
Dealt to Hero [2h 8s]
Dealt to 18cf0a2e 
Dealt to 8200d36c 
Dealt to 92adae06 
Dealt to f6c16b02 
92adae06: folds
f6c16b02: folds
65b8fe6b: folds
Hero: folds
18cf0a2e: folds
Uncalled bet ($0.03) returned to 8200d36c
*** SHOWDOWN ***
8200d36c collected $0.04 from pot
*** SUMMARY ***
Total pot $0.04 | Rake $0 | Jackpot $0 | Bingo $0 | Fortune $0
Seat 1: 65b8fe6b folded before Flop (didn't bet)
Seat 2: Hero (button) folded before Flop (didn't bet)
Seat 3: 18cf0a2e (small blind) folded before Flop
Seat 4: 8200d36c (big blind) collected ($0.04)
Seat 5: 92adae06 folded before Flop (didn't bet)
Seat 6: f6c16b02 folded before Flop (didn't bet)


Poker Hand #HD1205631711: Hold'em No Limit  ($0.02/$0.05) - 2023/04/16 19:13:04
Table 'NLHBlue44' 6-max Seat #1 is the button
Seat 1: 65b8fe6b ($4.52 in chips)
Seat 2: Hero ($5 in chips)
Seat 3: 18cf0a2e ($5 in chips)
Seat 4: 8200d36c ($5.82 in chips)
Seat 5: 92adae06 ($5.01 in chips)
Hero: posts small blind $0.02
18cf0a2e: posts big blind $0.05
*** HOLE CARDS ***
Dealt to 65b8fe6b 
Dealt to Hero [Jd 7s]
Dealt to 18cf0a2e 
Dealt to 8200d36c 
Dealt to 92adae06 
8200d36c: raises $0.15 to $0.2
92adae06: folds
65b8fe6b: folds
Hero: folds
18cf0a2e: folds
Uncalled bet ($0.15) returned to 8200d36c
*** SHOWDOWN ***
8200d36c collected $0.12 from pot
*** SUMMARY ***
Total pot $0.12 | Rake $0 | Jackpot $0 | Bingo $0 | Fortune $0
Seat 1: 65b8fe6b (button) folded before Flop (didn't bet)
Seat 2: Hero (small blind) folded before Flop
Seat 3: 18cf0a2e (big blind) folded before Flop
Seat 4: 8200d36c collected ($0.12)
Seat 5: 92adae06 folded before Flop (didn't bet)


Poker Hand #HD1205631679: Hold'em No Limit  ($0.02/$0.05) - 2023/04/16 19:12:44
Table 'NLHBlue44' 6-max Seat #6 is the button
Seat 1: 65b8fe6b ($4.54 in chips)
Seat 2: Hero ($5 in chips)
Seat 4: 8200d36c ($5.75 in chips)
Seat 5: 92adae06 ($5.01 in chips)
Seat 6: f6c16b02 ($5 in chips)
65b8fe6b: posts small blind $0.02
Hero: posts big blind $0.05
*** HOLE CARDS ***
Dealt to 65b8fe6b 
Dealt to Hero [Jh 8c]
Dealt to 8200d36c 
Dealt to 92adae06 
Dealt to f6c16b02 
8200d36c: raises $0.1 to $0.15
92adae06: folds
f6c16b02: folds
65b8fe6b: folds
Hero: folds
Uncalled bet ($0.1) returned to 8200d36c
*** SHOWDOWN ***
8200d36c collected $0.12 from pot
*** SUMMARY ***
Total pot $0.12 | Rake $0 | Jackpot $0 | Bingo $0 | Fortune $0
Seat 1: 65b8fe6b (small blind) folded before Flop
Seat 2: Hero (big blind) folded before Flop
Seat 4: 8200d36c collected ($0.12)
Seat 5: 92adae06 folded before Flop (didn't bet)
Seat 6: f6c16b02 (button) folded before Flop (didn't bet)


Poker Hand #HD1205631629: Hold'em No Limit  ($0.02/$0.05) - 2023/04/16 19:12:09
Table 'NLHBlue44' 6-max Seat #5 is the button
Seat 1: 65b8fe6b ($4.64 in chips)
Seat 2: Hero ($5 in chips)
Seat 4: 8200d36c ($5.75 in chips)
Seat 5: 92adae06 ($4.9 in chips)
Seat 6: f6c16b02 ($5 in chips)
f6c16b02: posts small blind $0.02
65b8fe6b: posts big blind $0.05
*** HOLE CARDS ***
Dealt to 65b8fe6b 
Dealt to Hero [8c Th]
Dealt to 8200d36c 
Dealt to 92adae06 
Dealt to f6c16b02 
Hero: folds
8200d36c: folds
92adae06: raises $0.05 to $0.1
f6c16b02: folds
65b8fe6b: calls $0.05
*** FLOP *** [Ad 8d 9c]
65b8fe6b: checks
92adae06: bets $0.1
65b8fe6b: folds
Uncalled bet ($0.1) returned to 92adae06
*** SHOWDOWN ***
92adae06 collected $0.21 from pot
*** SUMMARY ***
Total pot $0.22 | Rake $0.01 | Jackpot $0 | Bingo $0 | Fortune $0
Board [Ad 8d 9c]
Seat 1: 65b8fe6b (big blind) folded on the Flop
Seat 2: Hero folded before Flop (didn't bet)
Seat 4: 8200d36c folded before Flop (didn't bet)
Seat 5: 92adae06 (button) won ($0.21)
Seat 6: f6c16b02 (small blind) folded before Flop


Poker Hand #HD1205631537: Hold'em No Limit  ($0.02/$0.05) - 2023/04/16 19:11:06
Table 'NLHBlue44' 6-max Seat #4 is the button
Seat 1: 65b8fe6b ($4.64 in chips)
Seat 2: Hero ($5 in chips)
Seat 4: 8200d36c ($5.48 in chips)
Seat 5: 92adae06 ($5.02 in chips)
Seat 6: f6c16b02 ($5 in chips)
92adae06: posts small blind $0.02
f6c16b02: posts big blind $0.05
*** HOLE CARDS ***
Dealt to 65b8fe6b 
Dealt to Hero [Kc Jc]
Dealt to 8200d36c 
Dealt to 92adae06 
Dealt to f6c16b02 
65b8fe6b: folds
Hero: raises $0.07 to $0.12
8200d36c: calls $0.12
92adae06: calls $0.1
f6c16b02: folds
*** FLOP *** [5h 8d 2h]
92adae06: checks
Hero: checks
8200d36c: checks
*** TURN *** [5h 8d 2h] [3c]
92adae06: checks
Hero: checks
8200d36c: bets $0.31
92adae06: folds
Hero: folds
Uncalled bet ($0.31) returned to 8200d36c
*** SHOWDOWN ***
8200d36c collected $0.39 from pot
*** SUMMARY ***
Total pot $0.41 | Rake $0.02 | Jackpot $0 | Bingo $0 | Fortune $0
Board [5h 8d 2h 3c]
Seat 1: 65b8fe6b folded before Flop (didn't bet)
Seat 2: Hero folded on the Turn
Seat 4: 8200d36c (button) won ($0.39)
Seat 5: 92adae06 (small blind) folded on the Turn
Seat 6: f6c16b02 (big blind) folded before Flop


Poker Hand #HD1205631514: Hold'em No Limit  ($0.02/$0.05) - 2023/04/16 19:10:54
Table 'NLHBlue44' 6-max Seat #2 is the button
Seat 1: 65b8fe6b ($4.57 in chips)
Seat 2: Hero ($5 in chips)
Seat 4: 8200d36c ($5.5 in chips)
Seat 5: 92adae06 ($5.07 in chips)
8200d36c: posts small blind $0.02
92adae06: posts big blind $0.05
*** HOLE CARDS ***
Dealt to 65b8fe6b 
Dealt to Hero [2d 9c]
Dealt to 8200d36c 
Dealt to 92adae06 
65b8fe6b: raises $0.1 to $0.15
Hero: folds
8200d36c: folds
92adae06: folds
Uncalled bet ($0.1) returned to 65b8fe6b
*** SHOWDOWN ***
65b8fe6b collected $0.12 from pot
*** SUMMARY ***
Total pot $0.12 | Rake $0 | Jackpot $0 | Bingo $0 | Fortune $0
Seat 1: 65b8fe6b collected ($0.12)
Seat 2: Hero (button) folded before Flop (didn't bet)
Seat 4: 8200d36c (small blind) folded before Flop
Seat 5: 92adae06 (big blind) folded before Flop


Poker Hand #HD1205631467: Hold'em No Limit  ($0.02/$0.05) - 2023/04/16 19:10:29
Table 'NLHBlue44' 6-max Seat #1 is the button
Seat 1: 65b8fe6b ($4.72 in chips)
Seat 2: Hero ($5 in chips)
Seat 4: 8200d36c ($5.34 in chips)
Seat 5: 92adae06 ($5.07 in chips)
Hero: posts small blind $0.02
8200d36c: posts big blind $0.05
*** HOLE CARDS ***
Dealt to 65b8fe6b 
Dealt to Hero [4c 5s]
Dealt to 8200d36c 
Dealt to 92adae06 
92adae06: folds
65b8fe6b: raises $0.1 to $0.15
Hero: folds
8200d36c: calls $0.1
*** FLOP *** [7s 6d 6s]
8200d36c: checks
65b8fe6b: checks
*** TURN *** [7s 6d 6s] [Jc]
8200d36c: bets $0.16
65b8fe6b: folds
Uncalled bet ($0.16) returned to 8200d36c
*** SHOWDOWN ***
8200d36c collected $0.31 from pot
*** SUMMARY ***
Total pot $0.32 | Rake $0.01 | Jackpot $0 | Bingo $0 | Fortune $0
Board [7s 6d 6s Jc]
Seat 1: 65b8fe6b (button) folded on the Turn
Seat 2: Hero (small blind) folded before Flop
Seat 4: 8200d36c (big blind) won ($0.31)
Seat 5: 92adae06 folded before Flop (didn't bet)


Poker Hand #HD1205631445: Hold'em No Limit  ($0.02/$0.05) - 2023/04/16 19:10:15
Table 'NLHBlue44' 6-max Seat #5 is the button
Seat 1: 65b8fe6b ($4.74 in chips)
Seat 2: Hero ($5 in chips)
Seat 4: 8200d36c ($5.27 in chips)
Seat 5: 92adae06 ($5.07 in chips)
65b8fe6b: posts small blind $0.02
Hero: posts big blind $0.05
*** HOLE CARDS ***
Dealt to 65b8fe6b 
Dealt to Hero [Qc 4s]
Dealt to 8200d36c 
Dealt to 92adae06 
8200d36c: raises $0.1 to $0.15
92adae06: folds
65b8fe6b: folds
Hero: folds
Uncalled bet ($0.1) returned to 8200d36c
*** SHOWDOWN ***
8200d36c collected $0.12 from pot
*** SUMMARY ***
Total pot $0.12 | Rake $0 | Jackpot $0 | Bingo $0 | Fortune $0
Seat 1: 65b8fe6b (small blind) folded before Flop
Seat 2: Hero (big blind) folded before Flop
Seat 4: 8200d36c collected ($0.12)
Seat 5: 92adae06 (button) folded before Flop (didn't bet)


Poker Hand #HD1205631420: Hold'em No Limit  ($0.02/$0.05) - 2023/04/16 19:09:56
Table 'NLHBlue44' 6-max Seat #4 is the button
Seat 1: 65b8fe6b ($4.61 in chips)
Seat 2: Hero ($5 in chips)
Seat 4: 8200d36c ($5.27 in chips)
Seat 5: 92adae06 ($5.09 in chips)
92adae06: posts small blind $0.02
65b8fe6b: posts big blind $0.05
*** HOLE CARDS ***
Dealt to 65b8fe6b 
Dealt to Hero [6s 5s]
Dealt to 8200d36c 
Dealt to 92adae06 
Hero: raises $0.07 to $0.12
8200d36c: folds
92adae06: folds
65b8fe6b: raises $0.26 to $0.38
Hero: folds
Uncalled bet ($0.26) returned to 65b8fe6b
*** SHOWDOWN ***
65b8fe6b collected $0.25 from pot
*** SUMMARY ***
Total pot $0.26 | Rake $0.01 | Jackpot $0 | Bingo $0 | Fortune $0
Seat 1: 65b8fe6b (big blind) collected ($0.25)
Seat 2: Hero folded before Flop
Seat 4: 8200d36c (button) folded before Flop (didn't bet)
Seat 5: 92adae06 (small blind) folded before Flop


Poker Hand #HD1205631395: Hold'em No Limit  ($0.02/$0.05) - 2023/04/16 19:09:34
Table 'NLHBlue44' 6-max Seat #2 is the button
Seat 1: 65b8fe6b ($4.61 in chips)
Seat 2: Hero ($5 in chips)
Seat 4: 8200d36c ($5.37 in chips)
Seat 5: 92adae06 ($5 in chips)
8200d36c: posts small blind $0.02
92adae06: posts big blind $0.05
*** HOLE CARDS ***
Dealt to 65b8fe6b 
Dealt to Hero [6s Jd]
Dealt to 8200d36c 
Dealt to 92adae06 
65b8fe6b: folds
Hero: folds
8200d36c: raises $0.05 to $0.1
92adae06: raises $0.25 to $0.35
8200d36c: folds
Uncalled bet ($0.25) returned to 92adae06
*** SHOWDOWN ***
92adae06 collected $0.19 from pot
*** SUMMARY ***
Total pot $0.2 | Rake $0.01 | Jackpot $0 | Bingo $0 | Fortune $0
Seat 1: 65b8fe6b folded before Flop (didn't bet)
Seat 2: Hero (button) folded before Flop (didn't bet)
Seat 4: 8200d36c (small blind) folded before Flop
Seat 5: 92adae06 (big blind) collected ($0.19)


Poker Hand #HD1205631347: Hold'em No Limit  ($0.02/$0.05) - 2023/04/16 19:09:02
Table 'NLHBlue44' 6-max Seat #1 is the button
Seat 1: 65b8fe6b ($5 in chips)
Seat 2: Hero ($5 in chips)
Seat 4: 8200d36c ($5 in chips)
Hero: posts small blind $0.02
8200d36c: posts big blind $0.05
*** HOLE CARDS ***
Dealt to 65b8fe6b 
Dealt to Hero [Jc Td]
Dealt to 8200d36c 
65b8fe6b: raises $0.1 to $0.15
Hero: folds
8200d36c: calls $0.1
*** FLOP *** [4c 2h Th]
8200d36c: bets $0.24
65b8fe6b: calls $0.24
*** TURN *** [4c 2h Th] [Ks]
8200d36c: bets $0.8
65b8fe6b: folds
Uncalled bet ($0.8) returned to 8200d36c
*** SHOWDOWN ***
8200d36c collected $0.76 from pot
*** SUMMARY ***
Total pot $0.8 | Rake $0.04 | Jackpot $0 | Bingo $0 | Fortune $0
Board [4c 2h Th Ks]
Seat 1: 65b8fe6b (button) folded on the Turn
Seat 2: Hero (small blind) folded before Flop
Seat 4: 8200d36c (big blind) won ($0.76)


