Poker Hand #HD1174565481: Hold'em No Limit  ($0.02/$0.05) - 2023/03/25 00:08:23
Table 'NLHBlue29' 6-max Seat #5 is the button
Seat 1: 68dd9c04 ($0.8 in chips)
Seat 2: Hero ($5.15 in chips)
Seat 3: 5a617b9a ($10.3 in chips)
Seat 4: 56ad38ce ($7.4 in chips)
Seat 5: 92dc9d57 ($6.87 in chips)
Seat 6: 86d3fd28 ($8.97 in chips)
86d3fd28: posts small blind $0.02
68dd9c04: posts big blind $0.05
*** HOLE CARDS ***
Dealt to 68dd9c04 
Dealt to Hero [Ks 2c]
Dealt to 5a617b9a 
Dealt to 56ad38ce 
Dealt to 92dc9d57 
Dealt to 86d3fd28 
Hero: folds
5a617b9a: folds
56ad38ce: folds
92dc9d57: raises $0.1 to $0.15
86d3fd28: folds
68dd9c04: calls $0.1
*** FLOP *** [8d Jd 3d]
68dd9c04: checks
92dc9d57: bets $0.25
68dd9c04: folds
Uncalled bet ($0.25) returned to 92dc9d57
*** SHOWDOWN ***
92dc9d57 collected $0.31 from pot
*** SUMMARY ***
Total pot $0.32 | Rake $0.01 | Jackpot $0 | Bingo $0 | Fortune $0
Board [8d Jd 3d]
Seat 1: 68dd9c04 (big blind) folded on the Flop
Seat 2: Hero folded before Flop (didn't bet)
Seat 3: 5a617b9a folded before Flop (didn't bet)
Seat 4: 56ad38ce folded before Flop (didn't bet)
Seat 5: 92dc9d57 (button) won ($0.31)
Seat 6: 86d3fd28 (small blind) folded before Flop


Poker Hand #HD1174565441: Hold'em No Limit  ($0.02/$0.05) - 2023/03/25 00:08:03
Table 'NLHBlue29' 6-max Seat #4 is the button
Seat 1: 68dd9c04 ($0.73 in chips)
Seat 2: Hero ($5.15 in chips)
Seat 3: 5a617b9a ($10.3 in chips)
Seat 4: 56ad38ce ($7.4 in chips)
Seat 5: 92dc9d57 ($6.89 in chips)
Seat 6: 86d3fd28 ($9.02 in chips)
92dc9d57: posts small blind $0.02
86d3fd28: posts big blind $0.05
*** HOLE CARDS ***
Dealt to 68dd9c04 
Dealt to Hero [8h Kd]
Dealt to 5a617b9a 
Dealt to 56ad38ce 
Dealt to 92dc9d57 
Dealt to 86d3fd28 
68dd9c04: raises $0.12 to $0.17
Hero: folds
5a617b9a: folds
56ad38ce: folds
92dc9d57: folds
86d3fd28: folds
Uncalled bet ($0.12) returned to 68dd9c04
*** SHOWDOWN ***
68dd9c04 collected $0.12 from pot
*** SUMMARY ***
Total pot $0.12 | Rake $0 | Jackpot $0 | Bingo $0 | Fortune $0
Seat 1: 68dd9c04 collected ($0.12)
Seat 2: Hero folded before Flop (didn't bet)
Seat 3: 5a617b9a folded before Flop (didn't bet)
Seat 4: 56ad38ce (button) folded before Flop (didn't bet)
Seat 5: 92dc9d57 (small blind) folded before Flop
Seat 6: 86d3fd28 (big blind) folded before Flop


Poker Hand #HD1174565354: Hold'em No Limit  ($0.02/$0.05) - 2023/03/25 00:07:19
Table 'NLHBlue29' 6-max Seat #3 is the button
Seat 1: 68dd9c04 ($0.78 in chips)
Seat 2: Hero ($5.15 in chips)
Seat 3: 5a617b9a ($10.3 in chips)
Seat 4: 56ad38ce ($7.3 in chips)
Seat 5: 92dc9d57 ($6.94 in chips)
Seat 6: 86d3fd28 ($9.02 in chips)
56ad38ce: posts small blind $0.02
92dc9d57: posts big blind $0.05
*** HOLE CARDS ***
Dealt to 68dd9c04 
Dealt to Hero [3s 8s]
Dealt to 5a617b9a 
Dealt to 56ad38ce 
Dealt to 92dc9d57 
Dealt to 86d3fd28 
86d3fd28: folds
68dd9c04: calls $0.05
Hero: folds
5a617b9a: folds
56ad38ce: calls $0.03
92dc9d57: checks
*** FLOP *** [Qc Th 3d]
56ad38ce: bets $0.1
92dc9d57: folds
68dd9c04: folds
Uncalled bet ($0.1) returned to 56ad38ce
*** SHOWDOWN ***
56ad38ce collected $0.15 from pot
*** SUMMARY ***
Total pot $0.15 | Rake $0 | Jackpot $0 | Bingo $0 | Fortune $0
Board [Qc Th 3d]
Seat 1: 68dd9c04 folded on the Flop
Seat 2: Hero folded before Flop (didn't bet)
Seat 3: 5a617b9a (button) folded before Flop (didn't bet)
Seat 4: 56ad38ce (small blind) won ($0.15)
Seat 5: 92dc9d57 (big blind) folded on the Flop
Seat 6: 86d3fd28 folded before Flop (didn't bet)


Poker Hand #HD1174565274: Hold'em No Limit  ($0.02/$0.05) - 2023/03/25 00:06:39
Table 'NLHBlue29' 6-max Seat #2 is the button
Seat 1: 68dd9c04 ($0.78 in chips)
Seat 2: Hero ($5.15 in chips)
Seat 3: 5a617b9a ($10.45 in chips)
Seat 4: 56ad38ce ($7.16 in chips)
Seat 5: 92dc9d57 ($6.94 in chips)
Seat 6: 86d3fd28 ($9.02 in chips)
5a617b9a: posts small blind $0.02
56ad38ce: posts big blind $0.05
*** HOLE CARDS ***
Dealt to 68dd9c04 
Dealt to Hero [5c 2h]
Dealt to 5a617b9a 
Dealt to 56ad38ce 
Dealt to 92dc9d57 
Dealt to 86d3fd28 
92dc9d57: folds
86d3fd28: folds
68dd9c04: folds
Hero: folds
5a617b9a: raises $0.1 to $0.15
56ad38ce: raises $0.35 to $0.5
5a617b9a: folds
Uncalled bet ($0.35) returned to 56ad38ce
*** SHOWDOWN ***
56ad38ce collected $0.29 from pot
*** SUMMARY ***
Total pot $0.3 | Rake $0.01 | Jackpot $0 | Bingo $0 | Fortune $0
Seat 1: 68dd9c04 folded before Flop (didn't bet)
Seat 2: Hero (button) folded before Flop (didn't bet)
Seat 3: 5a617b9a (small blind) folded before Flop
Seat 4: 56ad38ce (big blind) collected ($0.29)
Seat 5: 92dc9d57 folded before Flop (didn't bet)
Seat 6: 86d3fd28 folded before Flop (didn't bet)


Poker Hand #HD1174565233: Hold'em No Limit  ($0.02/$0.05) - 2023/03/25 00:06:17
Table 'NLHBlue29' 6-max Seat #1 is the button
Seat 1: 68dd9c04 ($0.71 in chips)
Seat 2: Hero ($5.17 in chips)
Seat 3: 5a617b9a ($10.5 in chips)
Seat 4: 56ad38ce ($7.16 in chips)
Seat 5: 92dc9d57 ($6.94 in chips)
Seat 6: 86d3fd28 ($9.02 in chips)
Hero: posts small blind $0.02
5a617b9a: posts big blind $0.05
*** HOLE CARDS ***
Dealt to 68dd9c04 
Dealt to Hero [Kh 6c]
Dealt to 5a617b9a 
Dealt to 56ad38ce 
Dealt to 92dc9d57 
Dealt to 86d3fd28 
56ad38ce: folds
92dc9d57: folds
86d3fd28: folds
68dd9c04: raises $0.12 to $0.17
Hero: folds
5a617b9a: folds
Uncalled bet ($0.12) returned to 68dd9c04
*** SHOWDOWN ***
68dd9c04 collected $0.12 from pot
*** SUMMARY ***
Total pot $0.12 | Rake $0 | Jackpot $0 | Bingo $0 | Fortune $0
Seat 1: 68dd9c04 (button) collected ($0.12)
Seat 2: Hero (small blind) folded before Flop
Seat 3: 5a617b9a (big blind) folded before Flop
Seat 4: 56ad38ce folded before Flop (didn't bet)
Seat 5: 92dc9d57 folded before Flop (didn't bet)
Seat 6: 86d3fd28 folded before Flop (didn't bet)


Poker Hand #HD1174565130: Hold'em No Limit  ($0.02/$0.05) - 2023/03/25 00:05:32
Table 'NLHBlue29' 6-max Seat #6 is the button
Seat 1: 68dd9c04 ($0.73 in chips)
Seat 2: Hero ($5.32 in chips)
Seat 3: 5a617b9a ($10.5 in chips)
Seat 4: 56ad38ce ($7.16 in chips)
Seat 5: 92dc9d57 ($6.78 in chips)
Seat 6: 86d3fd28 ($9.02 in chips)
68dd9c04: posts small blind $0.02
Hero: posts big blind $0.05
*** HOLE CARDS ***
Dealt to 68dd9c04 
Dealt to Hero [8s 6s]
Dealt to 5a617b9a 
Dealt to 56ad38ce 
Dealt to 92dc9d57 
Dealt to 86d3fd28 
5a617b9a: folds
56ad38ce: folds
92dc9d57: raises $0.1 to $0.15
86d3fd28: folds
68dd9c04: folds
Hero: calls $0.1
*** FLOP *** [Tc Qd Jc]
Hero: checks
92dc9d57: bets $0.18
Hero: folds
Uncalled bet ($0.18) returned to 92dc9d57
*** SHOWDOWN ***
92dc9d57 collected $0.31 from pot
*** SUMMARY ***
Total pot $0.32 | Rake $0.01 | Jackpot $0 | Bingo $0 | Fortune $0
Board [Tc Qd Jc]
Seat 1: 68dd9c04 (small blind) folded before Flop
Seat 2: Hero (big blind) folded on the Flop
Seat 3: 5a617b9a folded before Flop (didn't bet)
Seat 4: 56ad38ce folded before Flop (didn't bet)
Seat 5: 92dc9d57 won ($0.31)
Seat 6: 86d3fd28 (button) folded before Flop (didn't bet)


Poker Hand #HD1174565077: Hold'em No Limit  ($0.02/$0.05) - 2023/03/25 00:05:09
Table 'NLHBlue29' 6-max Seat #5 is the button
Seat 1: 68dd9c04 ($0.71 in chips)
Seat 2: Hero ($5.32 in chips)
Seat 3: 5a617b9a ($10.5 in chips)
Seat 4: 56ad38ce ($7.16 in chips)
Seat 5: 92dc9d57 ($6.78 in chips)
Seat 6: 86d3fd28 ($9.04 in chips)
86d3fd28: posts small blind $0.02
68dd9c04: posts big blind $0.05
*** HOLE CARDS ***
Dealt to 68dd9c04 
Dealt to Hero [Qd 4s]
Dealt to 5a617b9a 
Dealt to 56ad38ce 
Dealt to 92dc9d57 
Dealt to 86d3fd28 
Hero: folds
5a617b9a: folds
56ad38ce: folds
92dc9d57: folds
86d3fd28: folds
Uncalled bet ($0.03) returned to 68dd9c04
*** SHOWDOWN ***
68dd9c04 collected $0.04 from pot
*** SUMMARY ***
Total pot $0.04 | Rake $0 | Jackpot $0 | Bingo $0 | Fortune $0
Seat 1: 68dd9c04 (big blind) collected ($0.04)
Seat 2: Hero folded before Flop (didn't bet)
Seat 3: 5a617b9a folded before Flop (didn't bet)
Seat 4: 56ad38ce folded before Flop (didn't bet)
Seat 5: 92dc9d57 (button) folded before Flop (didn't bet)
Seat 6: 86d3fd28 (small blind) folded before Flop


Poker Hand #HD1174564961: Hold'em No Limit  ($0.02/$0.05) - 2023/03/25 00:04:17
Table 'NLHBlue29' 6-max Seat #4 is the button
Seat 1: 68dd9c04 ($0.91 in chips)
Seat 2: Hero ($5.32 in chips)
Seat 3: 5a617b9a ($10.25 in chips)
Seat 4: 56ad38ce ($7.16 in chips)
Seat 5: 92dc9d57 ($6.8 in chips)
Seat 6: 86d3fd28 ($9.09 in chips)
92dc9d57: posts small blind $0.02
86d3fd28: posts big blind $0.05
*** HOLE CARDS ***
Dealt to 68dd9c04 
Dealt to Hero [7h Ah]
Dealt to 5a617b9a 
Dealt to 56ad38ce 
Dealt to 92dc9d57 
Dealt to 86d3fd28 
68dd9c04: calls $0.05
Hero: folds
5a617b9a: raises $0.15 to $0.2
56ad38ce: folds
92dc9d57: folds
86d3fd28: folds
68dd9c04: calls $0.15
*** FLOP *** [Ac 4h 9c]
68dd9c04: checks
5a617b9a: bets $0.36
68dd9c04: folds
Uncalled bet ($0.36) returned to 5a617b9a
*** SHOWDOWN ***
5a617b9a collected $0.45 from pot
*** SUMMARY ***
Total pot $0.47 | Rake $0.02 | Jackpot $0 | Bingo $0 | Fortune $0
Board [Ac 4h 9c]
Seat 1: 68dd9c04 folded on the Flop
Seat 2: Hero folded before Flop (didn't bet)
Seat 3: 5a617b9a won ($0.45)
Seat 4: 56ad38ce (button) folded before Flop (didn't bet)
Seat 5: 92dc9d57 (small blind) folded before Flop
Seat 6: 86d3fd28 (big blind) folded before Flop


Poker Hand #HD1174564915: Hold'em No Limit  ($0.02/$0.05) - 2023/03/25 00:03:54
Table 'NLHBlue29' 6-max Seat #3 is the button
Seat 1: 68dd9c04 ($0.91 in chips)
Seat 2: Hero ($5.32 in chips)
Seat 3: 5a617b9a ($10.25 in chips)
Seat 4: 56ad38ce ($7.11 in chips)
Seat 5: 92dc9d57 ($6.85 in chips)
Seat 6: 86d3fd28 ($9.09 in chips)
56ad38ce: posts small blind $0.02
92dc9d57: posts big blind $0.05
*** HOLE CARDS ***
Dealt to 68dd9c04 
Dealt to Hero [As 4h]
Dealt to 5a617b9a 
Dealt to 56ad38ce 
Dealt to 92dc9d57 
Dealt to 86d3fd28 
86d3fd28: folds
68dd9c04: folds
Hero: folds
5a617b9a: folds
56ad38ce: raises $0.05 to $0.1
92dc9d57: folds
Uncalled bet ($0.05) returned to 56ad38ce
*** SHOWDOWN ***
56ad38ce collected $0.1 from pot
*** SUMMARY ***
Total pot $0.1 | Rake $0 | Jackpot $0 | Bingo $0 | Fortune $0
Seat 1: 68dd9c04 folded before Flop (didn't bet)
Seat 2: Hero folded before Flop (didn't bet)
Seat 3: 5a617b9a (button) folded before Flop (didn't bet)
Seat 4: 56ad38ce (small blind) collected ($0.1)
Seat 5: 92dc9d57 (big blind) folded before Flop
Seat 6: 86d3fd28 folded before Flop (didn't bet)


Poker Hand #HD1174564793: Hold'em No Limit  ($0.02/$0.05) - 2023/03/25 00:02:52
Table 'NLHBlue29' 6-max Seat #2 is the button
Seat 1: 68dd9c04 ($0.73 in chips)
Seat 2: Hero ($5.32 in chips)
Seat 3: 5a617b9a ($10.27 in chips)
Seat 4: 56ad38ce ($7.28 in chips)
Seat 5: 92dc9d57 ($6.85 in chips)
Seat 6: 86d3fd28 ($9.09 in chips)
5a617b9a: posts small blind $0.02
56ad38ce: posts big blind $0.05
*** HOLE CARDS ***
Dealt to 68dd9c04 
Dealt to Hero [2s 8c]
Dealt to 5a617b9a 
Dealt to 56ad38ce 
Dealt to 92dc9d57 
Dealt to 86d3fd28 
92dc9d57: folds
86d3fd28: folds
68dd9c04: raises $0.12 to $0.17
Hero: folds
5a617b9a: folds
56ad38ce: calls $0.12
*** FLOP *** [Td 6h Kh]
56ad38ce: checks
68dd9c04: bets $0.56 and is all-in
56ad38ce: folds
Uncalled bet ($0.56) returned to 68dd9c04
*** SHOWDOWN ***
68dd9c04 collected $0.35 from pot
*** SUMMARY ***
Total pot $0.36 | Rake $0.01 | Jackpot $0 | Bingo $0 | Fortune $0
Board [Td 6h Kh]
Seat 1: 68dd9c04 won ($0.35)
Seat 2: Hero (button) folded before Flop (didn't bet)
Seat 3: 5a617b9a (small blind) folded before Flop
Seat 4: 56ad38ce (big blind) folded on the Flop
Seat 5: 92dc9d57 folded before Flop (didn't bet)
Seat 6: 86d3fd28 folded before Flop (didn't bet)


Poker Hand #HD1174564754: Hold'em No Limit  ($0.02/$0.05) - 2023/03/25 00:02:35
Table 'NLHBlue29' 6-max Seat #1 is the button
Seat 1: 68dd9c04 ($0.73 in chips)
Seat 2: Hero ($5.34 in chips)
Seat 3: 5a617b9a ($10.32 in chips)
Seat 4: 56ad38ce ($7.21 in chips)
Seat 5: 92dc9d57 ($6.85 in chips)
Seat 6: 86d3fd28 ($9.09 in chips)
Hero: posts small blind $0.02
5a617b9a: posts big blind $0.05
*** HOLE CARDS ***
Dealt to 68dd9c04 
Dealt to Hero [Th 5c]
Dealt to 5a617b9a 
Dealt to 56ad38ce 
Dealt to 92dc9d57 
Dealt to 86d3fd28 
56ad38ce: raises $0.08 to $0.13
92dc9d57: folds
86d3fd28: folds
68dd9c04: folds
Hero: folds
5a617b9a: folds
Uncalled bet ($0.08) returned to 56ad38ce
*** SHOWDOWN ***
56ad38ce collected $0.12 from pot
*** SUMMARY ***
Total pot $0.12 | Rake $0 | Jackpot $0 | Bingo $0 | Fortune $0
Seat 1: 68dd9c04 (button) folded before Flop (didn't bet)
Seat 2: Hero (small blind) folded before Flop
Seat 3: 5a617b9a (big blind) folded before Flop
Seat 4: 56ad38ce collected ($0.12)
Seat 5: 92dc9d57 folded before Flop (didn't bet)
Seat 6: 86d3fd28 folded before Flop (didn't bet)


Poker Hand #HD1174564707: Hold'em No Limit  ($0.02/$0.05) - 2023/03/25 00:02:15
Table 'NLHBlue29' 6-max Seat #6 is the button
Seat 1: 68dd9c04 ($0.75 in chips)
Seat 2: Hero ($5.32 in chips)
Seat 3: 5a617b9a ($10.32 in chips)
Seat 4: 56ad38ce ($7.21 in chips)
Seat 5: 92dc9d57 ($6.85 in chips)
Seat 6: 86d3fd28 ($9.09 in chips)
68dd9c04: posts small blind $0.02
Hero: posts big blind $0.05
*** HOLE CARDS ***
Dealt to 68dd9c04 
Dealt to Hero [7h Jc]
Dealt to 5a617b9a 
Dealt to 56ad38ce 
Dealt to 92dc9d57 
Dealt to 86d3fd28 
5a617b9a: folds
56ad38ce: folds
92dc9d57: folds
86d3fd28: folds
68dd9c04: folds
Uncalled bet ($0.03) returned to Hero
*** SHOWDOWN ***
Hero collected $0.04 from pot
*** SUMMARY ***
Total pot $0.04 | Rake $0 | Jackpot $0 | Bingo $0 | Fortune $0
Seat 1: 68dd9c04 (small blind) folded before Flop
Seat 2: Hero (big blind) collected ($0.04)
Seat 3: 5a617b9a folded before Flop (didn't bet)
Seat 4: 56ad38ce folded before Flop (didn't bet)
Seat 5: 92dc9d57 folded before Flop (didn't bet)
Seat 6: 86d3fd28 (button) folded before Flop (didn't bet)


Poker Hand #HD1174564544: Hold'em No Limit  ($0.02/$0.05) - 2023/03/25 00:00:55
Table 'NLHBlue29' 6-max Seat #5 is the button
Seat 1: 68dd9c04 ($1 in chips)
Seat 2: Hero ($5.07 in chips)
Seat 3: 5a617b9a ($10.32 in chips)
Seat 4: 56ad38ce ($7.21 in chips)
Seat 5: 92dc9d57 ($6.85 in chips)
Seat 6: 86d3fd28 ($9.11 in chips)
86d3fd28: posts small blind $0.02
68dd9c04: posts big blind $0.05
*** HOLE CARDS ***
Dealt to 68dd9c04 
Dealt to Hero [Kc Ad]
Dealt to 5a617b9a 
Dealt to 56ad38ce 
Dealt to 92dc9d57 
Dealt to 86d3fd28 
Hero: raises $0.07 to $0.12
5a617b9a: folds
56ad38ce: folds
92dc9d57: folds
86d3fd28: folds
68dd9c04: calls $0.07
*** FLOP *** [Qd 3s 4c]
68dd9c04: checks
Hero: bets $0.13
68dd9c04: calls $0.13
*** TURN *** [Qd 3s 4c] [As]
68dd9c04: checks
Hero: checks
*** RIVER *** [Qd 3s 4c As] [5c]
68dd9c04: checks
Hero: bets $0.78
68dd9c04: folds
Uncalled bet ($0.78) returned to Hero
*** SHOWDOWN ***
Hero collected $0.5 from pot
*** SUMMARY ***
Total pot $0.52 | Rake $0.02 | Jackpot $0 | Bingo $0 | Fortune $0
Board [Qd 3s 4c As 5c]
Seat 1: 68dd9c04 (big blind) folded on the River
Seat 2: Hero won ($0.5)
Seat 3: 5a617b9a folded before Flop (didn't bet)
Seat 4: 56ad38ce folded before Flop (didn't bet)
Seat 5: 92dc9d57 (button) folded before Flop (didn't bet)
Seat 6: 86d3fd28 (small blind) folded before Flop


Poker Hand #HD1174564484: Hold'em No Limit  ($0.02/$0.05) - 2023/03/25 00:00:29
Table 'NLHBlue29' 6-max Seat #4 is the button
Seat 2: Hero ($5 in chips)
Seat 3: 5a617b9a ($10.32 in chips)
Seat 4: 56ad38ce ($7.21 in chips)
Seat 5: 92dc9d57 ($6.87 in chips)
Seat 6: 86d3fd28 ($9.16 in chips)
92dc9d57: posts small blind $0.02
86d3fd28: posts big blind $0.05
*** HOLE CARDS ***
Dealt to Hero [9h 9d]
Dealt to 5a617b9a 
Dealt to 56ad38ce 
Dealt to 92dc9d57 
Dealt to 86d3fd28 
Hero: raises $0.07 to $0.12
5a617b9a: folds
56ad38ce: folds
92dc9d57: folds
86d3fd28: folds
Uncalled bet ($0.07) returned to Hero
*** SHOWDOWN ***
Hero collected $0.12 from pot
*** SUMMARY ***
Total pot $0.12 | Rake $0 | Jackpot $0 | Bingo $0 | Fortune $0
Seat 2: Hero collected ($0.12)
Seat 3: 5a617b9a folded before Flop (didn't bet)
Seat 4: 56ad38ce (button) folded before Flop (didn't bet)
Seat 5: 92dc9d57 (small blind) folded before Flop
Seat 6: 86d3fd28 (big blind) folded before Flop


Poker Hand #HD1174564428: Hold'em No Limit  ($0.02/$0.05) - 2023/03/25 00:00:05
Table 'NLHBlue29' 6-max Seat #3 is the button
Seat 2: Hero ($5 in chips)
Seat 3: 5a617b9a ($10.32 in chips)
Seat 4: 56ad38ce ($7.16 in chips)
Seat 5: 92dc9d57 ($6.92 in chips)
Seat 6: 86d3fd28 ($9.16 in chips)
56ad38ce: posts small blind $0.02
92dc9d57: posts big blind $0.05
*** HOLE CARDS ***
Dealt to Hero [6h 7s]
Dealt to 5a617b9a 
Dealt to 56ad38ce 
Dealt to 92dc9d57 
Dealt to 86d3fd28 
86d3fd28: folds
Hero: folds
5a617b9a: folds
56ad38ce: raises $0.1 to $0.15
92dc9d57: folds
Uncalled bet ($0.1) returned to 56ad38ce
*** SHOWDOWN ***
56ad38ce collected $0.1 from pot
*** SUMMARY ***
Total pot $0.1 | Rake $0 | Jackpot $0 | Bingo $0 | Fortune $0
Seat 2: Hero folded before Flop (didn't bet)
Seat 3: 5a617b9a (button) folded before Flop (didn't bet)
Seat 4: 56ad38ce (small blind) collected ($0.1)
Seat 5: 92dc9d57 (big blind) folded before Flop
Seat 6: 86d3fd28 folded before Flop (didn't bet)


Poker Hand #HD1174564366: Hold'em No Limit  ($0.02/$0.05) - 2023/03/24 23:59:44
Table 'NLHBlue29' 6-max Seat #2 is the button
Seat 2: Hero ($5 in chips)
Seat 3: 5a617b9a ($10.34 in chips)
Seat 4: 56ad38ce ($7.21 in chips)
Seat 5: 92dc9d57 ($6.92 in chips)
Seat 6: 86d3fd28 ($9.09 in chips)
5a617b9a: posts small blind $0.02
56ad38ce: posts big blind $0.05
*** HOLE CARDS ***
Dealt to Hero [6h 9s]
Dealt to 5a617b9a 
Dealt to 56ad38ce 
Dealt to 92dc9d57 
Dealt to 86d3fd28 
92dc9d57: folds
86d3fd28: raises $0.1 to $0.15
Hero: folds
5a617b9a: folds
56ad38ce: folds
Uncalled bet ($0.1) returned to 86d3fd28
*** SHOWDOWN ***
86d3fd28 collected $0.12 from pot
*** SUMMARY ***
Total pot $0.12 | Rake $0 | Jackpot $0 | Bingo $0 | Fortune $0
Seat 2: Hero (button) folded before Flop (didn't bet)
Seat 3: 5a617b9a (small blind) folded before Flop
Seat 4: 56ad38ce (big blind) folded before Flop
Seat 5: 92dc9d57 folded before Flop (didn't bet)
Seat 6: 86d3fd28 collected ($0.12)


Poker Hand #HD1174564270: Hold'em No Limit  ($0.02/$0.05) - 2023/03/24 23:59:02
Table 'NLHBlue29' 6-max Seat #6 is the button
Seat 2: Hero ($5 in chips)
Seat 3: 5a617b9a ($10.21 in chips)
Seat 4: 56ad38ce ($7.21 in chips)
Seat 5: 92dc9d57 ($6.92 in chips)
Seat 6: 86d3fd28 ($9.09 in chips)
Hero: posts small blind $0.02
5a617b9a: posts big blind $0.05
*** HOLE CARDS ***
Dealt to Hero [5d Qd]
Dealt to 5a617b9a 
Dealt to 56ad38ce 
Dealt to 92dc9d57 
Dealt to 86d3fd28 
56ad38ce: folds
92dc9d57: folds
86d3fd28: folds
Hero: raises $0.09 to $0.14
5a617b9a: calls $0.09
*** FLOP *** [3c 6h 7s]
Hero: checks
5a617b9a: checks
*** TURN *** [3c 6h 7s] [Kd]
Hero: checks
5a617b9a: bets $0.28
Hero: folds
Uncalled bet ($0.28) returned to 5a617b9a
*** SHOWDOWN ***
5a617b9a collected $0.27 from pot
*** SUMMARY ***
Total pot $0.28 | Rake $0.01 | Jackpot $0 | Bingo $0 | Fortune $0
Board [3c 6h 7s Kd]
Seat 2: Hero (small blind) folded on the Turn
Seat 3: 5a617b9a (big blind) won ($0.27)
Seat 4: 56ad38ce folded before Flop (didn't bet)
Seat 5: 92dc9d57 folded before Flop (didn't bet)
Seat 6: 86d3fd28 (button) folded before Flop (didn't bet)


Poker Hand #HD1174564187: Hold'em No Limit  ($0.02/$0.05) - 2023/03/24 23:58:27
Table 'NLHBlue29' 6-max Seat #5 is the button
Seat 2: Hero ($5 in chips)
Seat 3: 5a617b9a ($10.06 in chips)
Seat 4: 56ad38ce ($7.21 in chips)
Seat 5: 92dc9d57 ($6.92 in chips)
Seat 6: 86d3fd28 ($9.11 in chips)
86d3fd28: posts small blind $0.02
Hero: posts big blind $0.05
*** HOLE CARDS ***
Dealt to Hero [Kd Qc]
Dealt to 5a617b9a 
Dealt to 56ad38ce 
Dealt to 92dc9d57 
Dealt to 86d3fd28 
5a617b9a: raises $0.1 to $0.15
56ad38ce: folds
92dc9d57: folds
86d3fd28: folds
Hero: calls $0.1
*** FLOP *** [5c 3h 3d]
Hero: checks
5a617b9a: bets $0.24
Hero: folds
Uncalled bet ($0.24) returned to 5a617b9a
*** SHOWDOWN ***
5a617b9a collected $0.3 from pot
*** SUMMARY ***
Total pot $0.32 | Rake $0.02 | Jackpot $0 | Bingo $0 | Fortune $0
Board [5c 3h 3d]
Seat 2: Hero (big blind) folded on the Flop
Seat 3: 5a617b9a won ($0.3)
Seat 4: 56ad38ce folded before Flop (didn't bet)
Seat 5: 92dc9d57 (button) folded before Flop (didn't bet)
Seat 6: 86d3fd28 (small blind) folded before Flop


Poker Hand #HD1174564059: Hold'em No Limit  ($0.02/$0.05) - 2023/03/24 23:57:26
Table 'NLHBlue29' 6-max Seat #4 is the button
Seat 1: 68dd9c04 ($1 in chips)
Seat 2: Hero ($5 in chips)
Seat 3: 5a617b9a ($10.06 in chips)
Seat 4: 56ad38ce ($7.21 in chips)
Seat 5: 92dc9d57 ($6.94 in chips)
Seat 6: 86d3fd28 ($8.22 in chips)
92dc9d57: posts small blind $0.02
86d3fd28: posts big blind $0.05
*** HOLE CARDS ***
Dealt to 68dd9c04 
Dealt to Hero [5s 7s]
Dealt to 5a617b9a 
Dealt to 56ad38ce 
Dealt to 92dc9d57 
Dealt to 86d3fd28 
68dd9c04: raises $0.12 to $0.17
Hero: folds
5a617b9a: folds
56ad38ce: folds
92dc9d57: folds
86d3fd28: calls $0.12
*** FLOP *** [Jh 2s Ah]
86d3fd28: checks
68dd9c04: bets $0.36
86d3fd28: raises $7.69 to $8.05 and is all-in
68dd9c04: calls $0.47 and is all-in
Uncalled bet ($7.22) returned to 86d3fd28
86d3fd28: shows [Ac 2c] (Pair of Aces and Pair of Twos)
68dd9c04: shows [6h 6s] (Pair of Sixes)
*** FIRST TURN *** [Jh 2s Ah] [Qs]
*** FIRST RIVER *** [Jh 2s Ah Qs] [Ts]
*** SECOND TURN *** [Jh 2s Ah] [Ad]
*** SECOND RIVER *** [Jh 2s Ah Ad] [Qh]
*** FIRST SHOWDOWN ***
86d3fd28 collected $0.95 from pot
*** SECOND SHOWDOWN ***
86d3fd28 collected $0.94 from pot
*** SUMMARY ***
Total pot $2.02 | Rake $0.08 | Jackpot $0.05 | Bingo $0 | Fortune $0
Hand was run two times
FIRST Board [Jh 2s Ah Qs Ts]
SECOND Board [Ad Qh]
Seat 1: 68dd9c04 showed [6h 6s] and lost with Pair of Sixes, and lost
Seat 2: Hero folded before Flop (didn't bet)
Seat 3: 5a617b9a folded before Flop (didn't bet)
Seat 4: 56ad38ce (button) folded before Flop (didn't bet)
Seat 5: 92dc9d57 (small blind) folded before Flop
Seat 6: 86d3fd28 (big blind) showed [Ac 2c] and won ($0.95) with Pair of Aces and Pair of Twos, and won ($0.94)


Poker Hand #HD1174564003: Hold'em No Limit  ($0.02/$0.05) - 2023/03/24 23:57:02
Table 'NLHBlue29' 6-max Seat #3 is the button
Seat 1: 68dd9c04 ($1 in chips)
Seat 2: Hero ($5 in chips)
Seat 3: 5a617b9a ($10.06 in chips)
Seat 4: 56ad38ce ($7.23 in chips)
Seat 5: 92dc9d57 ($6.99 in chips)
Seat 6: 86d3fd28 ($8.15 in chips)
56ad38ce: posts small blind $0.02
92dc9d57: posts big blind $0.05
*** HOLE CARDS ***
Dealt to 68dd9c04 
Dealt to Hero [6s 5c]
Dealt to 5a617b9a 
Dealt to 56ad38ce 
Dealt to 92dc9d57 
Dealt to 86d3fd28 
86d3fd28: raises $0.1 to $0.15
68dd9c04: folds
Hero: folds
5a617b9a: folds
56ad38ce: folds
92dc9d57: folds
Uncalled bet ($0.1) returned to 86d3fd28
*** SHOWDOWN ***
86d3fd28 collected $0.12 from pot
*** SUMMARY ***
Total pot $0.12 | Rake $0 | Jackpot $0 | Bingo $0 | Fortune $0
Seat 1: 68dd9c04 folded before Flop (didn't bet)
Seat 2: Hero folded before Flop (didn't bet)
Seat 3: 5a617b9a (button) folded before Flop (didn't bet)
Seat 4: 56ad38ce (small blind) folded before Flop
Seat 5: 92dc9d57 (big blind) folded before Flop
Seat 6: 86d3fd28 collected ($0.12)


Poker Hand #HD1174563853: Hold'em No Limit  ($0.02/$0.05) - 2023/03/24 23:55:49
Table 'NLHBlue29' 6-max Seat #2 is the button
Seat 2: Hero ($5 in chips)
Seat 3: 5a617b9a ($9.9 in chips)
Seat 4: 56ad38ce ($7.28 in chips)
Seat 5: 92dc9d57 ($6.99 in chips)
Seat 6: 86d3fd28 ($8.15 in chips)
5a617b9a: posts small blind $0.02
56ad38ce: posts big blind $0.05
*** HOLE CARDS ***
Dealt to Hero [7d Kd]
Dealt to 5a617b9a 
Dealt to 56ad38ce 
Dealt to 92dc9d57 
Dealt to 86d3fd28 
92dc9d57: folds
86d3fd28: folds
Hero: raises $0.07 to $0.12
5a617b9a: raises $0.33 to $0.45
56ad38ce: folds
Hero: folds
Uncalled bet ($0.33) returned to 5a617b9a
*** SHOWDOWN ***
5a617b9a collected $0.28 from pot
*** SUMMARY ***
Total pot $0.29 | Rake $0.01 | Jackpot $0 | Bingo $0 | Fortune $0
Seat 2: Hero (button) folded before Flop
Seat 3: 5a617b9a (small blind) collected ($0.28)
Seat 4: 56ad38ce (big blind) folded before Flop
Seat 5: 92dc9d57 folded before Flop (didn't bet)
Seat 6: 86d3fd28 folded before Flop (didn't bet)


Poker Hand #HD1174563667: Hold'em No Limit  ($0.02/$0.05) - 2023/03/24 23:54:18
Table 'NLHBlue29' 6-max Seat #6 is the button
Seat 1: 68dd9c04 ($0.97 in chips)
Seat 2: Hero ($6.24 in chips)
Seat 3: 5a617b9a ($9.9 in chips)
Seat 4: 56ad38ce ($7.28 in chips)
Seat 5: 92dc9d57 ($6.99 in chips)
Seat 6: 86d3fd28 ($5.92 in chips)
68dd9c04: posts small blind $0.02
Hero: posts big blind $0.05
*** HOLE CARDS ***
Dealt to 68dd9c04 
Dealt to Hero [7h 8h]
Dealt to 5a617b9a 
Dealt to 56ad38ce 
Dealt to 92dc9d57 
Dealt to 86d3fd28 
5a617b9a: folds
56ad38ce: folds
92dc9d57: folds
86d3fd28: raises $0.1 to $0.15
68dd9c04: calls $0.13
Hero: calls $0.1
*** FLOP *** [Qd 6h 4c]
68dd9c04: bets $0.45
Hero: calls $0.45
86d3fd28: calls $0.45
*** TURN *** [Qd 6h 4c] [3h]
68dd9c04: checks
Hero: checks
86d3fd28: bets $0.9
68dd9c04: calls $0.37 and is all-in
Hero: calls $0.9
*** RIVER *** [Qd 6h 4c 3h] [3c]
Hero: checks
86d3fd28: bets $4.42 and is all-in
Hero: folds
Uncalled bet ($4.42) returned to 86d3fd28
86d3fd28: shows [7s 5s] (Sevens-High Straight)
68dd9c04: shows [Qc 9c] (Pair of Queens and Pair of Treys)
*** SHOWDOWN ***
86d3fd28 collected $2.72 from pot
86d3fd28 collected $1.01 from pot
*** SUMMARY ***
Total pot $3.97 | Rake $0.19 | Jackpot $0.05 | Bingo $0 | Fortune $0
Board [Qd 6h 4c 3h 3c]
Seat 1: 68dd9c04 (small blind) showed [Qc 9c] and lost with Pair of Queens and Pair of Treys
Seat 2: Hero (big blind) folded on the River
Seat 3: 5a617b9a folded before Flop (didn't bet)
Seat 4: 56ad38ce folded before Flop (didn't bet)
Seat 5: 92dc9d57 folded before Flop (didn't bet)
Seat 6: 86d3fd28 (button) showed [7s 5s] and won ($3.73) with Sevens-High Straight


Poker Hand #HD1174563599: Hold'em No Limit  ($0.02/$0.05) - 2023/03/24 23:53:41
Table 'NLHBlue29' 6-max Seat #5 is the button
Seat 1: 68dd9c04 ($1.02 in chips)
Seat 2: Hero ($6.24 in chips)
Seat 3: 5a617b9a ($9.9 in chips)
Seat 4: 56ad38ce ($7.09 in chips)
Seat 5: 92dc9d57 ($7.12 in chips)
Seat 6: 86d3fd28 ($5.94 in chips)
86d3fd28: posts small blind $0.02
68dd9c04: posts big blind $0.05
*** HOLE CARDS ***
Dealt to 68dd9c04 
Dealt to Hero [As 3h]
Dealt to 5a617b9a 
Dealt to 56ad38ce 
Dealt to 92dc9d57 
Dealt to 86d3fd28 
Hero: folds
5a617b9a: folds
56ad38ce: raises $0.08 to $0.13
92dc9d57: calls $0.13
86d3fd28: folds
68dd9c04: folds
*** FLOP *** [5d 9d 8d]
56ad38ce: checks
92dc9d57: checks
*** TURN *** [5d 9d 8d] [Ac]
56ad38ce: bets $0.2
92dc9d57: folds
Uncalled bet ($0.2) returned to 56ad38ce
*** SHOWDOWN ***
56ad38ce collected $0.32 from pot
*** SUMMARY ***
Total pot $0.33 | Rake $0.01 | Jackpot $0 | Bingo $0 | Fortune $0
Board [5d 9d 8d Ac]
Seat 1: 68dd9c04 (big blind) folded before Flop
Seat 2: Hero folded before Flop (didn't bet)
Seat 3: 5a617b9a folded before Flop (didn't bet)
Seat 4: 56ad38ce won ($0.32)
Seat 5: 92dc9d57 (button) folded on the Turn
Seat 6: 86d3fd28 (small blind) folded before Flop


Poker Hand #HD1174563533: Hold'em No Limit  ($0.02/$0.05) - 2023/03/24 23:53:06
Table 'NLHBlue29' 6-max Seat #4 is the button
Seat 1: 68dd9c04 ($0.95 in chips)
Seat 2: Hero ($6.24 in chips)
Seat 3: 5a617b9a ($9.9 in chips)
Seat 4: 56ad38ce ($7.09 in chips)
Seat 5: 92dc9d57 ($7.14 in chips)
Seat 6: 86d3fd28 ($5.99 in chips)
92dc9d57: posts small blind $0.02
86d3fd28: posts big blind $0.05
*** HOLE CARDS ***
Dealt to 68dd9c04 
Dealt to Hero [2s Ah]
Dealt to 5a617b9a 
Dealt to 56ad38ce 
Dealt to 92dc9d57 
Dealt to 86d3fd28 
68dd9c04: calls $0.05
Hero: folds
5a617b9a: folds
56ad38ce: folds
92dc9d57: folds
86d3fd28: checks
*** FLOP *** [2c Ks Js]
86d3fd28: checks
68dd9c04: bets $0.12
86d3fd28: folds
Uncalled bet ($0.12) returned to 68dd9c04
*** SHOWDOWN ***
68dd9c04 collected $0.12 from pot
*** SUMMARY ***
Total pot $0.12 | Rake $0 | Jackpot $0 | Bingo $0 | Fortune $0
Board [2c Ks Js]
Seat 1: 68dd9c04 won ($0.12)
Seat 2: Hero folded before Flop (didn't bet)
Seat 3: 5a617b9a folded before Flop (didn't bet)
Seat 4: 56ad38ce (button) folded before Flop (didn't bet)
Seat 5: 92dc9d57 (small blind) folded before Flop
Seat 6: 86d3fd28 (big blind) folded on the Flop


Poker Hand #HD1174563443: Hold'em No Limit  ($0.02/$0.05) - 2023/03/24 23:52:24
Table 'NLHBlue29' 6-max Seat #3 is the button
Seat 1: 68dd9c04 ($1 in chips)
Seat 2: Hero ($6.44 in chips)
Seat 3: 5a617b9a ($9.61 in chips)
Seat 4: 56ad38ce ($7.11 in chips)
Seat 5: 92dc9d57 ($7.19 in chips)
Seat 6: 86d3fd28 ($5.99 in chips)
56ad38ce: posts small blind $0.02
92dc9d57: posts big blind $0.05
*** HOLE CARDS ***
Dealt to 68dd9c04 
Dealt to Hero [Jd Kc]
Dealt to 5a617b9a 
Dealt to 56ad38ce 
Dealt to 92dc9d57 
Dealt to 86d3fd28 
86d3fd28: folds
68dd9c04: calls $0.05
Hero: raises $0.15 to $0.2
5a617b9a: raises $0.4 to $0.6
56ad38ce: folds
92dc9d57: folds
68dd9c04: folds
Hero: folds
Uncalled bet ($0.4) returned to 5a617b9a
*** SHOWDOWN ***
5a617b9a collected $0.49 from pot
*** SUMMARY ***
Total pot $0.52 | Rake $0.03 | Jackpot $0 | Bingo $0 | Fortune $0
Seat 1: 68dd9c04 folded before Flop
Seat 2: Hero folded before Flop
Seat 3: 5a617b9a (button) collected ($0.49)
Seat 4: 56ad38ce (small blind) folded before Flop
Seat 5: 92dc9d57 (big blind) folded before Flop
Seat 6: 86d3fd28 folded before Flop (didn't bet)


Poker Hand #HD1174563401: Hold'em No Limit  ($0.02/$0.05) - 2023/03/24 23:52:07
Table 'NLHBlue29' 6-max Seat #2 is the button
Seat 2: Hero ($6.44 in chips)
Seat 3: 5a617b9a ($9.56 in chips)
Seat 4: 56ad38ce ($7.16 in chips)
Seat 5: 92dc9d57 ($7.19 in chips)
Seat 6: 86d3fd28 ($5.99 in chips)
5a617b9a: posts small blind $0.02
56ad38ce: posts big blind $0.05
*** HOLE CARDS ***
Dealt to Hero [7h 3d]
Dealt to 5a617b9a 
Dealt to 56ad38ce 
Dealt to 92dc9d57 
Dealt to 86d3fd28 
92dc9d57: folds
86d3fd28: folds
Hero: folds
5a617b9a: raises $0.1 to $0.15
56ad38ce: folds
Uncalled bet ($0.1) returned to 5a617b9a
*** SHOWDOWN ***
5a617b9a collected $0.1 from pot
*** SUMMARY ***
Total pot $0.1 | Rake $0 | Jackpot $0 | Bingo $0 | Fortune $0
Seat 2: Hero (button) folded before Flop (didn't bet)
Seat 3: 5a617b9a (small blind) collected ($0.1)
Seat 4: 56ad38ce (big blind) folded before Flop
Seat 5: 92dc9d57 folded before Flop (didn't bet)
Seat 6: 86d3fd28 folded before Flop (didn't bet)


Poker Hand #HD1174563262: Hold'em No Limit  ($0.02/$0.05) - 2023/03/24 23:51:02
Table 'NLHBlue29' 6-max Seat #1 is the button
Seat 1: 68dd9c04 ($1 in chips)
Seat 2: Hero ($6.46 in chips)
Seat 3: 5a617b9a ($9.61 in chips)
Seat 4: 56ad38ce ($7.16 in chips)
Seat 5: 92dc9d57 ($7.19 in chips)
Seat 6: 86d3fd28 ($5.07 in chips)
Hero: posts small blind $0.02
5a617b9a: posts big blind $0.05
*** HOLE CARDS ***
Dealt to 68dd9c04 
Dealt to Hero [2c 3d]
Dealt to 5a617b9a 
Dealt to 56ad38ce 
Dealt to 92dc9d57 
Dealt to 86d3fd28 
56ad38ce: folds
92dc9d57: folds
86d3fd28: raises $0.1 to $0.15
68dd9c04: calls $0.15
Hero: folds
5a617b9a: folds
*** FLOP *** [5c 5d 6d]
86d3fd28: bets $0.28
68dd9c04: calls $0.28
*** TURN *** [5c 5d 6d] [2d]
86d3fd28: bets $0.7
68dd9c04: calls $0.57 and is all-in
Uncalled bet ($0.13) returned to 86d3fd28
86d3fd28: shows [Jd Kd] (King High Flush)
68dd9c04: shows [5s As] (Three Fives)
*** RIVER *** [5c 5d 6d 2d] [Qs]
*** SHOWDOWN ***
86d3fd28 collected $1.92 from pot
*** SUMMARY ***
Total pot $2.07 | Rake $0.1 | Jackpot $0.05 | Bingo $0 | Fortune $0
Board [5c 5d 6d 2d Qs]
Seat 1: 68dd9c04 (button) showed [5s As] and lost with Three Fives
Seat 2: Hero (small blind) folded before Flop
Seat 3: 5a617b9a (big blind) folded before Flop
Seat 4: 56ad38ce folded before Flop (didn't bet)
Seat 5: 92dc9d57 folded before Flop (didn't bet)
Seat 6: 86d3fd28 showed [Jd Kd] and won ($1.92) with King High Flush


Poker Hand #HD1174563198: Hold'em No Limit  ($0.02/$0.05) - 2023/03/24 23:50:33
Table 'NLHBlue29' 6-max Seat #6 is the button
Seat 1: 68dd9c04 ($1.02 in chips)
Seat 2: Hero ($6.51 in chips)
Seat 3: 5a617b9a ($9.61 in chips)
Seat 4: 56ad38ce ($7.16 in chips)
Seat 5: 92dc9d57 ($7.19 in chips)
Seat 6: 86d3fd28 ($5 in chips)
68dd9c04: posts small blind $0.02
Hero: posts big blind $0.05
*** HOLE CARDS ***
Dealt to 68dd9c04 
Dealt to Hero [Jd 7h]
Dealt to 5a617b9a 
Dealt to 56ad38ce 
Dealt to 92dc9d57 
Dealt to 86d3fd28 
5a617b9a: folds
56ad38ce: folds
92dc9d57: folds
86d3fd28: raises $0.1 to $0.15
68dd9c04: folds
Hero: folds
Uncalled bet ($0.1) returned to 86d3fd28
*** SHOWDOWN ***
86d3fd28 collected $0.12 from pot
*** SUMMARY ***
Total pot $0.12 | Rake $0 | Jackpot $0 | Bingo $0 | Fortune $0
Seat 1: 68dd9c04 (small blind) folded before Flop
Seat 2: Hero (big blind) folded before Flop
Seat 3: 5a617b9a folded before Flop (didn't bet)
Seat 4: 56ad38ce folded before Flop (didn't bet)
Seat 5: 92dc9d57 folded before Flop (didn't bet)
Seat 6: 86d3fd28 (button) collected ($0.12)


Poker Hand #HD1174563149: Hold'em No Limit  ($0.02/$0.05) - 2023/03/24 23:50:11
Table 'NLHBlue29' 6-max Seat #5 is the button
Seat 1: 68dd9c04 ($1 in chips)
Seat 2: Hero ($6.51 in chips)
Seat 3: 5a617b9a ($9.61 in chips)
Seat 4: 56ad38ce ($7.16 in chips)
Seat 5: 92dc9d57 ($7.19 in chips)
Seat 6: 86d3fd28 ($5 in chips)
86d3fd28: posts small blind $0.02
68dd9c04: posts big blind $0.05
*** HOLE CARDS ***
Dealt to 68dd9c04 
Dealt to Hero [Js 3c]
Dealt to 5a617b9a 
Dealt to 56ad38ce 
Dealt to 92dc9d57 
Dealt to 86d3fd28 
Hero: folds
5a617b9a: folds
56ad38ce: folds
92dc9d57: folds
86d3fd28: folds
Uncalled bet ($0.03) returned to 68dd9c04
*** SHOWDOWN ***
68dd9c04 collected $0.04 from pot
*** SUMMARY ***
Total pot $0.04 | Rake $0 | Jackpot $0 | Bingo $0 | Fortune $0
Seat 1: 68dd9c04 (big blind) collected ($0.04)
Seat 2: Hero folded before Flop (didn't bet)
Seat 3: 5a617b9a folded before Flop (didn't bet)
Seat 4: 56ad38ce folded before Flop (didn't bet)
Seat 5: 92dc9d57 (button) folded before Flop (didn't bet)
Seat 6: 86d3fd28 (small blind) folded before Flop


Poker Hand #HD1174562884: Hold'em No Limit  ($0.02/$0.05) - 2023/03/24 23:48:11
Table 'NLHBlue29' 6-max Seat #4 is the button
Seat 2: Hero ($5.07 in chips)
Seat 3: 5a617b9a ($9.61 in chips)
Seat 4: 56ad38ce ($8.73 in chips)
Seat 5: 92dc9d57 ($7.21 in chips)
Seat 6: 86d3fd28 ($5 in chips)
92dc9d57: posts small blind $0.02
86d3fd28: posts big blind $0.05
*** HOLE CARDS ***
Dealt to Hero [7h 7c]
Dealt to 5a617b9a 
Dealt to 56ad38ce 
Dealt to 92dc9d57 
Dealt to 86d3fd28 
Hero: raises $0.07 to $0.12
5a617b9a: folds
56ad38ce: raises $0.23 to $0.35
92dc9d57: folds
86d3fd28: folds
Hero: calls $0.23
*** FLOP *** [7s Js 5h]
Hero: checks
56ad38ce: bets $0.4
Hero: raises $0.82 to $1.22
56ad38ce: calls $0.82
*** TURN *** [7s Js 5h] [6d]
Hero: bets $3.5 and is all-in
56ad38ce: folds
Uncalled bet ($3.5) returned to Hero
*** SHOWDOWN ***
Hero collected $3.01 from pot
*** SUMMARY ***
Total pot $3.21 | Rake $0.15 | Jackpot $0.05 | Bingo $0 | Fortune $0
Board [7s Js 5h 6d]
Seat 2: Hero won ($3.01)
Seat 3: 5a617b9a folded before Flop (didn't bet)
Seat 4: 56ad38ce (button) folded on the Turn
Seat 5: 92dc9d57 (small blind) folded before Flop
Seat 6: 86d3fd28 (big blind) folded before Flop


Poker Hand #HD1174562838: Hold'em No Limit  ($0.02/$0.05) - 2023/03/24 23:47:53
Table 'NLHBlue29' 6-max Seat #3 is the button
Seat 2: Hero ($5.07 in chips)
Seat 3: 5a617b9a ($9.54 in chips)
Seat 4: 56ad38ce ($8.75 in chips)
Seat 5: 92dc9d57 ($7.26 in chips)
56ad38ce: posts small blind $0.02
92dc9d57: posts big blind $0.05
*** HOLE CARDS ***
Dealt to Hero [2d Tc]
Dealt to 5a617b9a 
Dealt to 56ad38ce 
Dealt to 92dc9d57 
Hero: folds
5a617b9a: raises $0.1 to $0.15
56ad38ce: folds
92dc9d57: folds
Uncalled bet ($0.1) returned to 5a617b9a
*** SHOWDOWN ***
5a617b9a collected $0.12 from pot
*** SUMMARY ***
Total pot $0.12 | Rake $0 | Jackpot $0 | Bingo $0 | Fortune $0
Seat 2: Hero folded before Flop (didn't bet)
Seat 3: 5a617b9a (button) collected ($0.12)
Seat 4: 56ad38ce (small blind) folded before Flop
Seat 5: 92dc9d57 (big blind) folded before Flop


Poker Hand #HD1174562786: Hold'em No Limit  ($0.02/$0.05) - 2023/03/24 23:47:24
Table 'NLHBlue29' 6-max Seat #2 is the button
Seat 2: Hero ($5 in chips)
Seat 3: 5a617b9a ($9.56 in chips)
Seat 4: 56ad38ce ($8.8 in chips)
Seat 5: 92dc9d57 ($7.26 in chips)
5a617b9a: posts small blind $0.02
56ad38ce: posts big blind $0.05
*** HOLE CARDS ***
Dealt to Hero [Tc 8c]
Dealt to 5a617b9a 
Dealt to 56ad38ce 
Dealt to 92dc9d57 
92dc9d57: folds
Hero: raises $0.07 to $0.12
5a617b9a: folds
56ad38ce: folds
Uncalled bet ($0.07) returned to Hero
*** SHOWDOWN ***
Hero collected $0.12 from pot
*** SUMMARY ***
Total pot $0.12 | Rake $0 | Jackpot $0 | Bingo $0 | Fortune $0
Seat 2: Hero (button) collected ($0.12)
Seat 3: 5a617b9a (small blind) folded before Flop
Seat 4: 56ad38ce (big blind) folded before Flop
Seat 5: 92dc9d57 folded before Flop (didn't bet)


Poker Hand #HD1174562726: Hold'em No Limit  ($0.02/$0.05) - 2023/03/24 23:46:57
Table 'NLHBlue29' 6-max Seat #5 is the button
Seat 2: Hero ($5 in chips)
Seat 3: 5a617b9a ($9.61 in chips)
Seat 4: 56ad38ce ($8.8 in chips)
Seat 5: 92dc9d57 ($7.19 in chips)
Hero: posts small blind $0.02
5a617b9a: posts big blind $0.05
*** HOLE CARDS ***
Dealt to Hero [9c Jd]
Dealt to 5a617b9a 
Dealt to 56ad38ce 
Dealt to 92dc9d57 
56ad38ce: folds
92dc9d57: raises $0.05 to $0.1
Hero: folds
5a617b9a: folds
Uncalled bet ($0.05) returned to 92dc9d57
*** SHOWDOWN ***
92dc9d57 collected $0.12 from pot
*** SUMMARY ***
Total pot $0.12 | Rake $0 | Jackpot $0 | Bingo $0 | Fortune $0
Seat 2: Hero (small blind) folded before Flop
Seat 3: 5a617b9a (big blind) folded before Flop
Seat 4: 56ad38ce folded before Flop (didn't bet)
Seat 5: 92dc9d57 (button) collected ($0.12)


Poker Hand #HD1174562654: Hold'em No Limit  ($0.02/$0.05) - 2023/03/24 23:46:19
Table 'NLHBlue29' 6-max Seat #4 is the button
Seat 2: Hero ($5.02 in chips)
Seat 3: 5a617b9a ($9.61 in chips)
Seat 4: 56ad38ce ($8.93 in chips)
Seat 5: 92dc9d57 ($7.02 in chips)
92dc9d57: posts small blind $0.02
Hero: posts big blind $0.05
*** HOLE CARDS ***
Dealt to Hero [3h Kd]
Dealt to 5a617b9a 
Dealt to 56ad38ce 
Dealt to 92dc9d57 
5a617b9a: folds
56ad38ce: raises $0.08 to $0.13
92dc9d57: raises $0.34 to $0.47
Hero: folds
56ad38ce: folds
Uncalled bet ($0.34) returned to 92dc9d57
*** SHOWDOWN ***
92dc9d57 collected $0.3 from pot
*** SUMMARY ***
Total pot $0.31 | Rake $0.01 | Jackpot $0 | Bingo $0 | Fortune $0
Seat 2: Hero (big blind) folded before Flop
Seat 3: 5a617b9a folded before Flop (didn't bet)
Seat 4: 56ad38ce (button) folded before Flop
Seat 5: 92dc9d57 (small blind) collected ($0.3)


Poker Hand #HD1174562586: Hold'em No Limit  ($0.02/$0.05) - 2023/03/24 23:45:43
Table 'NLHBlue29' 6-max Seat #3 is the button
Seat 2: Hero ($5.14 in chips)
Seat 3: 5a617b9a ($9.61 in chips)
Seat 4: 56ad38ce ($8.95 in chips)
Seat 5: 92dc9d57 ($6.89 in chips)
Seat 6: fe893b3b ($5.82 in chips)
56ad38ce: posts small blind $0.02
92dc9d57: posts big blind $0.05
*** HOLE CARDS ***
Dealt to Hero [Qc Kh]
Dealt to 5a617b9a 
Dealt to 56ad38ce 
Dealt to 92dc9d57 
Dealt to fe893b3b 
fe893b3b: folds
Hero: raises $0.07 to $0.12
5a617b9a: folds
56ad38ce: folds
92dc9d57: raises $0.31 to $0.43
Hero: folds
Uncalled bet ($0.31) returned to 92dc9d57
*** SHOWDOWN ***
92dc9d57 collected $0.25 from pot
*** SUMMARY ***
Total pot $0.26 | Rake $0.01 | Jackpot $0 | Bingo $0 | Fortune $0
Seat 2: Hero folded before Flop
Seat 3: 5a617b9a (button) folded before Flop (didn't bet)
Seat 4: 56ad38ce (small blind) folded before Flop
Seat 5: 92dc9d57 (big blind) collected ($0.25)
Seat 6: fe893b3b folded before Flop (didn't bet)


Poker Hand #HD1174562532: Hold'em No Limit  ($0.02/$0.05) - 2023/03/24 23:45:16
Table 'NLHBlue29' 6-max Seat #2 is the button
Seat 2: Hero ($5.07 in chips)
Seat 3: 5a617b9a ($9.63 in chips)
Seat 4: 56ad38ce ($9 in chips)
Seat 5: 92dc9d57 ($6.89 in chips)
Seat 6: fe893b3b ($5.82 in chips)
5a617b9a: posts small blind $0.02
56ad38ce: posts big blind $0.05
*** HOLE CARDS ***
Dealt to Hero [8s 7s]
Dealt to 5a617b9a 
Dealt to 56ad38ce 
Dealt to 92dc9d57 
Dealt to fe893b3b 
92dc9d57: folds
fe893b3b: folds
Hero: raises $0.07 to $0.12
5a617b9a: folds
56ad38ce: folds
Uncalled bet ($0.07) returned to Hero
*** SHOWDOWN ***
Hero collected $0.12 from pot
*** SUMMARY ***
Total pot $0.12 | Rake $0 | Jackpot $0 | Bingo $0 | Fortune $0
Seat 2: Hero (button) collected ($0.12)
Seat 3: 5a617b9a (small blind) folded before Flop
Seat 4: 56ad38ce (big blind) folded before Flop
Seat 5: 92dc9d57 folded before Flop (didn't bet)
Seat 6: fe893b3b folded before Flop (didn't bet)


Poker Hand #HD1174562491: Hold'em No Limit  ($0.02/$0.05) - 2023/03/24 23:44:58
Table 'NLHBlue29' 6-max Seat #6 is the button
Seat 2: Hero ($5.09 in chips)
Seat 3: 5a617b9a ($9.68 in chips)
Seat 4: 56ad38ce ($9 in chips)
Seat 5: 92dc9d57 ($6.89 in chips)
Seat 6: fe893b3b ($5.75 in chips)
Hero: posts small blind $0.02
5a617b9a: posts big blind $0.05
*** HOLE CARDS ***
Dealt to Hero [3d 4d]
Dealt to 5a617b9a 
Dealt to 56ad38ce 
Dealt to 92dc9d57 
Dealt to fe893b3b 
56ad38ce: folds
92dc9d57: folds
fe893b3b: raises $0.08 to $0.13
Hero: folds
5a617b9a: folds
Uncalled bet ($0.08) returned to fe893b3b
*** SHOWDOWN ***
fe893b3b collected $0.12 from pot
*** SUMMARY ***
Total pot $0.12 | Rake $0 | Jackpot $0 | Bingo $0 | Fortune $0
Seat 2: Hero (small blind) folded before Flop
Seat 3: 5a617b9a (big blind) folded before Flop
Seat 4: 56ad38ce folded before Flop (didn't bet)
Seat 5: 92dc9d57 folded before Flop (didn't bet)
Seat 6: fe893b3b (button) collected ($0.12)


Poker Hand #HD1174562415: Hold'em No Limit  ($0.02/$0.05) - 2023/03/24 23:44:22
Table 'NLHBlue29' 6-max Seat #5 is the button
Seat 2: Hero ($5.14 in chips)
Seat 3: 5a617b9a ($9.68 in chips)
Seat 4: 56ad38ce ($9.5 in chips)
Seat 5: 92dc9d57 ($6.89 in chips)
Seat 6: fe893b3b ($5.25 in chips)
fe893b3b: posts small blind $0.02
Hero: posts big blind $0.05
*** HOLE CARDS ***
Dealt to Hero [7s Js]
Dealt to 5a617b9a 
Dealt to 56ad38ce 
Dealt to 92dc9d57 
Dealt to fe893b3b 
5a617b9a: folds
56ad38ce: raises $0.08 to $0.13
92dc9d57: folds
fe893b3b: raises $0.37 to $0.5
Hero: folds
56ad38ce: calls $0.37
*** FLOP *** [As 8c 7d]
fe893b3b: bets $0.35
56ad38ce: folds
Uncalled bet ($0.35) returned to fe893b3b
*** SHOWDOWN ***
fe893b3b collected $1 from pot
*** SUMMARY ***
Total pot $1.05 | Rake $0.05 | Jackpot $0 | Bingo $0 | Fortune $0
Board [As 8c 7d]
Seat 2: Hero (big blind) folded before Flop
Seat 3: 5a617b9a folded before Flop (didn't bet)
Seat 4: 56ad38ce folded on the Flop
Seat 5: 92dc9d57 (button) folded before Flop (didn't bet)
Seat 6: fe893b3b (small blind) won ($1)


Poker Hand #HD1174562363: Hold'em No Limit  ($0.02/$0.05) - 2023/03/24 23:44:00
Table 'NLHBlue29' 6-max Seat #4 is the button
Seat 2: Hero ($5.14 in chips)
Seat 3: 5a617b9a ($9.61 in chips)
Seat 4: 56ad38ce ($9.5 in chips)
Seat 5: 92dc9d57 ($6.91 in chips)
Seat 6: fe893b3b ($5.3 in chips)
92dc9d57: posts small blind $0.02
fe893b3b: posts big blind $0.05
*** HOLE CARDS ***
Dealt to Hero [8d 2d]
Dealt to 5a617b9a 
Dealt to 56ad38ce 
Dealt to 92dc9d57 
Dealt to fe893b3b 
Hero: folds
5a617b9a: raises $0.1 to $0.15
56ad38ce: folds
92dc9d57: folds
fe893b3b: folds
Uncalled bet ($0.1) returned to 5a617b9a
*** SHOWDOWN ***
5a617b9a collected $0.12 from pot
*** SUMMARY ***
Total pot $0.12 | Rake $0 | Jackpot $0 | Bingo $0 | Fortune $0
Seat 2: Hero folded before Flop (didn't bet)
Seat 3: 5a617b9a collected ($0.12)
Seat 4: 56ad38ce (button) folded before Flop (didn't bet)
Seat 5: 92dc9d57 (small blind) folded before Flop
Seat 6: fe893b3b (big blind) folded before Flop


Poker Hand #HD1174562275: Hold'em No Limit  ($0.02/$0.05) - 2023/03/24 23:43:17
Table 'NLHBlue29' 6-max Seat #3 is the button
Seat 2: Hero ($5.07 in chips)
Seat 3: 5a617b9a ($9.61 in chips)
Seat 4: 56ad38ce ($9.52 in chips)
Seat 5: 92dc9d57 ($6.96 in chips)
Seat 6: fe893b3b ($5.3 in chips)
56ad38ce: posts small blind $0.02
92dc9d57: posts big blind $0.05
*** HOLE CARDS ***
Dealt to Hero [5s 5d]
Dealt to 5a617b9a 
Dealt to 56ad38ce 
Dealt to 92dc9d57 
Dealt to fe893b3b 
fe893b3b: folds
Hero: raises $0.07 to $0.12
5a617b9a: folds
56ad38ce: folds
92dc9d57: folds
Uncalled bet ($0.07) returned to Hero
*** SHOWDOWN ***
Hero collected $0.12 from pot
*** SUMMARY ***
Total pot $0.12 | Rake $0 | Jackpot $0 | Bingo $0 | Fortune $0
Seat 2: Hero collected ($0.12)
Seat 3: 5a617b9a (button) folded before Flop (didn't bet)
Seat 4: 56ad38ce (small blind) folded before Flop
Seat 5: 92dc9d57 (big blind) folded before Flop
Seat 6: fe893b3b folded before Flop (didn't bet)


Poker Hand #HD1174562237: Hold'em No Limit  ($0.02/$0.05) - 2023/03/24 23:42:56
Table 'NLHBlue29' 6-max Seat #2 is the button
Seat 2: Hero ($5 in chips)
Seat 3: 5a617b9a ($9.63 in chips)
Seat 4: 56ad38ce ($9.57 in chips)
Seat 5: 92dc9d57 ($6.96 in chips)
Seat 6: fe893b3b ($5.3 in chips)
5a617b9a: posts small blind $0.02
56ad38ce: posts big blind $0.05
*** HOLE CARDS ***
Dealt to Hero [Ah 4c]
Dealt to 5a617b9a 
Dealt to 56ad38ce 
Dealt to 92dc9d57 
Dealt to fe893b3b 
92dc9d57: folds
fe893b3b: folds
Hero: raises $0.07 to $0.12
5a617b9a: folds
56ad38ce: folds
Uncalled bet ($0.07) returned to Hero
*** SHOWDOWN ***
Hero collected $0.12 from pot
*** SUMMARY ***
Total pot $0.12 | Rake $0 | Jackpot $0 | Bingo $0 | Fortune $0
Seat 2: Hero (button) collected ($0.12)
Seat 3: 5a617b9a (small blind) folded before Flop
Seat 4: 56ad38ce (big blind) folded before Flop
Seat 5: 92dc9d57 folded before Flop (didn't bet)
Seat 6: fe893b3b folded before Flop (didn't bet)


Poker Hand #HD1174562131: Hold'em No Limit  ($0.02/$0.05) - 2023/03/24 23:42:02
Table 'NLHBlue29' 6-max Seat #6 is the button
Seat 2: Hero ($5 in chips)
Seat 3: 5a617b9a ($9.73 in chips)
Seat 4: 56ad38ce ($9.57 in chips)
Seat 5: 92dc9d57 ($6.85 in chips)
Seat 6: fe893b3b ($5.3 in chips)
Hero: posts small blind $0.02
5a617b9a: posts big blind $0.05
*** HOLE CARDS ***
Dealt to Hero [6h 3s]
Dealt to 5a617b9a 
Dealt to 56ad38ce 
Dealt to 92dc9d57 
Dealt to fe893b3b 
56ad38ce: folds
92dc9d57: raises $0.05 to $0.1
fe893b3b: folds
Hero: folds
5a617b9a: calls $0.05
*** FLOP *** [8d Ad Jc]
5a617b9a: checks
92dc9d57: checks
*** TURN *** [8d Ad Jc] [Ac]
5a617b9a: checks
92dc9d57: checks
*** RIVER *** [8d Ad Jc Ac] [9d]
5a617b9a: checks
92dc9d57: checks
5a617b9a: shows [3d 3h] (Pair of Aces and Pair of Treys)
92dc9d57: shows [4h 4c] (Pair of Aces and Pair of Fours)
*** SHOWDOWN ***
92dc9d57 collected $0.21 from pot
*** SUMMARY ***
Total pot $0.22 | Rake $0.01 | Jackpot $0 | Bingo $0 | Fortune $0
Board [8d Ad Jc Ac 9d]
Seat 2: Hero (small blind) folded before Flop
Seat 3: 5a617b9a (big blind) showed [3d 3h] and lost with Pair of Aces and Pair of Treys
Seat 4: 56ad38ce folded before Flop (didn't bet)
Seat 5: 92dc9d57 showed [4h 4c] and won ($0.21) with Pair of Aces and Pair of Fours
Seat 6: fe893b3b (button) folded before Flop (didn't bet)


Poker Hand #HD1174561966: Hold'em No Limit  ($0.02/$0.05) - 2023/03/24 23:40:44
Table 'NLHBlue29' 6-max Seat #5 is the button
Seat 2: Hero ($5 in chips)
Seat 3: 5a617b9a ($9.73 in chips)
Seat 4: 56ad38ce ($9.57 in chips)
Seat 5: 92dc9d57 ($5 in chips)
Seat 6: fe893b3b ($5.32 in chips)
fe893b3b: posts small blind $0.02
Hero: posts big blind $0.05
*** HOLE CARDS ***
Dealt to Hero [Ks Qd]
Dealt to 5a617b9a 
Dealt to 56ad38ce 
Dealt to 92dc9d57 
Dealt to fe893b3b 
5a617b9a: folds
56ad38ce: folds
92dc9d57: raises $0.1 to $0.15
fe893b3b: folds
Hero: calls $0.1
*** FLOP *** [5s Kd Jh]
Hero: bets $0.16
92dc9d57: raises $0.5 to $0.66
Hero: calls $0.5
*** TURN *** [5s Kd Jh] [2c]
Hero: checks
92dc9d57: bets $1.27
Hero: calls $1.27
*** RIVER *** [5s Kd Jh 2c] [5c]
Hero: checks
92dc9d57: bets $2.26
Hero: folds
Uncalled bet ($2.26) returned to 92dc9d57
*** SHOWDOWN ***
92dc9d57 collected $3.93 from pot
*** SUMMARY ***
Total pot $4.18 | Rake $0.2 | Jackpot $0.05 | Bingo $0 | Fortune $0
Board [5s Kd Jh 2c 5c]
Seat 2: Hero (big blind) folded on the River
Seat 3: 5a617b9a folded before Flop (didn't bet)
Seat 4: 56ad38ce folded before Flop (didn't bet)
Seat 5: 92dc9d57 (button) won ($3.93)
Seat 6: fe893b3b (small blind) folded before Flop


