Poker Hand #HD1172899768: Hold'em No Limit  ($0.02/$0.05) - 2023/03/23 19:21:12
Table 'NLHBlue103' 6-max Seat #3 is the button
Seat 1: 9db3640a ($9.66 in chips)
Seat 2: ca503645 ($4.93 in chips)
Seat 3: 78f8f936 ($5.2 in chips)
Seat 4: 1b3a10db ($6.92 in chips)
Seat 5: 6e569f3d ($7.28 in chips)
Seat 6: Hero ($5.28 in chips)
1b3a10db: posts small blind $0.02
6e569f3d: posts big blind $0.05
*** HOLE CARDS ***
Dealt to 9db3640a 
Dealt to ca503645 
Dealt to 78f8f936 
Dealt to 1b3a10db 
Dealt to 6e569f3d 
Dealt to Hero [Ts 4h]
Hero: folds
9db3640a: folds
ca503645: raises $0.05 to $0.1
78f8f936: folds
1b3a10db: folds
6e569f3d: folds
Uncalled bet ($0.05) returned to ca503645
*** SHOWDOWN ***
ca503645 collected $0.12 from pot
*** SUMMARY ***
Total pot $0.12 | Rake $0 | Jackpot $0 | Bingo $0 | Fortune $0
Seat 1: 9db3640a folded before Flop (didn't bet)
Seat 2: ca503645 collected ($0.12)
Seat 3: 78f8f936 (button) folded before Flop (didn't bet)
Seat 4: 1b3a10db (small blind) folded before Flop
Seat 5: 6e569f3d (big blind) folded before Flop
Seat 6: Hero folded before Flop (didn't bet)


Poker Hand #HD1172899721: Hold'em No Limit  ($0.02/$0.05) - 2023/03/23 19:20:53
Table 'NLHBlue103' 6-max Seat #2 is the button
Seat 1: 9db3640a ($9.66 in chips)
Seat 2: ca503645 ($4.93 in chips)
Seat 3: 78f8f936 ($5.22 in chips)
Seat 4: 1b3a10db ($6.97 in chips)
Seat 5: 6e569f3d ($7.21 in chips)
Seat 6: Hero ($5.28 in chips)
78f8f936: posts small blind $0.02
1b3a10db: posts big blind $0.05
*** HOLE CARDS ***
Dealt to 9db3640a 
Dealt to ca503645 
Dealt to 78f8f936 
Dealt to 1b3a10db 
Dealt to 6e569f3d 
Dealt to Hero [2d 6h]
6e569f3d: raises $0.1 to $0.15
Hero: folds
9db3640a: folds
ca503645: folds
78f8f936: folds
1b3a10db: folds
Uncalled bet ($0.1) returned to 6e569f3d
*** SHOWDOWN ***
6e569f3d collected $0.12 from pot
*** SUMMARY ***
Total pot $0.12 | Rake $0 | Jackpot $0 | Bingo $0 | Fortune $0
Seat 1: 9db3640a folded before Flop (didn't bet)
Seat 2: ca503645 (button) folded before Flop (didn't bet)
Seat 3: 78f8f936 (small blind) folded before Flop
Seat 4: 1b3a10db (big blind) folded before Flop
Seat 5: 6e569f3d collected ($0.12)
Seat 6: Hero folded before Flop (didn't bet)


Poker Hand #HD1172899689: Hold'em No Limit  ($0.02/$0.05) - 2023/03/23 19:20:39
Table 'NLHBlue103' 6-max Seat #1 is the button
Seat 1: 9db3640a ($9.66 in chips)
Seat 2: ca503645 ($4.95 in chips)
Seat 3: 78f8f936 ($5.27 in chips)
Seat 4: 1b3a10db ($6.97 in chips)
Seat 5: 6e569f3d ($7.21 in chips)
Seat 6: Hero ($5.21 in chips)
ca503645: posts small blind $0.02
78f8f936: posts big blind $0.05
*** HOLE CARDS ***
Dealt to 9db3640a 
Dealt to ca503645 
Dealt to 78f8f936 
Dealt to 1b3a10db 
Dealt to 6e569f3d 
Dealt to Hero [7c Tc]
1b3a10db: folds
6e569f3d: folds
Hero: raises $0.07 to $0.12
9db3640a: folds
ca503645: folds
78f8f936: folds
Uncalled bet ($0.07) returned to Hero
*** SHOWDOWN ***
Hero collected $0.12 from pot
*** SUMMARY ***
Total pot $0.12 | Rake $0 | Jackpot $0 | Bingo $0 | Fortune $0
Seat 1: 9db3640a (button) folded before Flop (didn't bet)
Seat 2: ca503645 (small blind) folded before Flop
Seat 3: 78f8f936 (big blind) folded before Flop
Seat 4: 1b3a10db folded before Flop (didn't bet)
Seat 5: 6e569f3d folded before Flop (didn't bet)
Seat 6: Hero collected ($0.12)


Poker Hand #HD1172899639: Hold'em No Limit  ($0.02/$0.05) - 2023/03/23 19:20:19
Table 'NLHBlue103' 6-max Seat #6 is the button
Seat 1: 9db3640a ($9.61 in chips)
Seat 2: ca503645 ($5 in chips)
Seat 3: 78f8f936 ($5.27 in chips)
Seat 4: 1b3a10db ($6.97 in chips)
Seat 5: 6e569f3d ($7.21 in chips)
Seat 6: Hero ($5.21 in chips)
9db3640a: posts small blind $0.02
ca503645: posts big blind $0.05
*** HOLE CARDS ***
Dealt to 9db3640a 
Dealt to ca503645 
Dealt to 78f8f936 
Dealt to 1b3a10db 
Dealt to 6e569f3d 
Dealt to Hero [4s 8d]
78f8f936: folds
1b3a10db: folds
6e569f3d: folds
Hero: folds
9db3640a: raises $0.1 to $0.15
ca503645: folds
Uncalled bet ($0.1) returned to 9db3640a
*** SHOWDOWN ***
9db3640a collected $0.1 from pot
*** SUMMARY ***
Total pot $0.1 | Rake $0 | Jackpot $0 | Bingo $0 | Fortune $0
Seat 1: 9db3640a (small blind) collected ($0.1)
Seat 2: ca503645 (big blind) folded before Flop
Seat 3: 78f8f936 folded before Flop (didn't bet)
Seat 4: 1b3a10db folded before Flop (didn't bet)
Seat 5: 6e569f3d folded before Flop (didn't bet)
Seat 6: Hero (button) folded before Flop (didn't bet)


Poker Hand #HD1172899483: Hold'em No Limit  ($0.02/$0.05) - 2023/03/23 19:19:13
Table 'NLHBlue103' 6-max Seat #5 is the button
Seat 1: 9db3640a ($9.66 in chips)
Seat 2: ca503645 ($5 in chips)
Seat 3: 78f8f936 ($5.27 in chips)
Seat 4: 1b3a10db ($5.04 in chips)
Seat 5: 6e569f3d ($9.33 in chips)
Seat 6: Hero ($5.23 in chips)
Hero: posts small blind $0.02
9db3640a: posts big blind $0.05
*** HOLE CARDS ***
Dealt to 9db3640a 
Dealt to ca503645 
Dealt to 78f8f936 
Dealt to 1b3a10db 
Dealt to 6e569f3d 
Dealt to Hero [Tc 8c]
ca503645: folds
78f8f936: folds
1b3a10db: raises $0.05 to $0.1
6e569f3d: raises $0.4 to $0.5
Hero: folds
9db3640a: folds
1b3a10db: calls $0.4
*** FLOP *** [Qd 2s Qs]
1b3a10db: checks
6e569f3d: bets $0.54
1b3a10db: calls $0.54
*** TURN *** [Qd 2s Qs] [5d]
1b3a10db: checks
6e569f3d: bets $1.08
1b3a10db: calls $1.08
*** RIVER *** [Qd 2s Qs 5d] [Ks]
1b3a10db: checks
6e569f3d: checks
1b3a10db: shows [3d 3h] (Pair of Queens and Pair of Treys)
6e569f3d: shows [Th Ad] (Pair of Queens)
*** SHOWDOWN ***
1b3a10db collected $4.05 from pot
*** SUMMARY ***
Total pot $4.31 | Rake $0.21 | Jackpot $0.05 | Bingo $0 | Fortune $0
Board [Qd 2s Qs 5d Ks]
Seat 1: 9db3640a (big blind) folded before Flop
Seat 2: ca503645 folded before Flop (didn't bet)
Seat 3: 78f8f936 folded before Flop (didn't bet)
Seat 4: 1b3a10db showed [3d 3h] and won ($4.05) with Pair of Queens and Pair of Treys
Seat 5: 6e569f3d (button) showed [Th Ad] and lost with Pair of Queens
Seat 6: Hero (small blind) folded before Flop


Poker Hand #HD1172899439: Hold'em No Limit  ($0.02/$0.05) - 2023/03/23 19:18:53
Table 'NLHBlue103' 6-max Seat #4 is the button
Seat 1: 9db3640a ($9.66 in chips)
Seat 2: ca503645 ($5 in chips)
Seat 3: 78f8f936 ($5.27 in chips)
Seat 4: 1b3a10db ($5.04 in chips)
Seat 5: 6e569f3d ($9.35 in chips)
Seat 6: Hero ($5.21 in chips)
6e569f3d: posts small blind $0.02
Hero: posts big blind $0.05
*** HOLE CARDS ***
Dealt to 9db3640a 
Dealt to ca503645 
Dealt to 78f8f936 
Dealt to 1b3a10db 
Dealt to 6e569f3d 
Dealt to Hero [Jh 5s]
9db3640a: folds
ca503645: folds
78f8f936: folds
1b3a10db: folds
6e569f3d: folds
Uncalled bet ($0.03) returned to Hero
*** SHOWDOWN ***
Hero collected $0.04 from pot
*** SUMMARY ***
Total pot $0.04 | Rake $0 | Jackpot $0 | Bingo $0 | Fortune $0
Seat 1: 9db3640a folded before Flop (didn't bet)
Seat 2: ca503645 folded before Flop (didn't bet)
Seat 3: 78f8f936 folded before Flop (didn't bet)
Seat 4: 1b3a10db (button) folded before Flop (didn't bet)
Seat 5: 6e569f3d (small blind) folded before Flop
Seat 6: Hero (big blind) collected ($0.04)


Poker Hand #HD1172899350: Hold'em No Limit  ($0.02/$0.05) - 2023/03/23 19:18:14
Table 'NLHBlue103' 6-max Seat #3 is the button
Seat 1: 9db3640a ($9.66 in chips)
Seat 3: 78f8f936 ($5.1 in chips)
Seat 4: 1b3a10db ($5.17 in chips)
Seat 5: 6e569f3d ($9.4 in chips)
Seat 6: Hero ($5.21 in chips)
1b3a10db: posts small blind $0.02
6e569f3d: posts big blind $0.05
*** HOLE CARDS ***
Dealt to 9db3640a 
Dealt to 78f8f936 
Dealt to 1b3a10db 
Dealt to 6e569f3d 
Dealt to Hero [6c 5c]
Hero: folds
9db3640a: folds
78f8f936: raises $0.08 to $0.13
1b3a10db: calls $0.11
6e569f3d: folds
*** FLOP *** [Tc 8c Ah]
1b3a10db: checks
78f8f936: checks
*** TURN *** [Tc 8c Ah] [Td]
1b3a10db: checks
78f8f936: checks
*** RIVER *** [Tc 8c Ah Td] [5s]
1b3a10db: checks
78f8f936: checks
1b3a10db: shows [Kd Js] (Pair of Tens)
78f8f936: shows [As 7s] (Pair of Aces and Pair of Tens)
*** SHOWDOWN ***
78f8f936 collected $0.3 from pot
*** SUMMARY ***
Total pot $0.31 | Rake $0.01 | Jackpot $0 | Bingo $0 | Fortune $0
Board [Tc 8c Ah Td 5s]
Seat 1: 9db3640a folded before Flop (didn't bet)
Seat 3: 78f8f936 (button) showed [As 7s] and won ($0.3) with Pair of Aces and Pair of Tens
Seat 4: 1b3a10db (small blind) showed [Kd Js] and lost with Pair of Tens
Seat 5: 6e569f3d (big blind) folded before Flop
Seat 6: Hero folded before Flop (didn't bet)


Poker Hand #HD1172899127: Hold'em No Limit  ($0.02/$0.05) - 2023/03/23 19:16:47
Table 'NLHBlue103' 6-max Seat #2 is the button
Seat 1: 9db3640a ($9.66 in chips)
Seat 2: ca503645 ($4.86 in chips)
Seat 3: 78f8f936 ($5.12 in chips)
Seat 4: 1b3a10db ($5.22 in chips)
Seat 5: 6e569f3d ($5 in chips)
Seat 6: Hero ($5.21 in chips)
78f8f936: posts small blind $0.02
1b3a10db: posts big blind $0.05
*** HOLE CARDS ***
Dealt to 9db3640a 
Dealt to ca503645 
Dealt to 78f8f936 
Dealt to 1b3a10db 
Dealt to 6e569f3d 
Dealt to Hero [5c Qh]
6e569f3d: raises $0.1 to $0.15
Hero: folds
9db3640a: folds
ca503645: calls $0.15
78f8f936: folds
1b3a10db: folds
*** FLOP *** [Qd 7c Ad]
6e569f3d: checks
ca503645: bets $0.28
6e569f3d: raises $0.7 to $0.98
ca503645: calls $0.7
*** TURN *** [Qd 7c Ad] [6s]
6e569f3d: bets $3.87 and is all-in
ca503645: calls $3.73 and is all-in
Uncalled bet ($0.14) returned to 6e569f3d
6e569f3d: shows [Ks Ac] (Pair of Aces)
ca503645: shows [Jh Ah] (Pair of Aces)
*** FIRST RIVER *** [Qd 7c Ad 6s] [3d]
*** SECOND RIVER *** [Qd 7c Ad 6s] [As]
*** FIRST SHOWDOWN ***
6e569f3d collected $4.63 from pot
*** SECOND SHOWDOWN ***
6e569f3d collected $4.63 from pot
*** SUMMARY ***
Total pot $9.79 | Rake $0.48 | Jackpot $0.05 | Bingo $0 | Fortune $0
Hand was run two times
FIRST Board [Qd 7c Ad 6s 3d]
SECOND Board [As]
Seat 1: 9db3640a folded before Flop (didn't bet)
Seat 2: ca503645 (button) showed [Jh Ah] and lost with Pair of Aces, and lost
Seat 3: 78f8f936 (small blind) folded before Flop
Seat 4: 1b3a10db (big blind) folded before Flop
Seat 5: 6e569f3d showed [Ks Ac] and won ($4.63) with Pair of Aces, and won ($4.63)
Seat 6: Hero folded before Flop (didn't bet)


Poker Hand #HD1172899084: Hold'em No Limit  ($0.02/$0.05) - 2023/03/23 19:16:27
Table 'NLHBlue103' 6-max Seat #1 is the button
Seat 1: 9db3640a ($9.59 in chips)
Seat 2: ca503645 ($4.88 in chips)
Seat 3: 78f8f936 ($5.17 in chips)
Seat 4: 1b3a10db ($5.22 in chips)
Seat 5: 6e569f3d ($5 in chips)
Seat 6: Hero ($5.21 in chips)
ca503645: posts small blind $0.02
78f8f936: posts big blind $0.05
*** HOLE CARDS ***
Dealt to 9db3640a 
Dealt to ca503645 
Dealt to 78f8f936 
Dealt to 1b3a10db 
Dealt to 6e569f3d 
Dealt to Hero [Ad 6h]
1b3a10db: folds
6e569f3d: folds
Hero: folds
9db3640a: raises $0.1 to $0.15
ca503645: folds
78f8f936: folds
Uncalled bet ($0.1) returned to 9db3640a
*** SHOWDOWN ***
9db3640a collected $0.12 from pot
*** SUMMARY ***
Total pot $0.12 | Rake $0 | Jackpot $0 | Bingo $0 | Fortune $0
Seat 1: 9db3640a (button) collected ($0.12)
Seat 2: ca503645 (small blind) folded before Flop
Seat 3: 78f8f936 (big blind) folded before Flop
Seat 4: 1b3a10db folded before Flop (didn't bet)
Seat 5: 6e569f3d folded before Flop (didn't bet)
Seat 6: Hero folded before Flop (didn't bet)


Poker Hand #HD1172899036: Hold'em No Limit  ($0.02/$0.05) - 2023/03/23 19:16:07
Table 'NLHBlue103' 6-max Seat #6 is the button
Seat 1: 9db3640a ($9.61 in chips)
Seat 2: ca503645 ($4.93 in chips)
Seat 3: 78f8f936 ($5.17 in chips)
Seat 4: 1b3a10db ($5.22 in chips)
Seat 5: 6e569f3d ($5 in chips)
Seat 6: Hero ($5.14 in chips)
9db3640a: posts small blind $0.02
ca503645: posts big blind $0.05
*** HOLE CARDS ***
Dealt to 9db3640a 
Dealt to ca503645 
Dealt to 78f8f936 
Dealt to 1b3a10db 
Dealt to 6e569f3d 
Dealt to Hero [3c 3h]
78f8f936: folds
1b3a10db: folds
6e569f3d: folds
Hero: raises $0.07 to $0.12
9db3640a: folds
ca503645: folds
Uncalled bet ($0.07) returned to Hero
*** SHOWDOWN ***
Hero collected $0.12 from pot
*** SUMMARY ***
Total pot $0.12 | Rake $0 | Jackpot $0 | Bingo $0 | Fortune $0
Seat 1: 9db3640a (small blind) folded before Flop
Seat 2: ca503645 (big blind) folded before Flop
Seat 3: 78f8f936 folded before Flop (didn't bet)
Seat 4: 1b3a10db folded before Flop (didn't bet)
Seat 5: 6e569f3d folded before Flop (didn't bet)
Seat 6: Hero (button) collected ($0.12)


Poker Hand #HD1172898810: Hold'em No Limit  ($0.02/$0.05) - 2023/03/23 19:14:34
Table 'NLHBlue103' 6-max Seat #5 is the button
Seat 1: 9db3640a ($5.07 in chips)
Seat 2: ca503645 ($4.93 in chips)
Seat 3: 78f8f936 ($5.17 in chips)
Seat 4: 1b3a10db ($5.22 in chips)
Seat 5: 6e569f3d ($9.65 in chips)
Seat 6: Hero ($5.16 in chips)
Hero: posts small blind $0.02
9db3640a: posts big blind $0.05
*** HOLE CARDS ***
Dealt to 9db3640a 
Dealt to ca503645 
Dealt to 78f8f936 
Dealt to 1b3a10db 
Dealt to 6e569f3d 
Dealt to Hero [2h As]
ca503645: folds
78f8f936: folds
1b3a10db: folds
6e569f3d: raises $0.1 to $0.15
Hero: folds
9db3640a: raises $0.32 to $0.47
6e569f3d: raises $0.72 to $1.19
9db3640a: calls $0.72
*** FLOP *** [6h 6s Qs]
9db3640a: checks
6e569f3d: bets $1.2
9db3640a: raises $2.68 to $3.88 and is all-in
6e569f3d: calls $2.68
9db3640a: shows [Ac Qd] (Pair of Queens and Pair of Sixes)
6e569f3d: shows [Ks Kd] (Pair of Kings and Pair of Sixes)
*** TURN *** [6h 6s Qs] [7h]
*** RIVER *** [6h 6s Qs 7h] [Qh]
*** SHOWDOWN ***
9db3640a collected $9.61 from pot
*** SUMMARY ***
Total pot $10.16 | Rake $0.5 | Jackpot $0.05 | Bingo $0 | Fortune $0
Board [6h 6s Qs 7h Qh]
Seat 1: 9db3640a (big blind) showed [Ac Qd] and won ($9.61) with Queens Full over Sixes
Seat 2: ca503645 folded before Flop (didn't bet)
Seat 3: 78f8f936 folded before Flop (didn't bet)
Seat 4: 1b3a10db folded before Flop (didn't bet)
Seat 5: 6e569f3d (button) showed [Ks Kd] and lost with Pair of Kings and Pair of Queens
Seat 6: Hero (small blind) folded before Flop


Poker Hand #HD1172898783: Hold'em No Limit  ($0.02/$0.05) - 2023/03/23 19:14:22
Table 'NLHBlue103' 6-max Seat #4 is the button
Seat 1: 9db3640a ($5.07 in chips)
Seat 2: ca503645 ($4.93 in chips)
Seat 3: 78f8f936 ($5.17 in chips)
Seat 4: 1b3a10db ($5.22 in chips)
Seat 5: 6e569f3d ($9.6 in chips)
Seat 6: Hero ($5.21 in chips)
6e569f3d: posts small blind $0.02
Hero: posts big blind $0.05
*** HOLE CARDS ***
Dealt to 9db3640a 
Dealt to ca503645 
Dealt to 78f8f936 
Dealt to 1b3a10db 
Dealt to 6e569f3d 
Dealt to Hero [2d Qs]
9db3640a: folds
ca503645: folds
78f8f936: folds
1b3a10db: folds
6e569f3d: raises $0.1 to $0.15
Hero: folds
Uncalled bet ($0.1) returned to 6e569f3d
*** SHOWDOWN ***
6e569f3d collected $0.1 from pot
*** SUMMARY ***
Total pot $0.1 | Rake $0 | Jackpot $0 | Bingo $0 | Fortune $0
Seat 1: 9db3640a folded before Flop (didn't bet)
Seat 2: ca503645 folded before Flop (didn't bet)
Seat 3: 78f8f936 folded before Flop (didn't bet)
Seat 4: 1b3a10db (button) folded before Flop (didn't bet)
Seat 5: 6e569f3d (small blind) collected ($0.1)
Seat 6: Hero (big blind) folded before Flop


Poker Hand #HD1172898692: Hold'em No Limit  ($0.02/$0.05) - 2023/03/23 19:13:41
Table 'NLHBlue103' 6-max Seat #3 is the button
Seat 1: 9db3640a ($5 in chips)
Seat 2: ca503645 ($4.93 in chips)
Seat 3: 78f8f936 ($5.17 in chips)
Seat 4: 1b3a10db ($5.24 in chips)
Seat 5: 6e569f3d ($9.65 in chips)
Seat 6: Hero ($5.21 in chips)
1b3a10db: posts small blind $0.02
6e569f3d: posts big blind $0.05
9db3640a: posts big blind $0.05
*** HOLE CARDS ***
Dealt to 9db3640a 
Dealt to ca503645 
Dealt to 78f8f936 
Dealt to 1b3a10db 
Dealt to 6e569f3d 
Dealt to Hero [Td Ac]
Hero: folds
9db3640a: checks
ca503645: folds
78f8f936: folds
1b3a10db: folds
6e569f3d: checks
*** FLOP *** [5c Qc 7s]
6e569f3d: checks
9db3640a: bets $0.05
6e569f3d: folds
Uncalled bet ($0.05) returned to 9db3640a
*** SHOWDOWN ***
9db3640a collected $0.12 from pot
*** SUMMARY ***
Total pot $0.12 | Rake $0 | Jackpot $0 | Bingo $0 | Fortune $0
Board [5c Qc 7s]
Seat 1: 9db3640a won ($0.12)
Seat 2: ca503645 folded before Flop (didn't bet)
Seat 3: 78f8f936 (button) folded before Flop (didn't bet)
Seat 4: 1b3a10db (small blind) folded before Flop
Seat 5: 6e569f3d (big blind) folded on the Flop
Seat 6: Hero folded before Flop (didn't bet)


Poker Hand #HD1172898666: Hold'em No Limit  ($0.02/$0.05) - 2023/03/23 19:13:31
Table 'NLHBlue103' 6-max Seat #2 is the button
Seat 2: ca503645 ($4.93 in chips)
Seat 3: 78f8f936 ($5.19 in chips)
Seat 4: 1b3a10db ($5.22 in chips)
Seat 5: 6e569f3d ($9.65 in chips)
Seat 6: Hero ($5.21 in chips)
78f8f936: posts small blind $0.02
1b3a10db: posts big blind $0.05
*** HOLE CARDS ***
Dealt to ca503645 
Dealt to 78f8f936 
Dealt to 1b3a10db 
Dealt to 6e569f3d 
Dealt to Hero [Jd 3d]
6e569f3d: folds
Hero: folds
ca503645: folds
78f8f936: folds
Uncalled bet ($0.03) returned to 1b3a10db
*** SHOWDOWN ***
1b3a10db collected $0.04 from pot
*** SUMMARY ***
Total pot $0.04 | Rake $0 | Jackpot $0 | Bingo $0 | Fortune $0
Seat 2: ca503645 (button) folded before Flop (didn't bet)
Seat 3: 78f8f936 (small blind) folded before Flop
Seat 4: 1b3a10db (big blind) collected ($0.04)
Seat 5: 6e569f3d folded before Flop (didn't bet)
Seat 6: Hero folded before Flop (didn't bet)


Poker Hand #HD1172898621: Hold'em No Limit  ($0.02/$0.05) - 2023/03/23 19:13:13
Table 'NLHBlue103' 6-max Seat #6 is the button
Seat 2: ca503645 ($4.95 in chips)
Seat 3: 78f8f936 ($5.24 in chips)
Seat 4: 1b3a10db ($5.22 in chips)
Seat 5: 6e569f3d ($9.65 in chips)
Seat 6: Hero ($5.14 in chips)
ca503645: posts small blind $0.02
78f8f936: posts big blind $0.05
*** HOLE CARDS ***
Dealt to ca503645 
Dealt to 78f8f936 
Dealt to 1b3a10db 
Dealt to 6e569f3d 
Dealt to Hero [4h As]
1b3a10db: folds
6e569f3d: folds
Hero: raises $0.07 to $0.12
ca503645: folds
78f8f936: folds
Uncalled bet ($0.07) returned to Hero
*** SHOWDOWN ***
Hero collected $0.12 from pot
*** SUMMARY ***
Total pot $0.12 | Rake $0 | Jackpot $0 | Bingo $0 | Fortune $0
Seat 2: ca503645 (small blind) folded before Flop
Seat 3: 78f8f936 (big blind) folded before Flop
Seat 4: 1b3a10db folded before Flop (didn't bet)
Seat 5: 6e569f3d folded before Flop (didn't bet)
Seat 6: Hero (button) collected ($0.12)


Poker Hand #HD1172898595: Hold'em No Limit  ($0.02/$0.05) - 2023/03/23 19:13:01
Table 'NLHBlue103' 6-max Seat #5 is the button
Seat 2: ca503645 ($4.93 in chips)
Seat 3: 78f8f936 ($5.24 in chips)
Seat 4: 1b3a10db ($5.22 in chips)
Seat 5: 6e569f3d ($9.65 in chips)
Seat 6: Hero ($5.16 in chips)
Hero: posts small blind $0.02
ca503645: posts big blind $0.05
*** HOLE CARDS ***
Dealt to ca503645 
Dealt to 78f8f936 
Dealt to 1b3a10db 
Dealt to 6e569f3d 
Dealt to Hero [Qs 5c]
78f8f936: folds
1b3a10db: folds
6e569f3d: folds
Hero: folds
Uncalled bet ($0.03) returned to ca503645
*** SHOWDOWN ***
ca503645 collected $0.04 from pot
*** SUMMARY ***
Total pot $0.04 | Rake $0 | Jackpot $0 | Bingo $0 | Fortune $0
Seat 2: ca503645 (big blind) collected ($0.04)
Seat 3: 78f8f936 folded before Flop (didn't bet)
Seat 4: 1b3a10db folded before Flop (didn't bet)
Seat 5: 6e569f3d (button) folded before Flop (didn't bet)
Seat 6: Hero (small blind) folded before Flop


Poker Hand #HD1172898547: Hold'em No Limit  ($0.02/$0.05) - 2023/03/23 19:12:41
Table 'NLHBlue103' 6-max Seat #4 is the button
Seat 1: a0c70336 ($5.41 in chips)
Seat 2: ca503645 ($4.93 in chips)
Seat 3: 78f8f936 ($5.24 in chips)
Seat 4: 1b3a10db ($5.22 in chips)
Seat 5: 6e569f3d ($9.67 in chips)
Seat 6: Hero ($5.14 in chips)
6e569f3d: posts small blind $0.02
Hero: posts big blind $0.05
*** HOLE CARDS ***
Dealt to a0c70336 
Dealt to ca503645 
Dealt to 78f8f936 
Dealt to 1b3a10db 
Dealt to 6e569f3d 
Dealt to Hero [2c Qh]
a0c70336: folds
ca503645: folds
78f8f936: folds
1b3a10db: folds
6e569f3d: folds
Uncalled bet ($0.03) returned to Hero
*** SHOWDOWN ***
Hero collected $0.04 from pot
*** SUMMARY ***
Total pot $0.04 | Rake $0 | Jackpot $0 | Bingo $0 | Fortune $0
Seat 1: a0c70336 folded before Flop (didn't bet)
Seat 2: ca503645 folded before Flop (didn't bet)
Seat 3: 78f8f936 folded before Flop (didn't bet)
Seat 4: 1b3a10db (button) folded before Flop (didn't bet)
Seat 5: 6e569f3d (small blind) folded before Flop
Seat 6: Hero (big blind) collected ($0.04)


Poker Hand #HD1172898508: Hold'em No Limit  ($0.02/$0.05) - 2023/03/23 19:12:26
Table 'NLHBlue103' 6-max Seat #3 is the button
Seat 1: a0c70336 ($5.41 in chips)
Seat 2: ca503645 ($4.93 in chips)
Seat 3: 78f8f936 ($5.24 in chips)
Seat 4: 1b3a10db ($5.24 in chips)
Seat 5: 6e569f3d ($9.65 in chips)
Seat 6: Hero ($5.14 in chips)
1b3a10db: posts small blind $0.02
6e569f3d: posts big blind $0.05
*** HOLE CARDS ***
Dealt to a0c70336 
Dealt to ca503645 
Dealt to 78f8f936 
Dealt to 1b3a10db 
Dealt to 6e569f3d 
Dealt to Hero [9h Ks]
Hero: folds
a0c70336: folds
ca503645: folds
78f8f936: folds
1b3a10db: folds
Uncalled bet ($0.03) returned to 6e569f3d
*** SHOWDOWN ***
6e569f3d collected $0.04 from pot
*** SUMMARY ***
Total pot $0.04 | Rake $0 | Jackpot $0 | Bingo $0 | Fortune $0
Seat 1: a0c70336 folded before Flop (didn't bet)
Seat 2: ca503645 folded before Flop (didn't bet)
Seat 3: 78f8f936 (button) folded before Flop (didn't bet)
Seat 4: 1b3a10db (small blind) folded before Flop
Seat 5: 6e569f3d (big blind) collected ($0.04)
Seat 6: Hero folded before Flop (didn't bet)


Poker Hand #HD1172898451: Hold'em No Limit  ($0.02/$0.05) - 2023/03/23 19:12:05
Table 'NLHBlue103' 6-max Seat #2 is the button
Seat 1: a0c70336 ($5.41 in chips)
Seat 2: ca503645 ($4.93 in chips)
Seat 3: 78f8f936 ($5.26 in chips)
Seat 4: 1b3a10db ($5.29 in chips)
Seat 5: 6e569f3d ($9.65 in chips)
Seat 6: Hero ($5.07 in chips)
78f8f936: posts small blind $0.02
1b3a10db: posts big blind $0.05
*** HOLE CARDS ***
Dealt to a0c70336 
Dealt to ca503645 
Dealt to 78f8f936 
Dealt to 1b3a10db 
Dealt to 6e569f3d 
Dealt to Hero [5c Ac]
6e569f3d: folds
Hero: raises $0.07 to $0.12
a0c70336: folds
ca503645: folds
78f8f936: folds
1b3a10db: folds
Uncalled bet ($0.07) returned to Hero
*** SHOWDOWN ***
Hero collected $0.12 from pot
*** SUMMARY ***
Total pot $0.12 | Rake $0 | Jackpot $0 | Bingo $0 | Fortune $0
Seat 1: a0c70336 folded before Flop (didn't bet)
Seat 2: ca503645 (button) folded before Flop (didn't bet)
Seat 3: 78f8f936 (small blind) folded before Flop
Seat 4: 1b3a10db (big blind) folded before Flop
Seat 5: 6e569f3d folded before Flop (didn't bet)
Seat 6: Hero collected ($0.12)


Poker Hand #HD1172898415: Hold'em No Limit  ($0.02/$0.05) - 2023/03/23 19:11:49
Table 'NLHBlue103' 6-max Seat #1 is the button
Seat 1: a0c70336 ($5.41 in chips)
Seat 2: ca503645 ($4.95 in chips)
Seat 3: 78f8f936 ($5.24 in chips)
Seat 4: 1b3a10db ($5.29 in chips)
Seat 5: 6e569f3d ($9.65 in chips)
Seat 6: Hero ($5.07 in chips)
ca503645: posts small blind $0.02
78f8f936: posts big blind $0.05
*** HOLE CARDS ***
Dealt to a0c70336 
Dealt to ca503645 
Dealt to 78f8f936 
Dealt to 1b3a10db 
Dealt to 6e569f3d 
Dealt to Hero [Ad 8c]
1b3a10db: folds
6e569f3d: folds
Hero: folds
a0c70336: folds
ca503645: folds
Uncalled bet ($0.03) returned to 78f8f936
*** SHOWDOWN ***
78f8f936 collected $0.04 from pot
*** SUMMARY ***
Total pot $0.04 | Rake $0 | Jackpot $0 | Bingo $0 | Fortune $0
Seat 1: a0c70336 (button) folded before Flop (didn't bet)
Seat 2: ca503645 (small blind) folded before Flop
Seat 3: 78f8f936 (big blind) collected ($0.04)
Seat 4: 1b3a10db folded before Flop (didn't bet)
Seat 5: 6e569f3d folded before Flop (didn't bet)
Seat 6: Hero folded before Flop (didn't bet)


Poker Hand #HD1172898373: Hold'em No Limit  ($0.02/$0.05) - 2023/03/23 19:11:31
Table 'NLHBlue103' 6-max Seat #6 is the button
Seat 1: a0c70336 ($5.43 in chips)
Seat 2: ca503645 ($5 in chips)
Seat 3: 78f8f936 ($5.24 in chips)
Seat 4: 1b3a10db ($5.29 in chips)
Seat 5: 6e569f3d ($9.65 in chips)
Seat 6: Hero ($5 in chips)
a0c70336: posts small blind $0.02
ca503645: posts big blind $0.05
*** HOLE CARDS ***
Dealt to a0c70336 
Dealt to ca503645 
Dealt to 78f8f936 
Dealt to 1b3a10db 
Dealt to 6e569f3d 
Dealt to Hero [Jc Qs]
78f8f936: folds
1b3a10db: folds
6e569f3d: folds
Hero: raises $0.07 to $0.12
a0c70336: folds
ca503645: folds
Uncalled bet ($0.07) returned to Hero
*** SHOWDOWN ***
Hero collected $0.12 from pot
*** SUMMARY ***
Total pot $0.12 | Rake $0 | Jackpot $0 | Bingo $0 | Fortune $0
Seat 1: a0c70336 (small blind) folded before Flop
Seat 2: ca503645 (big blind) folded before Flop
Seat 3: 78f8f936 folded before Flop (didn't bet)
Seat 4: 1b3a10db folded before Flop (didn't bet)
Seat 5: 6e569f3d folded before Flop (didn't bet)
Seat 6: Hero (button) collected ($0.12)


Poker Hand #HD1172898244: Hold'em No Limit  ($0.02/$0.05) - 2023/03/23 19:10:38
Table 'NLHBlue103' 6-max Seat #5 is the button
Seat 1: a0c70336 ($5 in chips)
Seat 3: 78f8f936 ($5.24 in chips)
Seat 4: 1b3a10db ($5.74 in chips)
Seat 5: 6e569f3d ($9.65 in chips)
Seat 6: Hero ($5 in chips)
Hero: posts small blind $0.02
a0c70336: posts big blind $0.05
*** HOLE CARDS ***
Dealt to a0c70336 
Dealt to 78f8f936 
Dealt to 1b3a10db 
Dealt to 6e569f3d 
Dealt to Hero [6d 6h]
78f8f936: folds
1b3a10db: raises $0.08 to $0.13
6e569f3d: folds
Hero: folds
a0c70336: raises $0.32 to $0.45
1b3a10db: calls $0.32
*** FLOP *** [Jh Qh Td]
a0c70336: bets $0.28
1b3a10db: folds
Uncalled bet ($0.28) returned to a0c70336
*** SHOWDOWN ***
a0c70336 collected $0.88 from pot
*** SUMMARY ***
Total pot $0.92 | Rake $0.04 | Jackpot $0 | Bingo $0 | Fortune $0
Board [Jh Qh Td]
Seat 1: a0c70336 (big blind) won ($0.88)
Seat 3: 78f8f936 folded before Flop (didn't bet)
Seat 4: 1b3a10db folded on the Flop
Seat 5: 6e569f3d (button) folded before Flop (didn't bet)
Seat 6: Hero (small blind) folded before Flop


Poker Hand #HD1172898199: Hold'em No Limit  ($0.02/$0.05) - 2023/03/23 19:10:21
Table 'NLHBlue103' 6-max Seat #4 is the button
Seat 1: a0c70336 ($5 in chips)
Seat 3: 78f8f936 ($5.24 in chips)
Seat 4: 1b3a10db ($5.67 in chips)
Seat 5: 6e569f3d ($9.67 in chips)
Seat 6: Hero ($5 in chips)
6e569f3d: posts small blind $0.02
Hero: posts big blind $0.05
*** HOLE CARDS ***
Dealt to a0c70336 
Dealt to 78f8f936 
Dealt to 1b3a10db 
Dealt to 6e569f3d 
Dealt to Hero [4h Th]
a0c70336: folds
78f8f936: folds
1b3a10db: raises $0.08 to $0.13
6e569f3d: folds
Hero: folds
Uncalled bet ($0.08) returned to 1b3a10db
*** SHOWDOWN ***
1b3a10db collected $0.12 from pot
*** SUMMARY ***
Total pot $0.12 | Rake $0 | Jackpot $0 | Bingo $0 | Fortune $0
Seat 1: a0c70336 folded before Flop (didn't bet)
Seat 3: 78f8f936 folded before Flop (didn't bet)
Seat 4: 1b3a10db (button) collected ($0.12)
Seat 5: 6e569f3d (small blind) folded before Flop
Seat 6: Hero (big blind) folded before Flop


