Poker Hand #HD1182917347: Hold'em No Limit  ($0.02/$0.05) - 2023/03/30 20:19:14
Table 'NLHBlue133' 6-max Seat #1 is the button
Seat 1: e58c45c4 ($5.97 in chips)
Seat 2: e87facd7 ($1.93 in chips)
Seat 3: 33c482b9 ($5.35 in chips)
Seat 4: Hero ($6.55 in chips)
Seat 5: 6feee1ec ($4.77 in chips)
Seat 6: cae134f0 ($1.36 in chips)
e87facd7: posts small blind $0.02
33c482b9: posts big blind $0.05
*** HOLE CARDS ***
Dealt to e58c45c4 
Dealt to e87facd7 
Dealt to 33c482b9 
Dealt to Hero [8s Qs]
Dealt to 6feee1ec 
Dealt to cae134f0 
Hero: folds
6feee1ec: folds
cae134f0: folds
e58c45c4: raises $0.08 to $0.13
e87facd7: folds
33c482b9: folds
Uncalled bet ($0.08) returned to e58c45c4
*** SHOWDOWN ***
e58c45c4 collected $0.12 from pot
*** SUMMARY ***
Total pot $0.12 | Rake $0 | Jackpot $0 | Bingo $0 | Fortune $0
Seat 1: e58c45c4 (button) collected ($0.12)
Seat 2: e87facd7 (small blind) folded before Flop
Seat 3: 33c482b9 (big blind) folded before Flop
Seat 4: Hero folded before Flop (didn't bet)
Seat 5: 6feee1ec folded before Flop (didn't bet)
Seat 6: cae134f0 folded before Flop (didn't bet)


Poker Hand #HD1182917268: Hold'em No Limit  ($0.02/$0.05) - 2023/03/30 20:18:45
Table 'NLHBlue133' 6-max Seat #6 is the button
Seat 1: e58c45c4 ($5.99 in chips)
Seat 2: e87facd7 ($1.8 in chips)
Seat 3: 33c482b9 ($5.35 in chips)
Seat 4: Hero ($6.67 in chips)
Seat 5: 6feee1ec ($4.77 in chips)
Seat 6: cae134f0 ($1.36 in chips)
e58c45c4: posts small blind $0.02
e87facd7: posts big blind $0.05
*** HOLE CARDS ***
Dealt to e58c45c4 
Dealt to e87facd7 
Dealt to 33c482b9 
Dealt to Hero [5h 5s]
Dealt to 6feee1ec 
Dealt to cae134f0 
33c482b9: folds
Hero: raises $0.07 to $0.12
6feee1ec: folds
cae134f0: folds
e58c45c4: folds
e87facd7: raises $0.6 to $0.72
Hero: folds
Uncalled bet ($0.6) returned to e87facd7
*** SHOWDOWN ***
e87facd7 collected $0.25 from pot
*** SUMMARY ***
Total pot $0.26 | Rake $0.01 | Jackpot $0 | Bingo $0 | Fortune $0
Seat 1: e58c45c4 (small blind) folded before Flop
Seat 2: e87facd7 (big blind) collected ($0.25)
Seat 3: 33c482b9 folded before Flop (didn't bet)
Seat 4: Hero folded before Flop
Seat 5: 6feee1ec folded before Flop (didn't bet)
Seat 6: cae134f0 (button) folded before Flop (didn't bet)


Poker Hand #HD1182917133: Hold'em No Limit  ($0.02/$0.05) - 2023/03/30 20:17:50
Table 'NLHBlue133' 6-max Seat #5 is the button
Seat 1: e58c45c4 ($6.04 in chips)
Seat 2: e87facd7 ($1.8 in chips)
Seat 3: 33c482b9 ($5.35 in chips)
Seat 4: Hero ($6.49 in chips)
Seat 5: 6feee1ec ($4.89 in chips)
Seat 6: cae134f0 ($1.38 in chips)
cae134f0: posts small blind $0.02
e58c45c4: posts big blind $0.05
*** HOLE CARDS ***
Dealt to e58c45c4 
Dealt to e87facd7 
Dealt to 33c482b9 
Dealt to Hero [Jh Qc]
Dealt to 6feee1ec 
Dealt to cae134f0 
e87facd7: folds
33c482b9: folds
Hero: raises $0.07 to $0.12
6feee1ec: calls $0.12
cae134f0: folds
e58c45c4: folds
*** FLOP *** [3s 9h Kd]
Hero: checks
6feee1ec: checks
*** TURN *** [3s 9h Kd] [8d]
Hero: checks
6feee1ec: checks
*** RIVER *** [3s 9h Kd 8d] [Th]
Hero: bets $0.24
6feee1ec: folds
Uncalled bet ($0.24) returned to Hero
*** SHOWDOWN ***
Hero collected $0.3 from pot
*** SUMMARY ***
Total pot $0.31 | Rake $0.01 | Jackpot $0 | Bingo $0 | Fortune $0
Board [3s 9h Kd 8d Th]
Seat 1: e58c45c4 (big blind) folded before Flop
Seat 2: e87facd7 folded before Flop (didn't bet)
Seat 3: 33c482b9 folded before Flop (didn't bet)
Seat 4: Hero won ($0.3)
Seat 5: 6feee1ec (button) folded on the River
Seat 6: cae134f0 (small blind) folded before Flop


Poker Hand #HD1182917054: Hold'em No Limit  ($0.02/$0.05) - 2023/03/30 20:17:21
Table 'NLHBlue133' 6-max Seat #4 is the button
Seat 1: e58c45c4 ($6.04 in chips)
Seat 2: e87facd7 ($1.61 in chips)
Seat 3: 33c482b9 ($5.35 in chips)
Seat 4: Hero ($6.49 in chips)
Seat 5: 6feee1ec ($5.04 in chips)
Seat 6: cae134f0 ($1.43 in chips)
6feee1ec: posts small blind $0.02
cae134f0: posts big blind $0.05
*** HOLE CARDS ***
Dealt to e58c45c4 
Dealt to e87facd7 
Dealt to 33c482b9 
Dealt to Hero [7h 3c]
Dealt to 6feee1ec 
Dealt to cae134f0 
e58c45c4: folds
e87facd7: raises $0.1 to $0.15
33c482b9: folds
Hero: folds
6feee1ec: calls $0.13
cae134f0: folds
*** FLOP *** [Th Ks 2h]
6feee1ec: checks
e87facd7: bets $0.18
6feee1ec: folds
Uncalled bet ($0.18) returned to e87facd7
*** SHOWDOWN ***
e87facd7 collected $0.34 from pot
*** SUMMARY ***
Total pot $0.35 | Rake $0.01 | Jackpot $0 | Bingo $0 | Fortune $0
Board [Th Ks 2h]
Seat 1: e58c45c4 folded before Flop (didn't bet)
Seat 2: e87facd7 won ($0.34)
Seat 3: 33c482b9 folded before Flop (didn't bet)
Seat 4: Hero (button) folded before Flop (didn't bet)
Seat 5: 6feee1ec (small blind) folded on the Flop
Seat 6: cae134f0 (big blind) folded before Flop


Poker Hand #HD1182916896: Hold'em No Limit  ($0.02/$0.05) - 2023/03/30 20:16:22
Table 'NLHBlue133' 6-max Seat #3 is the button
Seat 1: e58c45c4 ($6.32 in chips)
Seat 2: e87facd7 ($1.61 in chips)
Seat 3: 33c482b9 ($5.03 in chips)
Seat 4: Hero ($6.51 in chips)
Seat 5: 6feee1ec ($5.09 in chips)
Seat 6: cae134f0 ($1.43 in chips)
Hero: posts small blind $0.02
6feee1ec: posts big blind $0.05
*** HOLE CARDS ***
Dealt to e58c45c4 
Dealt to e87facd7 
Dealt to 33c482b9 
Dealt to Hero [7d Tc]
Dealt to 6feee1ec 
Dealt to cae134f0 
cae134f0: folds
e58c45c4: raises $0.1 to $0.15
e87facd7: folds
33c482b9: calls $0.15
Hero: folds
6feee1ec: folds
*** FLOP *** [3c 9h 6d]
e58c45c4: checks
33c482b9: bets $0.13
e58c45c4: calls $0.13
*** TURN *** [3c 9h 6d] [4d]
e58c45c4: checks
33c482b9: checks
*** RIVER *** [3c 9h 6d 4d] [2s]
e58c45c4: checks
33c482b9: checks
e58c45c4: shows [6h 7h] (Pair of Sixes)
33c482b9: shows [Jh Jd] (Pair of Jacks)
*** SHOWDOWN ***
33c482b9 collected $0.6 from pot
*** SUMMARY ***
Total pot $0.63 | Rake $0.03 | Jackpot $0 | Bingo $0 | Fortune $0
Board [3c 9h 6d 4d 2s]
Seat 1: e58c45c4 showed [6h 7h] and lost with Pair of Sixes
Seat 2: e87facd7 folded before Flop (didn't bet)
Seat 3: 33c482b9 (button) showed [Jh Jd] and won ($0.6) with Pair of Jacks
Seat 4: Hero (small blind) folded before Flop
Seat 5: 6feee1ec (big blind) folded before Flop
Seat 6: cae134f0 folded before Flop (didn't bet)


Poker Hand #HD1182916858: Hold'em No Limit  ($0.02/$0.05) - 2023/03/30 20:16:08
Table 'NLHBlue133' 6-max Seat #2 is the button
Seat 1: e58c45c4 ($6.25 in chips)
Seat 2: e87facd7 ($1.61 in chips)
Seat 3: 33c482b9 ($5.05 in chips)
Seat 4: Hero ($6.56 in chips)
Seat 5: 6feee1ec ($5.09 in chips)
Seat 6: cae134f0 ($1.43 in chips)
33c482b9: posts small blind $0.02
Hero: posts big blind $0.05
*** HOLE CARDS ***
Dealt to e58c45c4 
Dealt to e87facd7 
Dealt to 33c482b9 
Dealt to Hero [7c Qs]
Dealt to 6feee1ec 
Dealt to cae134f0 
6feee1ec: folds
cae134f0: folds
e58c45c4: raises $0.08 to $0.13
e87facd7: folds
33c482b9: folds
Hero: folds
Uncalled bet ($0.08) returned to e58c45c4
*** SHOWDOWN ***
e58c45c4 collected $0.12 from pot
*** SUMMARY ***
Total pot $0.12 | Rake $0 | Jackpot $0 | Bingo $0 | Fortune $0
Seat 1: e58c45c4 collected ($0.12)
Seat 2: e87facd7 (button) folded before Flop (didn't bet)
Seat 3: 33c482b9 (small blind) folded before Flop
Seat 4: Hero (big blind) folded before Flop
Seat 5: 6feee1ec folded before Flop (didn't bet)
Seat 6: cae134f0 folded before Flop (didn't bet)


Poker Hand #HD1182916814: Hold'em No Limit  ($0.02/$0.05) - 2023/03/30 20:15:53
Table 'NLHBlue133' 6-max Seat #1 is the button
Seat 1: e58c45c4 ($6.25 in chips)
Seat 2: e87facd7 ($1.63 in chips)
Seat 3: 33c482b9 ($5.03 in chips)
Seat 4: Hero ($6.56 in chips)
Seat 5: 6feee1ec ($5.09 in chips)
Seat 6: cae134f0 ($1.43 in chips)
e87facd7: posts small blind $0.02
33c482b9: posts big blind $0.05
*** HOLE CARDS ***
Dealt to e58c45c4 
Dealt to e87facd7 
Dealt to 33c482b9 
Dealt to Hero [5s Kd]
Dealt to 6feee1ec 
Dealt to cae134f0 
Hero: folds
6feee1ec: folds
cae134f0: folds
e58c45c4: folds
e87facd7: folds
Uncalled bet ($0.03) returned to 33c482b9
*** SHOWDOWN ***
33c482b9 collected $0.04 from pot
*** SUMMARY ***
Total pot $0.04 | Rake $0 | Jackpot $0 | Bingo $0 | Fortune $0
Seat 1: e58c45c4 (button) folded before Flop (didn't bet)
Seat 2: e87facd7 (small blind) folded before Flop
Seat 3: 33c482b9 (big blind) collected ($0.04)
Seat 4: Hero folded before Flop (didn't bet)
Seat 5: 6feee1ec folded before Flop (didn't bet)
Seat 6: cae134f0 folded before Flop (didn't bet)


Poker Hand #HD1182916682: Hold'em No Limit  ($0.02/$0.05) - 2023/03/30 20:14:59
Table 'NLHBlue133' 6-max Seat #6 is the button
Seat 1: e58c45c4 ($6.4 in chips)
Seat 2: e87facd7 ($1.78 in chips)
Seat 3: 33c482b9 ($5.03 in chips)
Seat 4: Hero ($6.56 in chips)
Seat 5: 6feee1ec ($4.81 in chips)
Seat 6: cae134f0 ($1.43 in chips)
e58c45c4: posts small blind $0.02
e87facd7: posts big blind $0.05
*** HOLE CARDS ***
Dealt to e58c45c4 
Dealt to e87facd7 
Dealt to 33c482b9 
Dealt to Hero [8d Jh]
Dealt to 6feee1ec 
Dealt to cae134f0 
33c482b9: folds
Hero: folds
6feee1ec: raises $0.1 to $0.15
cae134f0: folds
e58c45c4: calls $0.13
e87facd7: calls $0.1
*** FLOP *** [7h Ts 6s]
e58c45c4: checks
e87facd7: checks
6feee1ec: bets $0.15
e58c45c4: folds
e87facd7: folds
Uncalled bet ($0.15) returned to 6feee1ec
*** SHOWDOWN ***
6feee1ec collected $0.43 from pot
*** SUMMARY ***
Total pot $0.45 | Rake $0.02 | Jackpot $0 | Bingo $0 | Fortune $0
Board [7h Ts 6s]
Seat 1: e58c45c4 (small blind) folded on the Flop
Seat 2: e87facd7 (big blind) folded on the Flop
Seat 3: 33c482b9 folded before Flop (didn't bet)
Seat 4: Hero folded before Flop (didn't bet)
Seat 5: 6feee1ec won ($0.43)
Seat 6: cae134f0 (button) folded before Flop (didn't bet)


Poker Hand #HD1182916631: Hold'em No Limit  ($0.02/$0.05) - 2023/03/30 20:14:42
Table 'NLHBlue133' 6-max Seat #5 is the button
Seat 1: e58c45c4 ($6.45 in chips)
Seat 2: e87facd7 ($1.71 in chips)
Seat 3: 33c482b9 ($5.03 in chips)
Seat 4: Hero ($6.56 in chips)
Seat 5: 6feee1ec ($4.81 in chips)
Seat 6: cae134f0 ($1.45 in chips)
cae134f0: posts small blind $0.02
e58c45c4: posts big blind $0.05
*** HOLE CARDS ***
Dealt to e58c45c4 
Dealt to e87facd7 
Dealt to 33c482b9 
Dealt to Hero [2h Th]
Dealt to 6feee1ec 
Dealt to cae134f0 
e87facd7: raises $0.1 to $0.15
33c482b9: folds
Hero: folds
6feee1ec: folds
cae134f0: folds
e58c45c4: folds
Uncalled bet ($0.1) returned to e87facd7
*** SHOWDOWN ***
e87facd7 collected $0.12 from pot
*** SUMMARY ***
Total pot $0.12 | Rake $0 | Jackpot $0 | Bingo $0 | Fortune $0
Seat 1: e58c45c4 (big blind) folded before Flop
Seat 2: e87facd7 collected ($0.12)
Seat 3: 33c482b9 folded before Flop (didn't bet)
Seat 4: Hero folded before Flop (didn't bet)
Seat 5: 6feee1ec (button) folded before Flop (didn't bet)
Seat 6: cae134f0 (small blind) folded before Flop


Poker Hand #HD1182916604: Hold'em No Limit  ($0.02/$0.05) - 2023/03/30 20:14:31
Table 'NLHBlue133' 6-max Seat #4 is the button
Seat 1: e58c45c4 ($6.45 in chips)
Seat 2: e87facd7 ($1.64 in chips)
Seat 3: 33c482b9 ($5.03 in chips)
Seat 4: Hero ($6.56 in chips)
Seat 5: 6feee1ec ($4.83 in chips)
Seat 6: cae134f0 ($1.5 in chips)
6feee1ec: posts small blind $0.02
cae134f0: posts big blind $0.05
*** HOLE CARDS ***
Dealt to e58c45c4 
Dealt to e87facd7 
Dealt to 33c482b9 
Dealt to Hero [2s 4h]
Dealt to 6feee1ec 
Dealt to cae134f0 
e58c45c4: folds
e87facd7: raises $0.07 to $0.12
33c482b9: folds
Hero: folds
6feee1ec: folds
cae134f0: folds
Uncalled bet ($0.07) returned to e87facd7
*** SHOWDOWN ***
e87facd7 collected $0.12 from pot
*** SUMMARY ***
Total pot $0.12 | Rake $0 | Jackpot $0 | Bingo $0 | Fortune $0
Seat 1: e58c45c4 folded before Flop (didn't bet)
Seat 2: e87facd7 collected ($0.12)
Seat 3: 33c482b9 folded before Flop (didn't bet)
Seat 4: Hero (button) folded before Flop (didn't bet)
Seat 5: 6feee1ec (small blind) folded before Flop
Seat 6: cae134f0 (big blind) folded before Flop


Poker Hand #HD1182916559: Hold'em No Limit  ($0.02/$0.05) - 2023/03/30 20:14:16
Table 'NLHBlue133' 6-max Seat #3 is the button
Seat 1: e58c45c4 ($6.45 in chips)
Seat 2: e87facd7 ($1.64 in chips)
Seat 3: 33c482b9 ($5.03 in chips)
Seat 4: Hero ($6.58 in chips)
Seat 5: 6feee1ec ($4.81 in chips)
Seat 6: cae134f0 ($1.5 in chips)
Hero: posts small blind $0.02
6feee1ec: posts big blind $0.05
*** HOLE CARDS ***
Dealt to e58c45c4 
Dealt to e87facd7 
Dealt to 33c482b9 
Dealt to Hero [3s 4d]
Dealt to 6feee1ec 
Dealt to cae134f0 
cae134f0: folds
e58c45c4: folds
e87facd7: folds
33c482b9: folds
Hero: folds
Uncalled bet ($0.03) returned to 6feee1ec
*** SHOWDOWN ***
6feee1ec collected $0.04 from pot
*** SUMMARY ***
Total pot $0.04 | Rake $0 | Jackpot $0 | Bingo $0 | Fortune $0
Seat 1: e58c45c4 folded before Flop (didn't bet)
Seat 2: e87facd7 folded before Flop (didn't bet)
Seat 3: 33c482b9 (button) folded before Flop (didn't bet)
Seat 4: Hero (small blind) folded before Flop
Seat 5: 6feee1ec (big blind) collected ($0.04)
Seat 6: cae134f0 folded before Flop (didn't bet)


Poker Hand #HD1182916521: Hold'em No Limit  ($0.02/$0.05) - 2023/03/30 20:14:00
Table 'NLHBlue133' 6-max Seat #2 is the button
Seat 1: e58c45c4 ($6.45 in chips)
Seat 2: e87facd7 ($1.64 in chips)
Seat 3: 33c482b9 ($5.05 in chips)
Seat 4: Hero ($6.56 in chips)
Seat 5: 6feee1ec ($4.81 in chips)
Seat 6: cae134f0 ($1.5 in chips)
33c482b9: posts small blind $0.02
Hero: posts big blind $0.05
*** HOLE CARDS ***
Dealt to e58c45c4 
Dealt to e87facd7 
Dealt to 33c482b9 
Dealt to Hero [9d 7d]
Dealt to 6feee1ec 
Dealt to cae134f0 
6feee1ec: folds
cae134f0: folds
e58c45c4: folds
e87facd7: folds
33c482b9: folds
Uncalled bet ($0.03) returned to Hero
*** SHOWDOWN ***
Hero collected $0.04 from pot
*** SUMMARY ***
Total pot $0.04 | Rake $0 | Jackpot $0 | Bingo $0 | Fortune $0
Seat 1: e58c45c4 folded before Flop (didn't bet)
Seat 2: e87facd7 (button) folded before Flop (didn't bet)
Seat 3: 33c482b9 (small blind) folded before Flop
Seat 4: Hero (big blind) collected ($0.04)
Seat 5: 6feee1ec folded before Flop (didn't bet)
Seat 6: cae134f0 folded before Flop (didn't bet)


Poker Hand #HD1182916438: Hold'em No Limit  ($0.02/$0.05) - 2023/03/30 20:13:29
Table 'NLHBlue133' 6-max Seat #1 is the button
Seat 1: e58c45c4 ($6.45 in chips)
Seat 2: e87facd7 ($1.37 in chips)
Seat 3: 33c482b9 ($5.1 in chips)
Seat 4: Hero ($6.68 in chips)
Seat 5: 6feee1ec ($4.81 in chips)
Seat 6: cae134f0 ($1.62 in chips)
e87facd7: posts small blind $0.02
33c482b9: posts big blind $0.05
*** HOLE CARDS ***
Dealt to e58c45c4 
Dealt to e87facd7 
Dealt to 33c482b9 
Dealt to Hero [8c 9c]
Dealt to 6feee1ec 
Dealt to cae134f0 
Hero: raises $0.07 to $0.12
6feee1ec: folds
cae134f0: calls $0.12
e58c45c4: folds
e87facd7: raises $1.25 to $1.37 and is all-in
33c482b9: folds
Hero: folds
cae134f0: folds
Uncalled bet ($1.25) returned to e87facd7
*** SHOWDOWN ***
e87facd7 collected $0.39 from pot
*** SUMMARY ***
Total pot $0.41 | Rake $0.02 | Jackpot $0 | Bingo $0 | Fortune $0
Seat 1: e58c45c4 (button) folded before Flop (didn't bet)
Seat 2: e87facd7 (small blind) collected ($0.39)
Seat 3: 33c482b9 (big blind) folded before Flop
Seat 4: Hero folded before Flop
Seat 5: 6feee1ec folded before Flop (didn't bet)
Seat 6: cae134f0 folded before Flop


Poker Hand #HD1182916315: Hold'em No Limit  ($0.02/$0.05) - 2023/03/30 20:12:43
Table 'NLHBlue133' 6-max Seat #6 is the button
Seat 1: e58c45c4 ($6.33 in chips)
Seat 2: e87facd7 ($1.5 in chips)
Seat 3: 33c482b9 ($5.1 in chips)
Seat 4: Hero ($6.68 in chips)
Seat 5: 6feee1ec ($4.81 in chips)
Seat 6: cae134f0 ($1.62 in chips)
e58c45c4: posts small blind $0.02
e87facd7: posts big blind $0.05
*** HOLE CARDS ***
Dealt to e58c45c4 
Dealt to e87facd7 
Dealt to 33c482b9 
Dealt to Hero [Js 2d]
Dealt to 6feee1ec 
Dealt to cae134f0 
33c482b9: folds
Hero: folds
6feee1ec: folds
cae134f0: folds
e58c45c4: raises $0.08 to $0.13
e87facd7: calls $0.08
*** FLOP *** [6d Jd 7c]
e58c45c4: checks
e87facd7: checks
*** TURN *** [6d Jd 7c] [Jh]
e58c45c4: bets $0.12
e87facd7: folds
Uncalled bet ($0.12) returned to e58c45c4
*** SHOWDOWN ***
e58c45c4 collected $0.25 from pot
*** SUMMARY ***
Total pot $0.26 | Rake $0.01 | Jackpot $0 | Bingo $0 | Fortune $0
Board [6d Jd 7c Jh]
Seat 1: e58c45c4 (small blind) won ($0.25)
Seat 2: e87facd7 (big blind) folded on the Turn
Seat 3: 33c482b9 folded before Flop (didn't bet)
Seat 4: Hero folded before Flop (didn't bet)
Seat 5: 6feee1ec folded before Flop (didn't bet)
Seat 6: cae134f0 (button) folded before Flop (didn't bet)


Poker Hand #HD1182916203: Hold'em No Limit  ($0.02/$0.05) - 2023/03/30 20:12:04
Table 'NLHBlue133' 6-max Seat #5 is the button
Seat 1: e58c45c4 ($6.38 in chips)
Seat 3: 33c482b9 ($4.86 in chips)
Seat 4: Hero ($6.68 in chips)
Seat 5: 6feee1ec ($5 in chips)
Seat 6: cae134f0 ($1.64 in chips)
cae134f0: posts small blind $0.02
e58c45c4: posts big blind $0.05
*** HOLE CARDS ***
Dealt to e58c45c4 
Dealt to 33c482b9 
Dealt to Hero [7h 4c]
Dealt to 6feee1ec 
Dealt to cae134f0 
33c482b9: raises $0.05 to $0.1
Hero: folds
6feee1ec: calls $0.1
cae134f0: folds
e58c45c4: folds
*** FLOP *** [5s 9s 6d]
33c482b9: checks
6feee1ec: bets $0.09
33c482b9: calls $0.09
*** TURN *** [5s 9s 6d] [Tc]
33c482b9: checks
6feee1ec: checks
*** RIVER *** [5s 9s 6d Tc] [3d]
33c482b9: bets $0.23
6feee1ec: folds
Uncalled bet ($0.23) returned to 33c482b9
*** SHOWDOWN ***
33c482b9 collected $0.43 from pot
*** SUMMARY ***
Total pot $0.45 | Rake $0.02 | Jackpot $0 | Bingo $0 | Fortune $0
Board [5s 9s 6d Tc 3d]
Seat 1: e58c45c4 (big blind) folded before Flop
Seat 3: 33c482b9 won ($0.43)
Seat 4: Hero folded before Flop (didn't bet)
Seat 5: 6feee1ec (button) folded on the River
Seat 6: cae134f0 (small blind) folded before Flop


Poker Hand #HD1182916151: Hold'em No Limit  ($0.02/$0.05) - 2023/03/30 20:11:47
Table 'NLHBlue133' 6-max Seat #4 is the button
Seat 1: e58c45c4 ($6.31 in chips)
Seat 3: 33c482b9 ($4.86 in chips)
Seat 4: Hero ($6.68 in chips)
Seat 5: 6feee1ec ($5.02 in chips)
Seat 6: cae134f0 ($1.69 in chips)
6feee1ec: posts small blind $0.02
cae134f0: posts big blind $0.05
*** HOLE CARDS ***
Dealt to e58c45c4 
Dealt to 33c482b9 
Dealt to Hero [Qd 2s]
Dealt to 6feee1ec 
Dealt to cae134f0 
e58c45c4: raises $0.1 to $0.15
33c482b9: folds
Hero: folds
6feee1ec: folds
cae134f0: folds
Uncalled bet ($0.1) returned to e58c45c4
*** SHOWDOWN ***
e58c45c4 collected $0.12 from pot
*** SUMMARY ***
Total pot $0.12 | Rake $0 | Jackpot $0 | Bingo $0 | Fortune $0
Seat 1: e58c45c4 collected ($0.12)
Seat 3: 33c482b9 folded before Flop (didn't bet)
Seat 4: Hero (button) folded before Flop (didn't bet)
Seat 5: 6feee1ec (small blind) folded before Flop
Seat 6: cae134f0 (big blind) folded before Flop


Poker Hand #HD1182916111: Hold'em No Limit  ($0.02/$0.05) - 2023/03/30 20:11:35
Table 'NLHBlue133' 6-max Seat #3 is the button
Seat 1: e58c45c4 ($6.31 in chips)
Seat 3: 33c482b9 ($4.86 in chips)
Seat 4: Hero ($6.7 in chips)
Seat 5: 6feee1ec ($5 in chips)
Seat 6: cae134f0 ($1.69 in chips)
Hero: posts small blind $0.02
6feee1ec: posts big blind $0.05
*** HOLE CARDS ***
Dealt to e58c45c4 
Dealt to 33c482b9 
Dealt to Hero [Qs 4d]
Dealt to 6feee1ec 
Dealt to cae134f0 
cae134f0: folds
e58c45c4: folds
33c482b9: folds
Hero: folds
Uncalled bet ($0.03) returned to 6feee1ec
*** SHOWDOWN ***
6feee1ec collected $0.04 from pot
*** SUMMARY ***
Total pot $0.04 | Rake $0 | Jackpot $0 | Bingo $0 | Fortune $0
Seat 1: e58c45c4 folded before Flop (didn't bet)
Seat 3: 33c482b9 (button) folded before Flop (didn't bet)
Seat 4: Hero (small blind) folded before Flop
Seat 5: 6feee1ec (big blind) collected ($0.04)
Seat 6: cae134f0 folded before Flop (didn't bet)


Poker Hand #HD1182915983: Hold'em No Limit  ($0.02/$0.05) - 2023/03/30 20:10:47
Table 'NLHBlue133' 6-max Seat #2 is the button
Seat 1: e58c45c4 ($6.31 in chips)
Seat 2: e9dfe233 ($2.55 in chips)
Seat 3: 33c482b9 ($4.88 in chips)
Seat 4: Hero ($6.49 in chips)
Seat 5: 6feee1ec ($5 in chips)
Seat 6: cae134f0 ($1.79 in chips)
33c482b9: posts small blind $0.02
Hero: posts big blind $0.05
*** HOLE CARDS ***
Dealt to e58c45c4 
Dealt to e9dfe233 
Dealt to 33c482b9 
Dealt to Hero [Ts Qc]
Dealt to 6feee1ec 
Dealt to cae134f0 
6feee1ec: folds
cae134f0: raises $0.05 to $0.1
e58c45c4: folds
e9dfe233: calls $0.1
33c482b9: folds
Hero: calls $0.05
*** FLOP *** [Kd 8c Ks]
Hero: checks
cae134f0: checks
e9dfe233: checks
*** TURN *** [Kd 8c Ks] [4c]
Hero: checks
cae134f0: checks
e9dfe233: checks
*** RIVER *** [Kd 8c Ks 4c] [Td]
Hero: bets $0.16
cae134f0: folds
e9dfe233: folds
Uncalled bet ($0.16) returned to Hero
*** SHOWDOWN ***
Hero collected $0.31 from pot
*** SUMMARY ***
Total pot $0.32 | Rake $0.01 | Jackpot $0 | Bingo $0 | Fortune $0
Board [Kd 8c Ks 4c Td]
Seat 1: e58c45c4 folded before Flop (didn't bet)
Seat 2: e9dfe233 (button) folded on the River
Seat 3: 33c482b9 (small blind) folded before Flop
Seat 4: Hero (big blind) won ($0.31)
Seat 5: 6feee1ec folded before Flop (didn't bet)
Seat 6: cae134f0 folded on the River


Poker Hand #HD1182915805: Hold'em No Limit  ($0.02/$0.05) - 2023/03/30 20:09:41
Table 'NLHBlue133' 6-max Seat #1 is the button
Seat 1: e58c45c4 ($6.31 in chips)
Seat 2: e9dfe233 ($1.28 in chips)
Seat 3: 33c482b9 ($4.93 in chips)
Seat 4: Hero ($6.2 in chips)
Seat 5: 6feee1ec ($5 in chips)
Seat 6: cae134f0 ($1.91 in chips)
e9dfe233: posts small blind $0.02
33c482b9: posts big blind $0.05
*** HOLE CARDS ***
Dealt to e58c45c4 
Dealt to e9dfe233 
Dealt to 33c482b9 
Dealt to Hero [Tc Qc]
Dealt to 6feee1ec 
Dealt to cae134f0 
Hero: raises $0.07 to $0.12
6feee1ec: folds
cae134f0: calls $0.12
e58c45c4: folds
e9dfe233: calls $0.1
33c482b9: folds
*** FLOP *** [9s Th 6h]
e9dfe233: checks
Hero: bets $0.14
cae134f0: folds
e9dfe233: raises $0.23 to $0.37
Hero: raises $5.71 to $6.08 and is all-in
e9dfe233: calls $0.79 and is all-in
Uncalled bet ($4.92) returned to Hero
Hero: shows [Tc Qc] (Pair of Tens)
e9dfe233: shows [Qh 4h] (Queen-High)
*** TURN *** [9s Th 6h] [7h]
*** RIVER *** [9s Th 6h 7h] [Td]
Hero: Receives Cashout ($1.57)
*** SHOWDOWN ***
e9dfe233 collected $2.55 from pot
*** SUMMARY ***
Total pot $2.73 | Rake $0.13 | Jackpot $0.05 | Bingo $0 | Fortune $0
Board [9s Th 6h 7h Td]
Seat 1: e58c45c4 (button) folded before Flop (didn't bet)
Seat 2: e9dfe233 (small blind) showed [Qh 4h] and won ($2.55) with Queen High Flush
Seat 3: 33c482b9 (big blind) folded before Flop
Seat 4: Hero showed [Tc Qc] and lost with Three Tens, EV Cashout ($1.57)
Seat 5: 6feee1ec folded before Flop (didn't bet)
Seat 6: cae134f0 folded on the Flop


Poker Hand #HD1182915754: Hold'em No Limit  ($0.02/$0.05) - 2023/03/30 20:09:26
Table 'NLHBlue133' 6-max Seat #6 is the button
Seat 1: e58c45c4 ($6.26 in chips)
Seat 2: e9dfe233 ($1.33 in chips)
Seat 3: 33c482b9 ($4.93 in chips)
Seat 4: Hero ($6.2 in chips)
Seat 5: 6feee1ec ($5 in chips)
Seat 6: cae134f0 ($1.91 in chips)
e58c45c4: posts small blind $0.02
e9dfe233: posts big blind $0.05
*** HOLE CARDS ***
Dealt to e58c45c4 
Dealt to e9dfe233 
Dealt to 33c482b9 
Dealt to Hero [9h 6c]
Dealt to 6feee1ec 
Dealt to cae134f0 
33c482b9: folds
Hero: folds
6feee1ec: folds
cae134f0: folds
e58c45c4: raises $0.08 to $0.13
e9dfe233: folds
Uncalled bet ($0.08) returned to e58c45c4
*** SHOWDOWN ***
e58c45c4 collected $0.1 from pot
*** SUMMARY ***
Total pot $0.1 | Rake $0 | Jackpot $0 | Bingo $0 | Fortune $0
Seat 1: e58c45c4 (small blind) collected ($0.1)
Seat 2: e9dfe233 (big blind) folded before Flop
Seat 3: 33c482b9 folded before Flop (didn't bet)
Seat 4: Hero folded before Flop (didn't bet)
Seat 5: 6feee1ec folded before Flop (didn't bet)
Seat 6: cae134f0 (button) folded before Flop (didn't bet)


Poker Hand #HD1182865633: Hold'em No Limit  ($0.02/$0.05) - 2023/03/30 20:08:34
Table 'NLHBlue133' 6-max Seat #5 is the button
Seat 1: e58c45c4 ($6.48 in chips)
Seat 2: e9dfe233 ($1.33 in chips)
Seat 3: 33c482b9 ($4.93 in chips)
Seat 4: Hero ($6.2 in chips)
Seat 5: 6feee1ec ($5 in chips)
Seat 6: cae134f0 ($1.71 in chips)
cae134f0: posts small blind $0.02
e58c45c4: posts big blind $0.05
*** HOLE CARDS ***
Dealt to e58c45c4 
Dealt to e9dfe233 
Dealt to 33c482b9 
Dealt to Hero [Jd 3h]
Dealt to 6feee1ec 
Dealt to cae134f0 
e9dfe233: folds
33c482b9: folds
Hero: folds
6feee1ec: folds
cae134f0: calls $0.03
e58c45c4: checks
*** FLOP *** [Ad 7s 5c]
cae134f0: checks
e58c45c4: checks
*** TURN *** [Ad 7s 5c] [8c]
cae134f0: checks
e58c45c4: bets $0.06
cae134f0: raises $0.11 to $0.17
e58c45c4: calls $0.11
*** RIVER *** [Ad 7s 5c 8c] [9s]
cae134f0: bets $0.22
e58c45c4: folds
Uncalled bet ($0.22) returned to cae134f0
*** SHOWDOWN ***
cae134f0 collected $0.42 from pot
*** SUMMARY ***
Total pot $0.44 | Rake $0.02 | Jackpot $0 | Bingo $0 | Fortune $0
Board [Ad 7s 5c 8c 9s]
Seat 1: e58c45c4 (big blind) folded on the River
Seat 2: e9dfe233 folded before Flop (didn't bet)
Seat 3: 33c482b9 folded before Flop (didn't bet)
Seat 4: Hero folded before Flop (didn't bet)
Seat 5: 6feee1ec (button) folded before Flop (didn't bet)
Seat 6: cae134f0 (small blind) won ($0.42)


Poker Hand #HD1182865519: Hold'em No Limit  ($0.02/$0.05) - 2023/03/30 20:07:57
Table 'NLHBlue133' 6-max Seat #4 is the button
Seat 1: e58c45c4 ($6.48 in chips)
Seat 2: e9dfe233 ($1.18 in chips)
Seat 3: 33c482b9 ($4.93 in chips)
Seat 4: Hero ($6.2 in chips)
Seat 5: 6feee1ec ($5.02 in chips)
Seat 6: cae134f0 ($1.85 in chips)
6feee1ec: posts small blind $0.02
cae134f0: posts big blind $0.05
*** HOLE CARDS ***
Dealt to e58c45c4 
Dealt to e9dfe233 
Dealt to 33c482b9 
Dealt to Hero [Jh 3d]
Dealt to 6feee1ec 
Dealt to cae134f0 
e58c45c4: folds
e9dfe233: calls $0.05
33c482b9: folds
Hero: folds
6feee1ec: folds
cae134f0: checks
*** FLOP *** [7h 4c 6c]
cae134f0: checks
e9dfe233: bets $0.09
cae134f0: calls $0.09
*** TURN *** [7h 4c 6c] [Ah]
cae134f0: checks
e9dfe233: bets $0.23
cae134f0: folds
Uncalled bet ($0.23) returned to e9dfe233
*** SHOWDOWN ***
e9dfe233 collected $0.29 from pot
*** SUMMARY ***
Total pot $0.3 | Rake $0.01 | Jackpot $0 | Bingo $0 | Fortune $0
Board [7h 4c 6c Ah]
Seat 1: e58c45c4 folded before Flop (didn't bet)
Seat 2: e9dfe233 won ($0.29)
Seat 3: 33c482b9 folded before Flop (didn't bet)
Seat 4: Hero (button) folded before Flop (didn't bet)
Seat 5: 6feee1ec (small blind) folded before Flop
Seat 6: cae134f0 (big blind) folded on the Turn


Poker Hand #HD1182865500: Hold'em No Limit  ($0.02/$0.05) - 2023/03/30 20:07:50
Table 'NLHBlue133' 6-max Seat #3 is the button
Seat 1: e58c45c4 ($6.48 in chips)
Seat 2: e9dfe233 ($1.18 in chips)
Seat 3: 33c482b9 ($4.93 in chips)
Seat 4: Hero ($6.22 in chips)
Seat 5: 6feee1ec ($5 in chips)
Hero: posts small blind $0.02
6feee1ec: posts big blind $0.05
*** HOLE CARDS ***
Dealt to e58c45c4 
Dealt to e9dfe233 
Dealt to 33c482b9 
Dealt to Hero [2h 3c]
Dealt to 6feee1ec 
e58c45c4: folds
e9dfe233: folds
33c482b9: folds
Hero: folds
Uncalled bet ($0.03) returned to 6feee1ec
*** SHOWDOWN ***
6feee1ec collected $0.04 from pot
*** SUMMARY ***
Total pot $0.04 | Rake $0 | Jackpot $0 | Bingo $0 | Fortune $0
Seat 1: e58c45c4 folded before Flop (didn't bet)
Seat 2: e9dfe233 folded before Flop (didn't bet)
Seat 3: 33c482b9 (button) folded before Flop (didn't bet)
Seat 4: Hero (small blind) folded before Flop
Seat 5: 6feee1ec (big blind) collected ($0.04)


Poker Hand #HD1182865390: Hold'em No Limit  ($0.02/$0.05) - 2023/03/30 20:07:05
Table 'NLHBlue133' 6-max Seat #2 is the button
Seat 1: e58c45c4 ($5.22 in chips)
Seat 2: e9dfe233 ($1.18 in chips)
Seat 3: 33c482b9 ($4.95 in chips)
Seat 4: Hero ($6.27 in chips)
Seat 6: cae134f0 ($1.37 in chips)
33c482b9: posts small blind $0.02
Hero: posts big blind $0.05
*** HOLE CARDS ***
Dealt to e58c45c4 
Dealt to e9dfe233 
Dealt to 33c482b9 
Dealt to Hero [3d 5h]
Dealt to cae134f0 
cae134f0: calls $0.05
e58c45c4: raises $0.19 to $0.24
e9dfe233: folds
33c482b9: folds
Hero: folds
cae134f0: calls $0.19
*** FLOP *** [Ks 4s 3s]
cae134f0: checks
e58c45c4: bets $0.25
cae134f0: raises $0.35 to $0.6
e58c45c4: calls $0.35
*** TURN *** [Ks 4s 3s] [6s]
cae134f0: bets $0.53 and is all-in
e58c45c4: calls $0.53
cae134f0: shows [Qh Kh] (Pair of Kings)
e58c45c4: shows [7s 7d] (King High Flush)
*** RIVER *** [Ks 4s 3s 6s] [5c]
*** SHOWDOWN ***
e58c45c4 collected $2.63 from pot
*** SUMMARY ***
Total pot $2.81 | Rake $0.13 | Jackpot $0.05 | Bingo $0 | Fortune $0
Board [Ks 4s 3s 6s 5c]
Seat 1: e58c45c4 showed [7s 7d] and won ($2.63) with King High Flush
Seat 2: e9dfe233 (button) folded before Flop (didn't bet)
Seat 3: 33c482b9 (small blind) folded before Flop
Seat 4: Hero (big blind) folded before Flop
Seat 6: cae134f0 showed [Qh Kh] and lost with Pair of Kings


Poker Hand #HD1182865311: Hold'em No Limit  ($0.02/$0.05) - 2023/03/30 20:06:33
Table 'NLHBlue133' 6-max Seat #1 is the button
Seat 1: e58c45c4 ($5.22 in chips)
Seat 2: e9dfe233 ($1.02 in chips)
Seat 3: 33c482b9 ($5 in chips)
Seat 4: Hero ($6.39 in chips)
Seat 6: cae134f0 ($1.37 in chips)
e9dfe233: posts small blind $0.02
33c482b9: posts big blind $0.05
*** HOLE CARDS ***
Dealt to e58c45c4 
Dealt to e9dfe233 
Dealt to 33c482b9 
Dealt to Hero [6d 6c]
Dealt to cae134f0 
Hero: raises $0.07 to $0.12
cae134f0: folds
e58c45c4: folds
e9dfe233: calls $0.1
33c482b9: folds
*** FLOP *** [Js 8d 2s]
e9dfe233: bets $0.15
Hero: folds
Uncalled bet ($0.15) returned to e9dfe233
*** SHOWDOWN ***
e9dfe233 collected $0.28 from pot
*** SUMMARY ***
Total pot $0.29 | Rake $0.01 | Jackpot $0 | Bingo $0 | Fortune $0
Board [Js 8d 2s]
Seat 1: e58c45c4 (button) folded before Flop (didn't bet)
Seat 2: e9dfe233 (small blind) won ($0.28)
Seat 3: 33c482b9 (big blind) folded before Flop
Seat 4: Hero folded on the Flop
Seat 6: cae134f0 folded before Flop (didn't bet)


Poker Hand #HD1182865267: Hold'em No Limit  ($0.02/$0.05) - 2023/03/30 20:06:15
Table 'NLHBlue133' 6-max Seat #6 is the button
Seat 1: e58c45c4 ($5.24 in chips)
Seat 2: e9dfe233 ($1 in chips)
Seat 4: Hero ($6.39 in chips)
Seat 6: cae134f0 ($1.37 in chips)
e58c45c4: posts small blind $0.02
e9dfe233: posts big blind $0.05
*** HOLE CARDS ***
Dealt to e58c45c4 
Dealt to e9dfe233 
Dealt to Hero [4s Qc]
Dealt to cae134f0 
Hero: folds
cae134f0: folds
e58c45c4: folds
Uncalled bet ($0.03) returned to e9dfe233
*** SHOWDOWN ***
e9dfe233 collected $0.04 from pot
*** SUMMARY ***
Total pot $0.04 | Rake $0 | Jackpot $0 | Bingo $0 | Fortune $0
Seat 1: e58c45c4 (small blind) folded before Flop
Seat 2: e9dfe233 (big blind) collected ($0.04)
Seat 4: Hero folded before Flop (didn't bet)
Seat 6: cae134f0 (button) folded before Flop (didn't bet)


Poker Hand #HD1182865230: Hold'em No Limit  ($0.02/$0.05) - 2023/03/30 20:06:05
Table 'NLHBlue133' 6-max Seat #4 is the button
Seat 1: e58c45c4 ($5.29 in chips)
Seat 4: Hero ($6.32 in chips)
Seat 6: cae134f0 ($1.39 in chips)
cae134f0: posts small blind $0.02
e58c45c4: posts big blind $0.05
*** HOLE CARDS ***
Dealt to e58c45c4 
Dealt to Hero [Td 9d]
Dealt to cae134f0 
Hero: raises $0.07 to $0.12
cae134f0: folds
e58c45c4: folds
Uncalled bet ($0.07) returned to Hero
*** SHOWDOWN ***
Hero collected $0.12 from pot
*** SUMMARY ***
Total pot $0.12 | Rake $0 | Jackpot $0 | Bingo $0 | Fortune $0
Seat 1: e58c45c4 (big blind) folded before Flop
Seat 4: Hero (button) collected ($0.12)
Seat 6: cae134f0 (small blind) folded before Flop


Poker Hand #HD1182865152: Hold'em No Limit  ($0.02/$0.05) - 2023/03/30 20:05:34
Table 'NLHBlue133' 6-max Seat #1 is the button
Seat 1: e58c45c4 ($5 in chips)
Seat 3: 81635428 ($5.46 in chips)
Seat 4: Hero ($6.37 in chips)
Seat 6: cae134f0 ($1.63 in chips)
81635428: posts small blind $0.02
Hero: posts big blind $0.05
*** HOLE CARDS ***
Dealt to e58c45c4 
Dealt to 81635428 
Dealt to Hero [6h Ac]
Dealt to cae134f0 
cae134f0: calls $0.05
e58c45c4: raises $0.19 to $0.24
81635428: folds
Hero: folds
cae134f0: calls $0.19
*** FLOP *** [3c 2d 2h]
cae134f0: checks
e58c45c4: bets $0.25
cae134f0: folds
Uncalled bet ($0.25) returned to e58c45c4
*** SHOWDOWN ***
e58c45c4 collected $0.53 from pot
*** SUMMARY ***
Total pot $0.55 | Rake $0.02 | Jackpot $0 | Bingo $0 | Fortune $0
Board [3c 2d 2h]
Seat 1: e58c45c4 (button) won ($0.53)
Seat 3: 81635428 (small blind) folded before Flop
Seat 4: Hero (big blind) folded before Flop
Seat 6: cae134f0 folded on the Flop


Poker Hand #HD1182865110: Hold'em No Limit  ($0.02/$0.05) - 2023/03/30 20:05:23
Table 'NLHBlue133' 6-max Seat #6 is the button
Seat 1: e58c45c4 ($5.02 in chips)
Seat 3: 81635428 ($5.51 in chips)
Seat 4: Hero ($6.37 in chips)
Seat 6: cae134f0 ($1.56 in chips)
e58c45c4: posts small blind $0.02
81635428: posts big blind $0.05
*** HOLE CARDS ***
Dealt to e58c45c4 
Dealt to 81635428 
Dealt to Hero [5h As]
Dealt to cae134f0 
Hero: folds
cae134f0: raises $0.1 to $0.15
e58c45c4: folds
81635428: folds
Uncalled bet ($0.1) returned to cae134f0
*** SHOWDOWN ***
cae134f0 collected $0.12 from pot
*** SUMMARY ***
Total pot $0.12 | Rake $0 | Jackpot $0 | Bingo $0 | Fortune $0
Seat 1: e58c45c4 (small blind) folded before Flop
Seat 3: 81635428 (big blind) folded before Flop
Seat 4: Hero folded before Flop (didn't bet)
Seat 6: cae134f0 (button) collected ($0.12)


Poker Hand #HD1182865092: Hold'em No Limit  ($0.02/$0.05) - 2023/03/30 20:05:14
Table 'NLHBlue133' 6-max Seat #4 is the button
Seat 1: e58c45c4 ($5 in chips)
Seat 3: 81635428 ($5.51 in chips)
Seat 4: Hero ($6.37 in chips)
Seat 6: cae134f0 ($1.58 in chips)
cae134f0: posts small blind $0.02
e58c45c4: posts big blind $0.05
*** HOLE CARDS ***
Dealt to e58c45c4 
Dealt to 81635428 
Dealt to Hero [8d 7c]
Dealt to cae134f0 
81635428: folds
Hero: folds
cae134f0: folds
Uncalled bet ($0.03) returned to e58c45c4
*** SHOWDOWN ***
e58c45c4 collected $0.04 from pot
*** SUMMARY ***
Total pot $0.04 | Rake $0 | Jackpot $0 | Bingo $0 | Fortune $0
Seat 1: e58c45c4 (big blind) collected ($0.04)
Seat 3: 81635428 folded before Flop (didn't bet)
Seat 4: Hero (button) folded before Flop (didn't bet)
Seat 6: cae134f0 (small blind) folded before Flop


Poker Hand #HD1182865067: Hold'em No Limit  ($0.02/$0.05) - 2023/03/30 20:05:06
Table 'NLHBlue133' 6-max Seat #3 is the button
Seat 3: 81635428 ($5.44 in chips)
Seat 4: Hero ($6.39 in chips)
Seat 5: 995db773 ($4.55 in chips)
Seat 6: cae134f0 ($1.58 in chips)
Hero: posts small blind $0.02
995db773: posts big blind $0.05
*** HOLE CARDS ***
Dealt to 81635428 
Dealt to Hero [8h Jd]
Dealt to 995db773 
Dealt to cae134f0 
cae134f0: folds
81635428: raises $0.08 to $0.13
Hero: folds
995db773: folds
Uncalled bet ($0.08) returned to 81635428
*** SHOWDOWN ***
81635428 collected $0.12 from pot
*** SUMMARY ***
Total pot $0.12 | Rake $0 | Jackpot $0 | Bingo $0 | Fortune $0
Seat 3: 81635428 (button) collected ($0.12)
Seat 4: Hero (small blind) folded before Flop
Seat 5: 995db773 (big blind) folded before Flop
Seat 6: cae134f0 folded before Flop (didn't bet)


Poker Hand #HD1182864949: Hold'em No Limit  ($0.02/$0.05) - 2023/03/30 20:04:15
Table 'NLHBlue133' 6-max Seat #1 is the button
Seat 1: 24ef55dc ($5 in chips)
Seat 2: e9dfe233 ($1.45 in chips)
Seat 3: 81635428 ($5.49 in chips)
Seat 4: Hero ($6.39 in chips)
Seat 5: 995db773 ($3.24 in chips)
Seat 6: cae134f0 ($1.58 in chips)
e9dfe233: posts small blind $0.02
81635428: posts big blind $0.05
*** HOLE CARDS ***
Dealt to 24ef55dc 
Dealt to e9dfe233 
Dealt to 81635428 
Dealt to Hero [Kc 7d]
Dealt to 995db773 
Dealt to cae134f0 
Hero: folds
995db773: raises $0.08 to $0.13
cae134f0: folds
24ef55dc: folds
e9dfe233: raises $0.11 to $0.24
81635428: folds
995db773: raises $3 to $3.24 and is all-in
e9dfe233: calls $1.21 and is all-in
Uncalled bet ($1.79) returned to 995db773
995db773: shows [Ah Th]
e9dfe233: shows [Td Tc]
*** FLOP *** [3h Qd 7h]
*** TURN *** [3h Qd 7h] [4h]
*** RIVER *** [3h Qd 7h 4h] [8s]
*** SHOWDOWN ***
995db773 collected $2.76 from pot
*** SUMMARY ***
Total pot $2.95 | Rake $0.14 | Jackpot $0.05 | Bingo $0 | Fortune $0
Board [3h Qd 7h 4h 8s]
Seat 1: 24ef55dc (button) folded before Flop (didn't bet)
Seat 2: e9dfe233 (small blind) showed [Td Tc] and lost with Pair of Tens
Seat 3: 81635428 (big blind) folded before Flop
Seat 4: Hero folded before Flop (didn't bet)
Seat 5: 995db773 showed [Ah Th] and won ($2.76) with Ace High Flush
Seat 6: cae134f0 folded before Flop (didn't bet)


Poker Hand #HD1182864760: Hold'em No Limit  ($0.02/$0.05) - 2023/03/30 20:03:09
Table 'NLHBlue133' 6-max Seat #6 is the button
Seat 1: 24ef55dc ($5 in chips)
Seat 2: e9dfe233 ($1.5 in chips)
Seat 3: 81635428 ($5.49 in chips)
Seat 4: Hero ($5 in chips)
Seat 5: 995db773 ($4.76 in chips)
Seat 6: cae134f0 ($1.58 in chips)
24ef55dc: posts small blind $0.02
e9dfe233: posts big blind $0.05
*** HOLE CARDS ***
Dealt to 24ef55dc 
Dealt to e9dfe233 
Dealt to 81635428 
Dealt to Hero [6d 6h]
Dealt to 995db773 
Dealt to cae134f0 
81635428: folds
Hero: raises $0.07 to $0.12
995db773: raises $0.23 to $0.35
cae134f0: folds
24ef55dc: folds
e9dfe233: folds
Hero: calls $0.23
*** FLOP *** [9s 9c 9h]
Hero: checks
995db773: checks
*** TURN *** [9s 9c 9h] [Jh]
Hero: bets $0.39
995db773: calls $0.39
*** RIVER *** [9s 9c 9h Jh] [5h]
Hero: checks
995db773: bets $0.78
Hero: calls $0.78
995db773: shows [Ad Qs] (Three Nines)
Hero: shows [6d 6h] (Nines Full over Sixes)
*** SHOWDOWN ***
Hero collected $2.91 from pot
*** SUMMARY ***
Total pot $3.11 | Rake $0.15 | Jackpot $0.05 | Bingo $0 | Fortune $0
Board [9s 9c 9h Jh 5h]
Seat 1: 24ef55dc (small blind) folded before Flop
Seat 2: e9dfe233 (big blind) folded before Flop
Seat 3: 81635428 folded before Flop (didn't bet)
Seat 4: Hero showed [6d 6h] and won ($2.91) with Nines Full over Sixes
Seat 5: 995db773 showed [Ad Qs] and lost with Three Nines
Seat 6: cae134f0 (button) folded before Flop (didn't bet)


Poker Hand #HD1182864642: Hold'em No Limit  ($0.02/$0.05) - 2023/03/30 20:02:24
Table 'NLHBlue133' 6-max Seat #5 is the button
Seat 1: 24ef55dc ($5 in chips)
Seat 2: e9dfe233 ($1.2 in chips)
Seat 3: 81635428 ($5.49 in chips)
Seat 4: Hero ($5 in chips)
Seat 5: 995db773 ($5.02 in chips)
Seat 6: cae134f0 ($1.6 in chips)
cae134f0: posts small blind $0.02
24ef55dc: posts big blind $0.05
*** HOLE CARDS ***
Dealt to 24ef55dc 
Dealt to e9dfe233 
Dealt to 81635428 
Dealt to Hero [2h 3h]
Dealt to 995db773 
Dealt to cae134f0 
e9dfe233: calls $0.05
81635428: folds
Hero: folds
995db773: raises $0.09 to $0.14
cae134f0: folds
24ef55dc: folds
e9dfe233: calls $0.09
*** FLOP *** [8d 9h 9s]
e9dfe233: checks
995db773: bets $0.12
e9dfe233: calls $0.12
*** TURN *** [8d 9h 9s] [7s]
e9dfe233: checks
995db773: checks
*** RIVER *** [8d 9h 9s 7s] [7h]
e9dfe233: checks
995db773: checks
e9dfe233: shows [Ah Th] (Pair of Nines and Pair of Sevens)
995db773: shows [4d 4s] (Pair of Nines and Pair of Sevens)
*** SHOWDOWN ***
e9dfe233 collected $0.56 from pot
*** SUMMARY ***
Total pot $0.59 | Rake $0.03 | Jackpot $0 | Bingo $0 | Fortune $0
Board [8d 9h 9s 7s 7h]
Seat 1: 24ef55dc (big blind) folded before Flop
Seat 2: e9dfe233 showed [Ah Th] and won ($0.56) with Pair of Nines and Pair of Sevens
Seat 3: 81635428 folded before Flop (didn't bet)
Seat 4: Hero folded before Flop (didn't bet)
Seat 5: 995db773 (button) showed [4d 4s] and lost with Pair of Nines and Pair of Sevens
Seat 6: cae134f0 (small blind) folded before Flop


Poker Hand #HD1182864471: Hold'em No Limit  ($0.02/$0.05) - 2023/03/30 20:01:20
Table 'NLHBlue133' 6-max Seat #4 is the button
Seat 2: e9dfe233 ($1.4 in chips)
Seat 3: 81635428 ($5.05 in chips)
Seat 4: Hero ($5 in chips)
Seat 5: 995db773 ($5.04 in chips)
Seat 6: cae134f0 ($1.65 in chips)
995db773: posts small blind $0.02
cae134f0: posts big blind $0.05
*** HOLE CARDS ***
Dealt to e9dfe233 
Dealt to 81635428 
Dealt to Hero [Kd As]
Dealt to 995db773 
Dealt to cae134f0 
e9dfe233: calls $0.05
81635428: calls $0.05
Hero: raises $0.15 to $0.2
995db773: folds
cae134f0: folds
e9dfe233: calls $0.15
81635428: calls $0.15
*** FLOP *** [2c 4d 9d]
e9dfe233: checks
81635428: checks
Hero: checks
*** TURN *** [2c 4d 9d] [9c]
e9dfe233: checks
81635428: checks
Hero: checks
*** RIVER *** [2c 4d 9d 9c] [Jh]
e9dfe233: checks
81635428: bets $0.23
Hero: folds
e9dfe233: folds
Uncalled bet ($0.23) returned to 81635428
*** SHOWDOWN ***
81635428 collected $0.64 from pot
*** SUMMARY ***
Total pot $0.67 | Rake $0.03 | Jackpot $0 | Bingo $0 | Fortune $0
Board [2c 4d 9d 9c Jh]
Seat 2: e9dfe233 folded on the River
Seat 3: 81635428 won ($0.64)
Seat 4: Hero (button) folded on the River
Seat 5: 995db773 (small blind) folded before Flop
Seat 6: cae134f0 (big blind) folded before Flop


Poker Hand #HD1182864438: Hold'em No Limit  ($0.02/$0.05) - 2023/03/30 20:01:09
Table 'NLHBlue133' 6-max Seat #3 is the button
Seat 2: e9dfe233 ($1.4 in chips)
Seat 3: 81635428 ($5.05 in chips)
Seat 4: Hero ($5 in chips)
Seat 5: 995db773 ($5.09 in chips)
Seat 6: cae134f0 ($1.58 in chips)
Hero: posts small blind $0.02
995db773: posts big blind $0.05
*** HOLE CARDS ***
Dealt to e9dfe233 
Dealt to 81635428 
Dealt to Hero [Js 6c]
Dealt to 995db773 
Dealt to cae134f0 
cae134f0: raises $0.1 to $0.15
e9dfe233: folds
81635428: folds
Hero: folds
995db773: folds
Uncalled bet ($0.1) returned to cae134f0
*** SHOWDOWN ***
cae134f0 collected $0.12 from pot
*** SUMMARY ***
Total pot $0.12 | Rake $0 | Jackpot $0 | Bingo $0 | Fortune $0
Seat 2: e9dfe233 folded before Flop (didn't bet)
Seat 3: 81635428 (button) folded before Flop (didn't bet)
Seat 4: Hero (small blind) folded before Flop
Seat 5: 995db773 (big blind) folded before Flop
Seat 6: cae134f0 collected ($0.12)


Poker Hand #HD1182864336: Hold'em No Limit  ($0.02/$0.05) - 2023/03/30 20:00:33
Table 'NLHBlue133' 6-max Seat #2 is the button
Seat 2: e9dfe233 ($1.4 in chips)
Seat 3: 81635428 ($5.07 in chips)
Seat 4: Hero ($5.1 in chips)
Seat 5: 995db773 ($4.76 in chips)
Seat 6: cae134f0 ($1.58 in chips)
81635428: posts small blind $0.02
Hero: posts big blind $0.05
*** HOLE CARDS ***
Dealt to e9dfe233 
Dealt to 81635428 
Dealt to Hero [Ts 7s]
Dealt to 995db773 
Dealt to cae134f0 
995db773: raises $0.08 to $0.13
cae134f0: folds
e9dfe233: folds
81635428: folds
Hero: calls $0.08
*** FLOP *** [Th 7d 9s]
Hero: bets $0.21
995db773: raises $4.42 to $4.63 and is all-in
Hero: folds
Uncalled bet ($4.42) returned to 995db773
*** SHOWDOWN ***
995db773 collected $0.67 from pot
*** SUMMARY ***
Total pot $0.7 | Rake $0.03 | Jackpot $0 | Bingo $0 | Fortune $0
Board [Th 7d 9s]
Seat 2: e9dfe233 (button) folded before Flop (didn't bet)
Seat 3: 81635428 (small blind) folded before Flop
Seat 4: Hero (big blind) folded on the Flop
Seat 5: 995db773 won ($0.67)
Seat 6: cae134f0 folded before Flop (didn't bet)


Poker Hand #HD1182864181: Hold'em No Limit  ($0.02/$0.05) - 2023/03/30 19:59:38
Table 'NLHBlue133' 6-max Seat #6 is the button
Seat 1: 24ef55dc ($5 in chips)
Seat 2: e9dfe233 ($1.38 in chips)
Seat 3: 81635428 ($5.07 in chips)
Seat 4: Hero ($5.1 in chips)
Seat 5: 995db773 ($4.76 in chips)
Seat 6: cae134f0 ($1.58 in chips)
24ef55dc: posts small blind $0.02
e9dfe233: posts big blind $0.05
*** HOLE CARDS ***
Dealt to 24ef55dc 
Dealt to e9dfe233 
Dealt to 81635428 
Dealt to Hero [8h 4s]
Dealt to 995db773 
Dealt to cae134f0 
81635428: folds
Hero: folds
995db773: folds
cae134f0: folds
24ef55dc: folds
Uncalled bet ($0.03) returned to e9dfe233
*** SHOWDOWN ***
e9dfe233 collected $0.04 from pot
*** SUMMARY ***
Total pot $0.04 | Rake $0 | Jackpot $0 | Bingo $0 | Fortune $0
Seat 1: 24ef55dc (small blind) folded before Flop
Seat 2: e9dfe233 (big blind) collected ($0.04)
Seat 3: 81635428 folded before Flop (didn't bet)
Seat 4: Hero folded before Flop (didn't bet)
Seat 5: 995db773 folded before Flop (didn't bet)
Seat 6: cae134f0 (button) folded before Flop (didn't bet)


Poker Hand #HD1182864115: Hold'em No Limit  ($0.02/$0.05) - 2023/03/30 19:59:12
Table 'NLHBlue133' 6-max Seat #5 is the button
Seat 1: 24ef55dc ($5 in chips)
Seat 2: e9dfe233 ($1.38 in chips)
Seat 3: 81635428 ($5 in chips)
Seat 4: Hero ($5.1 in chips)
Seat 5: 995db773 ($4.76 in chips)
Seat 6: cae134f0 ($1.6 in chips)
cae134f0: posts small blind $0.02
24ef55dc: posts big blind $0.05
*** HOLE CARDS ***
Dealt to 24ef55dc 
Dealt to e9dfe233 
Dealt to 81635428 
Dealt to Hero [2d 9h]
Dealt to 995db773 
Dealt to cae134f0 
e9dfe233: folds
81635428: raises $0.08 to $0.13
Hero: folds
995db773: folds
cae134f0: folds
24ef55dc: folds
Uncalled bet ($0.08) returned to 81635428
*** SHOWDOWN ***
81635428 collected $0.12 from pot
*** SUMMARY ***
Total pot $0.12 | Rake $0 | Jackpot $0 | Bingo $0 | Fortune $0
Seat 1: 24ef55dc (big blind) folded before Flop
Seat 2: e9dfe233 folded before Flop (didn't bet)
Seat 3: 81635428 collected ($0.12)
Seat 4: Hero folded before Flop (didn't bet)
Seat 5: 995db773 (button) folded before Flop (didn't bet)
Seat 6: cae134f0 (small blind) folded before Flop


Poker Hand #HD1182863936: Hold'em No Limit  ($0.02/$0.05) - 2023/03/30 19:58:15
Table 'NLHBlue133' 6-max Seat #4 is the button
Seat 1: 24ef55dc ($5 in chips)
Seat 2: e9dfe233 ($1.22 in chips)
Seat 3: 81635428 ($5 in chips)
Seat 4: Hero ($5.1 in chips)
Seat 5: 995db773 ($4.78 in chips)
Seat 6: cae134f0 ($1.65 in chips)
995db773: posts small blind $0.02
cae134f0: posts big blind $0.05
*** HOLE CARDS ***
Dealt to 24ef55dc 
Dealt to e9dfe233 
Dealt to 81635428 
Dealt to Hero [5h 4c]
Dealt to 995db773 
Dealt to cae134f0 
24ef55dc: raises $0.05 to $0.1
e9dfe233: calls $0.1
81635428: folds
Hero: folds
995db773: folds
cae134f0: folds
*** FLOP *** [8s Jh 3d]
24ef55dc: checks
e9dfe233: checks
*** TURN *** [8s Jh 3d] [5c]
24ef55dc: checks
e9dfe233: checks
*** RIVER *** [8s Jh 3d 5c] [Jc]
24ef55dc: checks
e9dfe233: checks
24ef55dc: shows [9h Ah] (Pair of Jacks)
e9dfe233: shows [Qh Ad] (Pair of Jacks)
*** SHOWDOWN ***
e9dfe233 collected $0.26 from pot
*** SUMMARY ***
Total pot $0.27 | Rake $0.01 | Jackpot $0 | Bingo $0 | Fortune $0
Board [8s Jh 3d 5c Jc]
Seat 1: 24ef55dc showed [9h Ah] and lost with Pair of Jacks
Seat 2: e9dfe233 showed [Qh Ad] and won ($0.26) with Pair of Jacks
Seat 3: 81635428 folded before Flop (didn't bet)
Seat 4: Hero (button) folded before Flop (didn't bet)
Seat 5: 995db773 (small blind) folded before Flop
Seat 6: cae134f0 (big blind) folded before Flop


Poker Hand #HD1182863806: Hold'em No Limit  ($0.02/$0.05) - 2023/03/30 19:57:29
Table 'NLHBlue133' 6-max Seat #3 is the button
Seat 1: 24ef55dc ($5 in chips)
Seat 2: e9dfe233 ($1.22 in chips)
Seat 3: 81635428 ($5 in chips)
Seat 4: Hero ($5 in chips)
Seat 5: 995db773 ($4.83 in chips)
Seat 6: cae134f0 ($1.7 in chips)
Hero: posts small blind $0.02
995db773: posts big blind $0.05
*** HOLE CARDS ***
Dealt to 24ef55dc 
Dealt to e9dfe233 
Dealt to 81635428 
Dealt to Hero [6c 6d]
Dealt to 995db773 
Dealt to cae134f0 
cae134f0: calls $0.05
24ef55dc: folds
e9dfe233: folds
81635428: folds
Hero: calls $0.03
995db773: checks
*** FLOP *** [Kc Qd Qc]
Hero: bets $0.08
995db773: folds
cae134f0: folds
Uncalled bet ($0.08) returned to Hero
*** SHOWDOWN ***
Hero collected $0.15 from pot
*** SUMMARY ***
Total pot $0.15 | Rake $0 | Jackpot $0 | Bingo $0 | Fortune $0
Board [Kc Qd Qc]
Seat 1: 24ef55dc folded before Flop (didn't bet)
Seat 2: e9dfe233 folded before Flop (didn't bet)
Seat 3: 81635428 (button) folded before Flop (didn't bet)
Seat 4: Hero (small blind) won ($0.15)
Seat 5: 995db773 (big blind) folded on the Flop
Seat 6: cae134f0 folded on the Flop


Poker Hand #HD1182863660: Hold'em No Limit  ($0.02/$0.05) - 2023/03/30 19:56:31
Table 'NLHBlue133' 6-max Seat #2 is the button
Seat 1: 24ef55dc ($5 in chips)
Seat 2: e9dfe233 ($1.22 in chips)
Seat 3: 81635428 ($5.02 in chips)
Seat 4: Hero ($5 in chips)
Seat 5: 995db773 ($4.83 in chips)
Seat 6: cae134f0 ($1.54 in chips)
81635428: posts small blind $0.02
Hero: posts big blind $0.05
*** HOLE CARDS ***
Dealt to 24ef55dc 
Dealt to e9dfe233 
Dealt to 81635428 
Dealt to Hero [As 4d]
Dealt to 995db773 
Dealt to cae134f0 
995db773: folds
cae134f0: raises $0.1 to $0.15
24ef55dc: folds
e9dfe233: folds
81635428: folds
Hero: calls $0.1
*** FLOP *** [6d 6h Js]
Hero: checks
cae134f0: checks
*** TURN *** [6d 6h Js] [7s]
Hero: checks
cae134f0: checks
*** RIVER *** [6d 6h Js 7s] [3s]
Hero: checks
cae134f0: checks
Hero: shows [As 4d] (Pair of Sixes)
cae134f0: shows [Ad Kc] (Pair of Sixes)
*** SHOWDOWN ***
cae134f0 collected $0.31 from pot
*** SUMMARY ***
Total pot $0.32 | Rake $0.01 | Jackpot $0 | Bingo $0 | Fortune $0
Board [6d 6h Js 7s 3s]
Seat 1: 24ef55dc folded before Flop (didn't bet)
Seat 2: e9dfe233 (button) folded before Flop (didn't bet)
Seat 3: 81635428 (small blind) folded before Flop
Seat 4: Hero (big blind) showed [As 4d] and lost with Pair of Sixes
Seat 5: 995db773 folded before Flop (didn't bet)
Seat 6: cae134f0 showed [Ad Kc] and won ($0.31) with Pair of Sixes


Poker Hand #HD1182863600: Hold'em No Limit  ($0.02/$0.05) - 2023/03/30 19:56:11
Table 'NLHBlue133' 6-max Seat #1 is the button
Seat 1: 24ef55dc ($5 in chips)
Seat 2: e9dfe233 ($1.24 in chips)
Seat 3: 81635428 ($5 in chips)
Seat 4: Hero ($5 in chips)
Seat 5: 995db773 ($4.83 in chips)
Seat 6: cae134f0 ($1.54 in chips)
e9dfe233: posts small blind $0.02
81635428: posts big blind $0.05
*** HOLE CARDS ***
Dealt to 24ef55dc 
Dealt to e9dfe233 
Dealt to 81635428 
Dealt to Hero [Qd 4h]
Dealt to 995db773 
Dealt to cae134f0 
Hero: folds
995db773: folds
cae134f0: folds
24ef55dc: folds
e9dfe233: folds
Uncalled bet ($0.03) returned to 81635428
*** SHOWDOWN ***
81635428 collected $0.04 from pot
*** SUMMARY ***
Total pot $0.04 | Rake $0 | Jackpot $0 | Bingo $0 | Fortune $0
Seat 1: 24ef55dc (button) folded before Flop (didn't bet)
Seat 2: e9dfe233 (small blind) folded before Flop
Seat 3: 81635428 (big blind) collected ($0.04)
Seat 4: Hero folded before Flop (didn't bet)
Seat 5: 995db773 folded before Flop (didn't bet)
Seat 6: cae134f0 folded before Flop (didn't bet)


Poker Hand #HD1182863506: Hold'em No Limit  ($0.02/$0.05) - 2023/03/30 19:55:33
Table 'NLHBlue133' 6-max Seat #6 is the button
Seat 1: 24ef55dc ($5.02 in chips)
Seat 2: e9dfe233 ($1.13 in chips)
Seat 4: Hero ($5 in chips)
Seat 5: 995db773 ($4.93 in chips)
Seat 6: cae134f0 ($1.54 in chips)
24ef55dc: posts small blind $0.02
e9dfe233: posts big blind $0.05
*** HOLE CARDS ***
Dealt to 24ef55dc 
Dealt to e9dfe233 
Dealt to Hero [5c Qh]
Dealt to 995db773 
Dealt to cae134f0 
Hero: folds
995db773: raises $0.05 to $0.1
cae134f0: folds
24ef55dc: folds
e9dfe233: calls $0.05
*** FLOP *** [4s Jd 4c]
e9dfe233: checks
995db773: checks
*** TURN *** [4s Jd 4c] [Jh]
e9dfe233: bets $0.11
995db773: folds
Uncalled bet ($0.11) returned to e9dfe233
*** SHOWDOWN ***
e9dfe233 collected $0.21 from pot
*** SUMMARY ***
Total pot $0.22 | Rake $0.01 | Jackpot $0 | Bingo $0 | Fortune $0
Board [4s Jd 4c Jh]
Seat 1: 24ef55dc (small blind) folded before Flop
Seat 2: e9dfe233 (big blind) won ($0.21)
Seat 4: Hero folded before Flop (didn't bet)
Seat 5: 995db773 folded on the Turn
Seat 6: cae134f0 (button) folded before Flop (didn't bet)


Poker Hand #HD1182863480: Hold'em No Limit  ($0.02/$0.05) - 2023/03/30 19:55:26
Table 'NLHBlue133' 6-max Seat #5 is the button
Seat 1: 24ef55dc ($5 in chips)
Seat 2: e9dfe233 ($1.13 in chips)
Seat 4: Hero ($5 in chips)
Seat 5: 995db773 ($4.93 in chips)
Seat 6: cae134f0 ($1.56 in chips)
cae134f0: posts small blind $0.02
24ef55dc: posts big blind $0.05
*** HOLE CARDS ***
Dealt to 24ef55dc 
Dealt to e9dfe233 
Dealt to Hero [4d Th]
Dealt to 995db773 
Dealt to cae134f0 
e9dfe233: folds
Hero: folds
995db773: folds
cae134f0: folds
Uncalled bet ($0.03) returned to 24ef55dc
*** SHOWDOWN ***
24ef55dc collected $0.04 from pot
*** SUMMARY ***
Total pot $0.04 | Rake $0 | Jackpot $0 | Bingo $0 | Fortune $0
Seat 1: 24ef55dc (big blind) collected ($0.04)
Seat 2: e9dfe233 folded before Flop (didn't bet)
Seat 4: Hero folded before Flop (didn't bet)
Seat 5: 995db773 (button) folded before Flop (didn't bet)
Seat 6: cae134f0 (small blind) folded before Flop


Poker Hand #HD1182863300: Hold'em No Limit  ($0.02/$0.05) - 2023/03/30 19:54:21
Table 'NLHBlue133' 6-max Seat #4 is the button
Seat 1: 24ef55dc ($5 in chips)
Seat 2: e9dfe233 ($1.17 in chips)
Seat 4: Hero ($5 in chips)
Seat 5: 995db773 ($4.95 in chips)
Seat 6: cae134f0 ($1.61 in chips)
995db773: posts small blind $0.02
cae134f0: posts big blind $0.05
*** HOLE CARDS ***
Dealt to 24ef55dc 
Dealt to e9dfe233 
Dealt to Hero [4s 8s]
Dealt to 995db773 
Dealt to cae134f0 
24ef55dc: raises $0.06 to $0.11
e9dfe233: calls $0.11
Hero: folds
995db773: folds
cae134f0: folds
*** FLOP *** [9d Qs Kd]
24ef55dc: checks
e9dfe233: bets $0.15
24ef55dc: raises $2.61 to $2.76
e9dfe233: calls $0.91 and is all-in
Uncalled bet ($1.7) returned to 24ef55dc
24ef55dc: shows [Ah Ks] (Pair of Kings)
e9dfe233: shows [Kh Ad] (Pair of Kings)
*** TURN *** [9d Qs Kd] [Qd]
*** RIVER *** [9d Qs Kd Qd] [5c]
*** SHOWDOWN ***
24ef55dc collected $1.13 from pot
e9dfe233 collected $1.13 from pot
*** SUMMARY ***
Total pot $2.41 | Rake $0.1 | Jackpot $0.05 | Bingo $0 | Fortune $0
Board [9d Qs Kd Qd 5c]
Seat 1: 24ef55dc showed [Ah Ks] and won ($1.13) with Pair of Kings and Pair of Queens
Seat 2: e9dfe233 showed [Kh Ad] and won ($1.13) with Pair of Kings and Pair of Queens
Seat 4: Hero (button) folded before Flop (didn't bet)
Seat 5: 995db773 (small blind) folded before Flop
Seat 6: cae134f0 (big blind) folded before Flop


Poker Hand #HD1182863197: Hold'em No Limit  ($0.02/$0.05) - 2023/03/30 19:53:39
Table 'NLHBlue133' 6-max Seat #2 is the button
Seat 1: 24ef55dc ($5 in chips)
Seat 2: e9dfe233 ($1.17 in chips)
Seat 4: Hero ($5 in chips)
Seat 5: 995db773 ($5.09 in chips)
Seat 6: cae134f0 ($1.46 in chips)
Hero: posts small blind $0.02
995db773: posts big blind $0.05
*** HOLE CARDS ***
Dealt to 24ef55dc 
Dealt to e9dfe233 
Dealt to Hero [8d 6h]
Dealt to 995db773 
Dealt to cae134f0 
cae134f0: calls $0.05
24ef55dc: folds
e9dfe233: folds
Hero: folds
995db773: checks
*** FLOP *** [4s 5c 8c]
995db773: checks
cae134f0: checks
*** TURN *** [4s 5c 8c] [9d]
995db773: checks
cae134f0: checks
*** RIVER *** [4s 5c 8c 9d] [8h]
995db773: bets $0.09
cae134f0: raises $1.32 to $1.41 and is all-in
995db773: folds
Uncalled bet ($1.32) returned to cae134f0
*** SHOWDOWN ***
cae134f0 collected $0.29 from pot
*** SUMMARY ***
Total pot $0.3 | Rake $0.01 | Jackpot $0 | Bingo $0 | Fortune $0
Board [4s 5c 8c 9d 8h]
Seat 1: 24ef55dc folded before Flop (didn't bet)
Seat 2: e9dfe233 (button) folded before Flop (didn't bet)
Seat 4: Hero (small blind) folded before Flop
Seat 5: 995db773 (big blind) folded on the River
Seat 6: cae134f0 won ($0.29)


Poker Hand #HD1182863057: Hold'em No Limit  ($0.02/$0.05) - 2023/03/30 19:52:48
Table 'NLHBlue133' 6-max Seat #1 is the button
Seat 1: 24ef55dc ($5 in chips)
Seat 2: e9dfe233 ($1.19 in chips)
Seat 4: Hero ($5 in chips)
Seat 5: 995db773 ($5.09 in chips)
Seat 6: cae134f0 ($1.39 in chips)
e9dfe233: posts small blind $0.02
Hero: posts big blind $0.05
*** HOLE CARDS ***
Dealt to 24ef55dc 
Dealt to e9dfe233 
Dealt to Hero [8d Qs]
Dealt to 995db773 
Dealt to cae134f0 
995db773: folds
cae134f0: calls $0.05
24ef55dc: folds
e9dfe233: folds
Hero: checks
*** FLOP *** [Jd 9s 7d]
Hero: checks
cae134f0: checks
*** TURN *** [Jd 9s 7d] [4d]
Hero: checks
cae134f0: checks
*** RIVER *** [Jd 9s 7d 4d] [Ah]
Hero: checks
cae134f0: checks
Hero: shows [8d Qs] (Ace-High)
cae134f0: shows [2s 2d] (Pair of Twos)
*** SHOWDOWN ***
cae134f0 collected $0.12 from pot
*** SUMMARY ***
Total pot $0.12 | Rake $0 | Jackpot $0 | Bingo $0 | Fortune $0
Board [Jd 9s 7d 4d Ah]
Seat 1: 24ef55dc (button) folded before Flop (didn't bet)
Seat 2: e9dfe233 (small blind) folded before Flop
Seat 4: Hero (big blind) showed [8d Qs] and lost with Ace-High
Seat 5: 995db773 folded before Flop (didn't bet)
Seat 6: cae134f0 showed [2s 2d] and won ($0.12) with Pair of Twos


Poker Hand #HD1182862929: Hold'em No Limit  ($0.02/$0.05) - 2023/03/30 19:51:59
Table 'NLHBlue133' 6-max Seat #6 is the button
Seat 1: 24ef55dc ($5 in chips)
Seat 2: e9dfe233 ($1.24 in chips)
Seat 3: 52e848da ($11.13 in chips)
Seat 4: Hero ($5 in chips)
Seat 5: 995db773 ($5.09 in chips)
Seat 6: cae134f0 ($1.32 in chips)
24ef55dc: posts small blind $0.02
e9dfe233: posts big blind $0.05
*** HOLE CARDS ***
Dealt to 24ef55dc 
Dealt to e9dfe233 
Dealt to 52e848da 
Dealt to Hero [Qc 8h]
Dealt to 995db773 
Dealt to cae134f0 
52e848da: folds
Hero: folds
995db773: folds
cae134f0: calls $0.05
24ef55dc: folds
e9dfe233: checks
*** FLOP *** [Qs 2c Js]
e9dfe233: checks
cae134f0: bets $0.06
e9dfe233: folds
Uncalled bet ($0.06) returned to cae134f0
*** SHOWDOWN ***
cae134f0 collected $0.12 from pot
*** SUMMARY ***
Total pot $0.12 | Rake $0 | Jackpot $0 | Bingo $0 | Fortune $0
Board [Qs 2c Js]
Seat 1: 24ef55dc (small blind) folded before Flop
Seat 2: e9dfe233 (big blind) folded on the Flop
Seat 3: 52e848da folded before Flop (didn't bet)
Seat 4: Hero folded before Flop (didn't bet)
Seat 5: 995db773 folded before Flop (didn't bet)
Seat 6: cae134f0 (button) won ($0.12)


Poker Hand #HD1182862832: Hold'em No Limit  ($0.02/$0.05) - 2023/03/30 19:51:21
Table 'NLHBlue133' 6-max Seat #5 is the button
Seat 1: 24ef55dc ($5 in chips)
Seat 2: e9dfe233 ($1.17 in chips)
Seat 3: 52e848da ($11.13 in chips)
Seat 4: Hero ($5 in chips)
Seat 5: 995db773 ($5.09 in chips)
Seat 6: cae134f0 ($1.34 in chips)
cae134f0: posts small blind $0.02
24ef55dc: posts big blind $0.05
*** HOLE CARDS ***
Dealt to 24ef55dc 
Dealt to e9dfe233 
Dealt to 52e848da 
Dealt to Hero [6d 9h]
Dealt to 995db773 
Dealt to cae134f0 
e9dfe233: calls $0.05
52e848da: folds
Hero: folds
995db773: folds
cae134f0: folds
24ef55dc: checks
*** FLOP *** [Jh 5c 3c]
24ef55dc: checks
e9dfe233: checks
*** TURN *** [Jh 5c 3c] [As]
24ef55dc: checks
e9dfe233: bets $0.12
24ef55dc: folds
Uncalled bet ($0.12) returned to e9dfe233
*** SHOWDOWN ***
e9dfe233 collected $0.12 from pot
*** SUMMARY ***
Total pot $0.12 | Rake $0 | Jackpot $0 | Bingo $0 | Fortune $0
Board [Jh 5c 3c As]
Seat 1: 24ef55dc (big blind) folded on the Turn
Seat 2: e9dfe233 won ($0.12)
Seat 3: 52e848da folded before Flop (didn't bet)
Seat 4: Hero folded before Flop (didn't bet)
Seat 5: 995db773 (button) folded before Flop (didn't bet)
Seat 6: cae134f0 (small blind) folded before Flop


Poker Hand #HD1182862717: Hold'em No Limit  ($0.02/$0.05) - 2023/03/30 19:50:34
Table 'NLHBlue133' 6-max Seat #4 is the button
Seat 1: 24ef55dc ($5 in chips)
Seat 2: e9dfe233 ($1.27 in chips)
Seat 3: 52e848da ($11.13 in chips)
Seat 4: Hero ($5 in chips)
Seat 5: 995db773 ($4.95 in chips)
Seat 6: cae134f0 ($1.39 in chips)
995db773: posts small blind $0.02
cae134f0: posts big blind $0.05
*** HOLE CARDS ***
Dealt to 24ef55dc 
Dealt to e9dfe233 
Dealt to 52e848da 
Dealt to Hero [5s 9h]
Dealt to 995db773 
Dealt to cae134f0 
24ef55dc: folds
e9dfe233: calls $0.05
52e848da: folds
Hero: folds
995db773: raises $0.05 to $0.1
cae134f0: folds
e9dfe233: calls $0.05
*** FLOP *** [7s 5d Jd]
995db773: bets $0.09
e9dfe233: folds
Uncalled bet ($0.09) returned to 995db773
*** SHOWDOWN ***
995db773 collected $0.24 from pot
*** SUMMARY ***
Total pot $0.25 | Rake $0.01 | Jackpot $0 | Bingo $0 | Fortune $0
Board [7s 5d Jd]
Seat 1: 24ef55dc folded before Flop (didn't bet)
Seat 2: e9dfe233 folded on the Flop
Seat 3: 52e848da folded before Flop (didn't bet)
Seat 4: Hero (button) folded before Flop (didn't bet)
Seat 5: 995db773 (small blind) won ($0.24)
Seat 6: cae134f0 (big blind) folded before Flop


Poker Hand #HD1182862539: Hold'em No Limit  ($0.02/$0.05) - 2023/03/30 19:49:29
Table 'NLHBlue133' 6-max Seat #3 is the button
Seat 1: 24ef55dc ($5 in chips)
Seat 2: e9dfe233 ($0.95 in chips)
Seat 3: 52e848da ($11.13 in chips)
Seat 4: Hero ($5 in chips)
Seat 5: 995db773 ($5 in chips)
Seat 6: cae134f0 ($1.67 in chips)
Hero: posts small blind $0.02
995db773: posts big blind $0.05
*** HOLE CARDS ***
Dealt to 24ef55dc 
Dealt to e9dfe233 
Dealt to 52e848da 
Dealt to Hero [3s 7s]
Dealt to 995db773 
Dealt to cae134f0 
cae134f0: raises $0.1 to $0.15
24ef55dc: folds
e9dfe233: calls $0.15
52e848da: folds
Hero: folds
995db773: folds
*** FLOP *** [6d 2s 6s]
cae134f0: bets $0.13
e9dfe233: calls $0.13
*** TURN *** [6d 2s 6s] [Th]
cae134f0: checks
e9dfe233: checks
*** RIVER *** [6d 2s 6s Th] [Qs]
cae134f0: checks
e9dfe233: checks
cae134f0: shows [Ah Kc] (Pair of Sixes)
e9dfe233: shows [4s 4d] (Pair of Sixes and Pair of Fours)
*** SHOWDOWN ***
e9dfe233 collected $0.6 from pot
*** SUMMARY ***
Total pot $0.63 | Rake $0.03 | Jackpot $0 | Bingo $0 | Fortune $0
Board [6d 2s 6s Th Qs]
Seat 1: 24ef55dc folded before Flop (didn't bet)
Seat 2: e9dfe233 showed [4s 4d] and won ($0.6) with Pair of Sixes and Pair of Fours
Seat 3: 52e848da (button) folded before Flop (didn't bet)
Seat 4: Hero (small blind) folded before Flop
Seat 5: 995db773 (big blind) folded before Flop
Seat 6: cae134f0 showed [Ah Kc] and lost with Pair of Sixes


Poker Hand #HD1182862493: Hold'em No Limit  ($0.02/$0.05) - 2023/03/30 19:49:08
Table 'NLHBlue133' 6-max Seat #2 is the button
Seat 1: 24ef55dc ($5 in chips)
Seat 2: e9dfe233 ($0.95 in chips)
Seat 3: 52e848da ($11.08 in chips)
Seat 4: Hero ($5 in chips)
Seat 6: cae134f0 ($1.67 in chips)
52e848da: posts small blind $0.02
Hero: posts big blind $0.05
*** HOLE CARDS ***
Dealt to 24ef55dc 
Dealt to e9dfe233 
Dealt to 52e848da 
Dealt to Hero [3c Qh]
Dealt to cae134f0 
cae134f0: folds
24ef55dc: folds
e9dfe233: folds
52e848da: raises $0.1 to $0.15
Hero: folds
Uncalled bet ($0.1) returned to 52e848da
*** SHOWDOWN ***
52e848da collected $0.1 from pot
*** SUMMARY ***
Total pot $0.1 | Rake $0 | Jackpot $0 | Bingo $0 | Fortune $0
Seat 1: 24ef55dc folded before Flop (didn't bet)
Seat 2: e9dfe233 (button) folded before Flop (didn't bet)
Seat 3: 52e848da (small blind) collected ($0.1)
Seat 4: Hero (big blind) folded before Flop
Seat 6: cae134f0 folded before Flop (didn't bet)


