Poker Hand #HD1163153292: Hold'em No Limit  ($0.02/$0.05) - 2023/03/16 20:09:18
Table 'NLHBlue100' 6-max Seat #1 is the button
Seat 1: c0464749 ($4.56 in chips)
Seat 4: c918aaad ($7.02 in chips)
Seat 5: d2077923 ($5 in chips)
Seat 6: Hero ($5.07 in chips)
c918aaad: posts small blind $0.02
d2077923: posts big blind $0.05
*** HOLE CARDS ***
Dealt to c0464749 
Dealt to c918aaad 
Dealt to d2077923 
Dealt to Hero [Jh Js]
Hero: raises $0.07 to $0.12
c0464749: folds
c918aaad: folds
d2077923: folds
Uncalled bet ($0.07) returned to Hero
*** SHOWDOWN ***
Hero collected $0.12 from pot
*** SUMMARY ***
Total pot $0.12 | Rake $0 | Jackpot $0 | Bingo $0 | Fortune $0
Seat 1: c0464749 (button) folded before Flop (didn't bet)
Seat 4: c918aaad (small blind) folded before Flop
Seat 5: d2077923 (big blind) folded before Flop
Seat 6: Hero collected ($0.12)


Poker Hand #HD1163153265: Hold'em No Limit  ($0.02/$0.05) - 2023/03/16 20:09:08
Table 'NLHBlue100' 6-max Seat #6 is the button
Seat 1: c0464749 ($4.58 in chips)
Seat 4: c918aaad ($7.07 in chips)
Seat 5: d2077923 ($5 in chips)
Seat 6: Hero ($5 in chips)
c0464749: posts small blind $0.02
c918aaad: posts big blind $0.05
*** HOLE CARDS ***
Dealt to c0464749 
Dealt to c918aaad 
Dealt to d2077923 
Dealt to Hero [Jd 9s]
d2077923: folds
Hero: raises $0.07 to $0.12
c0464749: folds
c918aaad: folds
Uncalled bet ($0.07) returned to Hero
*** SHOWDOWN ***
Hero collected $0.12 from pot
*** SUMMARY ***
Total pot $0.12 | Rake $0 | Jackpot $0 | Bingo $0 | Fortune $0
Seat 1: c0464749 (small blind) folded before Flop
Seat 4: c918aaad (big blind) folded before Flop
Seat 5: d2077923 folded before Flop (didn't bet)
Seat 6: Hero (button) collected ($0.12)


Poker Hand #HD1163153171: Hold'em No Limit  ($0.02/$0.05) - 2023/03/16 20:08:31
Table 'NLHBlue100' 6-max Seat #5 is the button
Seat 1: c0464749 ($3.87 in chips)
Seat 3: 26d039ab ($30.34 in chips)
Seat 4: c918aaad ($7.22 in chips)
Seat 5: d2077923 ($5 in chips)
Seat 6: Hero ($5.43 in chips)
Hero: posts small blind $0.02
c0464749: posts big blind $0.05
*** HOLE CARDS ***
Dealt to c0464749 
Dealt to 26d039ab 
Dealt to c918aaad 
Dealt to d2077923 
Dealt to Hero [Ah 4h]
26d039ab: folds
c918aaad: raises $0.1 to $0.15
d2077923: folds
Hero: raises $0.53 to $0.68
c0464749: raises $0.62 to $1.3
c918aaad: folds
Hero: folds
Uncalled bet ($0.62) returned to c0464749
*** SHOWDOWN ***
c0464749 collected $1.39 from pot
*** SUMMARY ***
Total pot $1.51 | Rake $0.07 | Jackpot $0.05 | Bingo $0 | Fortune $0
Seat 1: c0464749 (big blind) collected ($1.39)
Seat 3: 26d039ab folded before Flop (didn't bet)
Seat 4: c918aaad folded before Flop
Seat 5: d2077923 (button) folded before Flop (didn't bet)
Seat 6: Hero (small blind) folded before Flop


Poker Hand #HD1163153119: Hold'em No Limit  ($0.02/$0.05) - 2023/03/16 20:08:14
Table 'NLHBlue100' 6-max Seat #4 is the button
Seat 1: c0464749 ($3.87 in chips)
Seat 3: 26d039ab ($30.34 in chips)
Seat 4: c918aaad ($7.15 in chips)
Seat 5: d2077923 ($5 in chips)
Seat 6: Hero ($5.48 in chips)
d2077923: posts small blind $0.02
Hero: posts big blind $0.05
*** HOLE CARDS ***
Dealt to c0464749 
Dealt to 26d039ab 
Dealt to c918aaad 
Dealt to d2077923 
Dealt to Hero [7h 2s]
c0464749: folds
26d039ab: folds
c918aaad: raises $0.1 to $0.15
d2077923: folds
Hero: folds
Uncalled bet ($0.1) returned to c918aaad
*** SHOWDOWN ***
c918aaad collected $0.12 from pot
*** SUMMARY ***
Total pot $0.12 | Rake $0 | Jackpot $0 | Bingo $0 | Fortune $0
Seat 1: c0464749 folded before Flop (didn't bet)
Seat 3: 26d039ab folded before Flop (didn't bet)
Seat 4: c918aaad (button) collected ($0.12)
Seat 5: d2077923 (small blind) folded before Flop
Seat 6: Hero (big blind) folded before Flop


Poker Hand #HD1163153008: Hold'em No Limit  ($0.02/$0.05) - 2023/03/16 20:07:38
Table 'NLHBlue100' 6-max Seat #3 is the button
Seat 1: c0464749 ($3.87 in chips)
Seat 3: 26d039ab ($30.34 in chips)
Seat 4: c918aaad ($6.7 in chips)
Seat 5: d2077923 ($5.14 in chips)
Seat 6: Hero ($5.48 in chips)
c918aaad: posts small blind $0.02
d2077923: posts big blind $0.05
*** HOLE CARDS ***
Dealt to c0464749 
Dealt to 26d039ab 
Dealt to c918aaad 
Dealt to d2077923 
Dealt to Hero [8s Qc]
Hero: folds
c0464749: folds
26d039ab: folds
c918aaad: raises $0.1 to $0.15
d2077923: raises $0.35 to $0.5
c918aaad: calls $0.35
*** FLOP *** [3h 3d Tc]
c918aaad: checks
d2077923: checks
*** TURN *** [3h 3d Tc] [2s]
c918aaad: bets $0.5
d2077923: folds
Uncalled bet ($0.5) returned to c918aaad
*** SHOWDOWN ***
c918aaad collected $0.95 from pot
*** SUMMARY ***
Total pot $1 | Rake $0.05 | Jackpot $0 | Bingo $0 | Fortune $0
Board [3h 3d Tc 2s]
Seat 1: c0464749 folded before Flop (didn't bet)
Seat 3: 26d039ab (button) folded before Flop (didn't bet)
Seat 4: c918aaad (small blind) won ($0.95)
Seat 5: d2077923 (big blind) folded on the Turn
Seat 6: Hero folded before Flop (didn't bet)


Poker Hand #HD1163152956: Hold'em No Limit  ($0.02/$0.05) - 2023/03/16 20:07:13
Table 'NLHBlue100' 6-max Seat #1 is the button
Seat 1: c0464749 ($3.71 in chips)
Seat 3: 26d039ab ($30.46 in chips)
Seat 4: c918aaad ($6.75 in chips)
Seat 5: d2077923 ($5.14 in chips)
Seat 6: Hero ($5.48 in chips)
26d039ab: posts small blind $0.02
c918aaad: posts big blind $0.05
*** HOLE CARDS ***
Dealt to c0464749 
Dealt to 26d039ab 
Dealt to c918aaad 
Dealt to d2077923 
Dealt to Hero [4s 7s]
d2077923: folds
Hero: folds
c0464749: raises $0.07 to $0.12
26d039ab: calls $0.1
c918aaad: folds
*** FLOP *** [2d Ad 6h]
26d039ab: checks
c0464749: bets $0.44
26d039ab: folds
Uncalled bet ($0.44) returned to c0464749
*** SHOWDOWN ***
c0464749 collected $0.28 from pot
*** SUMMARY ***
Total pot $0.29 | Rake $0.01 | Jackpot $0 | Bingo $0 | Fortune $0
Board [2d Ad 6h]
Seat 1: c0464749 (button) won ($0.28)
Seat 3: 26d039ab (small blind) folded on the Flop
Seat 4: c918aaad (big blind) folded before Flop
Seat 5: d2077923 folded before Flop (didn't bet)
Seat 6: Hero folded before Flop (didn't bet)


Poker Hand #HD1163152900: Hold'em No Limit  ($0.02/$0.05) - 2023/03/16 20:06:57
Table 'NLHBlue100' 6-max Seat #6 is the button
Seat 1: c0464749 ($3.73 in chips)
Seat 3: 26d039ab ($30.51 in chips)
Seat 4: c918aaad ($6.68 in chips)
Seat 5: d2077923 ($5.14 in chips)
Seat 6: Hero ($5.48 in chips)
c0464749: posts small blind $0.02
26d039ab: posts big blind $0.05
*** HOLE CARDS ***
Dealt to c0464749 
Dealt to 26d039ab 
Dealt to c918aaad 
Dealt to d2077923 
Dealt to Hero [4s Js]
c918aaad: raises $0.15 to $0.2
d2077923: folds
Hero: folds
c0464749: folds
26d039ab: folds
Uncalled bet ($0.15) returned to c918aaad
*** SHOWDOWN ***
c918aaad collected $0.12 from pot
*** SUMMARY ***
Total pot $0.12 | Rake $0 | Jackpot $0 | Bingo $0 | Fortune $0
Seat 1: c0464749 (small blind) folded before Flop
Seat 3: 26d039ab (big blind) folded before Flop
Seat 4: c918aaad collected ($0.12)
Seat 5: d2077923 folded before Flop (didn't bet)
Seat 6: Hero (button) folded before Flop (didn't bet)


Poker Hand #HD1163152828: Hold'em No Limit  ($0.02/$0.05) - 2023/03/16 20:06:28
Table 'NLHBlue100' 6-max Seat #5 is the button
Seat 1: c0464749 ($3.86 in chips)
Seat 3: 26d039ab ($30.51 in chips)
Seat 4: c918aaad ($6.68 in chips)
Seat 5: d2077923 ($5 in chips)
Seat 6: Hero ($5.5 in chips)
Hero: posts small blind $0.02
c0464749: posts big blind $0.05
*** HOLE CARDS ***
Dealt to c0464749 
Dealt to 26d039ab 
Dealt to c918aaad 
Dealt to d2077923 
Dealt to Hero [6s 8d]
26d039ab: folds
c918aaad: folds
d2077923: raises $0.08 to $0.13
Hero: folds
c0464749: calls $0.08
*** FLOP *** [Th Ah 4h]
c0464749: checks
d2077923: bets $0.21
c0464749: folds
Uncalled bet ($0.21) returned to d2077923
*** SHOWDOWN ***
d2077923 collected $0.27 from pot
*** SUMMARY ***
Total pot $0.28 | Rake $0.01 | Jackpot $0 | Bingo $0 | Fortune $0
Board [Th Ah 4h]
Seat 1: c0464749 (big blind) folded on the Flop
Seat 3: 26d039ab folded before Flop (didn't bet)
Seat 4: c918aaad folded before Flop (didn't bet)
Seat 5: d2077923 (button) won ($0.27)
Seat 6: Hero (small blind) folded before Flop


Poker Hand #HD1163152189: Hold'em No Limit  ($0.02/$0.05) - 2023/03/16 20:02:47
Table 'NLHBlue100' 6-max Seat #4 is the button
Seat 1: c0464749 ($2.5 in chips)
Seat 2: 2690b536 ($5.22 in chips)
Seat 3: 26d039ab ($30.51 in chips)
Seat 4: c918aaad ($6.68 in chips)
Seat 5: d2077923 ($5.02 in chips)
Seat 6: Hero ($5.6 in chips)
d2077923: posts small blind $0.02
Hero: posts big blind $0.05
*** HOLE CARDS ***
Dealt to c0464749 
Dealt to 2690b536 
Dealt to 26d039ab 
Dealt to c918aaad 
Dealt to d2077923 
Dealt to Hero [4c As]
c0464749: raises $0.05 to $0.1
2690b536: calls $0.1
26d039ab: folds
c918aaad: folds
d2077923: folds
Hero: calls $0.05
*** FLOP *** [3s 6h 7c]
Hero: checks
c0464749: bets $0.23
2690b536: raises $0.59 to $0.82
Hero: folds
c0464749: calls $0.59
*** TURN *** [3s 6h 7c] [Kh]
c0464749: bets $0.51
2690b536: calls $0.51
*** RIVER *** [3s 6h 7c Kh] [8d]
c0464749: bets $1.07 and is all-in
2690b536: folds
Uncalled bet ($1.07) returned to c0464749
*** SHOWDOWN ***
c0464749 collected $2.79 from pot
*** SUMMARY ***
Total pot $2.98 | Rake $0.14 | Jackpot $0.05 | Bingo $0 | Fortune $0
Board [3s 6h 7c Kh 8d]
Seat 1: c0464749 won ($2.79)
Seat 2: 2690b536 folded on the River
Seat 3: 26d039ab folded before Flop (didn't bet)
Seat 4: c918aaad (button) folded before Flop (didn't bet)
Seat 5: d2077923 (small blind) folded before Flop
Seat 6: Hero (big blind) folded on the Flop


Poker Hand #HD1163152099: Hold'em No Limit  ($0.02/$0.05) - 2023/03/16 20:02:15
Table 'NLHBlue100' 6-max Seat #3 is the button
Seat 1: c0464749 ($2.5 in chips)
Seat 2: 2690b536 ($5.22 in chips)
Seat 3: 26d039ab ($30.51 in chips)
Seat 4: c918aaad ($6.7 in chips)
Seat 5: d2077923 ($5.07 in chips)
Seat 6: Hero ($5.53 in chips)
c918aaad: posts small blind $0.02
d2077923: posts big blind $0.05
*** HOLE CARDS ***
Dealt to c0464749 
Dealt to 2690b536 
Dealt to 26d039ab 
Dealt to c918aaad 
Dealt to d2077923 
Dealt to Hero [2s 2d]
Hero: raises $0.07 to $0.12
c0464749: folds
2690b536: folds
26d039ab: folds
c918aaad: folds
d2077923: folds
Uncalled bet ($0.07) returned to Hero
*** SHOWDOWN ***
Hero collected $0.12 from pot
*** SUMMARY ***
Total pot $0.12 | Rake $0 | Jackpot $0 | Bingo $0 | Fortune $0
Seat 1: c0464749 folded before Flop (didn't bet)
Seat 2: 2690b536 folded before Flop (didn't bet)
Seat 3: 26d039ab (button) folded before Flop (didn't bet)
Seat 4: c918aaad (small blind) folded before Flop
Seat 5: d2077923 (big blind) folded before Flop
Seat 6: Hero collected ($0.12)


Poker Hand #HD1163152042: Hold'em No Limit  ($0.02/$0.05) - 2023/03/16 20:01:57
Table 'NLHBlue100' 6-max Seat #2 is the button
Seat 1: c0464749 ($2.5 in chips)
Seat 2: 2690b536 ($5.22 in chips)
Seat 3: 26d039ab ($30.53 in chips)
Seat 4: c918aaad ($6.75 in chips)
Seat 5: d2077923 ($5.07 in chips)
Seat 6: Hero ($5.46 in chips)
26d039ab: posts small blind $0.02
c918aaad: posts big blind $0.05
*** HOLE CARDS ***
Dealt to c0464749 
Dealt to 2690b536 
Dealt to 26d039ab 
Dealt to c918aaad 
Dealt to d2077923 
Dealt to Hero [2d 2c]
d2077923: folds
Hero: raises $0.07 to $0.12
c0464749: folds
2690b536: folds
26d039ab: folds
c918aaad: folds
Uncalled bet ($0.07) returned to Hero
*** SHOWDOWN ***
Hero collected $0.12 from pot
*** SUMMARY ***
Total pot $0.12 | Rake $0 | Jackpot $0 | Bingo $0 | Fortune $0
Seat 1: c0464749 folded before Flop (didn't bet)
Seat 2: 2690b536 (button) folded before Flop (didn't bet)
Seat 3: 26d039ab (small blind) folded before Flop
Seat 4: c918aaad (big blind) folded before Flop
Seat 5: d2077923 folded before Flop (didn't bet)
Seat 6: Hero collected ($0.12)


Poker Hand #HD1163151900: Hold'em No Limit  ($0.02/$0.05) - 2023/03/16 20:01:10
Table 'NLHBlue100' 6-max Seat #1 is the button
Seat 1: c0464749 ($2.5 in chips)
Seat 2: 2690b536 ($5.24 in chips)
Seat 3: 26d039ab ($30.58 in chips)
Seat 4: c918aaad ($6.07 in chips)
Seat 5: d2077923 ($5.07 in chips)
Seat 6: Hero ($5.46 in chips)
2690b536: posts small blind $0.02
26d039ab: posts big blind $0.05
*** HOLE CARDS ***
Dealt to c0464749 
Dealt to 2690b536 
Dealt to 26d039ab 
Dealt to c918aaad 
Dealt to d2077923 
Dealt to Hero [9d Jc]
c918aaad: calls $0.05
d2077923: folds
Hero: folds
c0464749: raises $0.2 to $0.25
2690b536: folds
26d039ab: folds
c918aaad: calls $0.2
*** FLOP *** [Jd 9c 4d]
c918aaad: checks
c0464749: checks
*** TURN *** [Jd 9c 4d] [8d]
c918aaad: checks
c0464749: checks
*** RIVER *** [Jd 9c 4d 8d] [3d]
c918aaad: bets $0.43
c0464749: calls $0.43
c918aaad: shows [Ad 2d] (Ace High Flush)
c0464749: shows [Ah Qd] (Queen High Flush)
*** SHOWDOWN ***
c918aaad collected $1.36 from pot
*** SUMMARY ***
Total pot $1.43 | Rake $0.07 | Jackpot $0 | Bingo $0 | Fortune $0
Board [Jd 9c 4d 8d 3d]
Seat 1: c0464749 (button) showed [Ah Qd] and lost with Queen High Flush
Seat 2: 2690b536 (small blind) folded before Flop
Seat 3: 26d039ab (big blind) folded before Flop
Seat 4: c918aaad showed [Ad 2d] and won ($1.36) with Ace High Flush
Seat 5: d2077923 folded before Flop (didn't bet)
Seat 6: Hero folded before Flop (didn't bet)


Poker Hand #HD1163151769: Hold'em No Limit  ($0.02/$0.05) - 2023/03/16 20:00:23
Table 'NLHBlue100' 6-max Seat #6 is the button
Seat 1: c0464749 ($2.5 in chips)
Seat 2: 2690b536 ($5.29 in chips)
Seat 4: c918aaad ($6.5 in chips)
Seat 5: d2077923 ($5.07 in chips)
Seat 6: Hero ($5 in chips)
c0464749: posts small blind $0.02
2690b536: posts big blind $0.05
*** HOLE CARDS ***
Dealt to c0464749 
Dealt to 2690b536 
Dealt to c918aaad 
Dealt to d2077923 
Dealt to Hero [Tc Ts]
c918aaad: raises $0.1 to $0.15
d2077923: folds
Hero: raises $0.28 to $0.43
c0464749: folds
2690b536: folds
c918aaad: calls $0.28
*** FLOP *** [As 8s 3h]
c918aaad: checks
Hero: bets $0.47
c918aaad: folds
Uncalled bet ($0.47) returned to Hero
*** SHOWDOWN ***
Hero collected $0.89 from pot
*** SUMMARY ***
Total pot $0.93 | Rake $0.04 | Jackpot $0 | Bingo $0 | Fortune $0
Board [As 8s 3h]
Seat 1: c0464749 (small blind) folded before Flop
Seat 2: 2690b536 (big blind) folded before Flop
Seat 4: c918aaad folded on the Flop
Seat 5: d2077923 folded before Flop (didn't bet)
Seat 6: Hero (button) won ($0.89)


Poker Hand #HD1163151705: Hold'em No Limit  ($0.02/$0.05) - 2023/03/16 20:00:00
Table 'NLHBlue100' 6-max Seat #5 is the button
Seat 1: c0464749 ($2.5 in chips)
Seat 2: 2690b536 ($5.29 in chips)
Seat 4: c918aaad ($6.43 in chips)
Seat 5: d2077923 ($5.07 in chips)
Seat 6: Hero ($5 in chips)
Hero: posts small blind $0.02
c0464749: posts big blind $0.05
*** HOLE CARDS ***
Dealt to c0464749 
Dealt to 2690b536 
Dealt to c918aaad 
Dealt to d2077923 
Dealt to Hero [Kd 9c]
2690b536: folds
c918aaad: raises $0.1 to $0.15
d2077923: folds
Hero: folds
c0464749: folds
Uncalled bet ($0.1) returned to c918aaad
*** SHOWDOWN ***
c918aaad collected $0.12 from pot
*** SUMMARY ***
Total pot $0.12 | Rake $0 | Jackpot $0 | Bingo $0 | Fortune $0
Seat 1: c0464749 (big blind) folded before Flop
Seat 2: 2690b536 folded before Flop (didn't bet)
Seat 4: c918aaad collected ($0.12)
Seat 5: d2077923 (button) folded before Flop (didn't bet)
Seat 6: Hero (small blind) folded before Flop


Poker Hand #HD1163151618: Hold'em No Limit  ($0.02/$0.05) - 2023/03/16 19:59:31
Table 'NLHBlue100' 6-max Seat #4 is the button
Seat 1: c0464749 ($2.5 in chips)
Seat 2: 2690b536 ($5.29 in chips)
Seat 4: c918aaad ($6.27 in chips)
Seat 5: d2077923 ($5.09 in chips)
Seat 6: Hero ($5 in chips)
d2077923: posts small blind $0.02
Hero: posts big blind $0.05
*** HOLE CARDS ***
Dealt to c0464749 
Dealt to 2690b536 
Dealt to c918aaad 
Dealt to d2077923 
Dealt to Hero [Qd Th]
c0464749: folds
2690b536: folds
c918aaad: raises $0.1 to $0.15
d2077923: folds
Hero: calls $0.1
*** FLOP *** [Kh 7d 8c]
Hero: checks
c918aaad: checks
*** TURN *** [Kh 7d 8c] [8s]
Hero: checks
c918aaad: bets $0.24
Hero: folds
Uncalled bet ($0.24) returned to c918aaad
*** SHOWDOWN ***
c918aaad collected $0.31 from pot
*** SUMMARY ***
Total pot $0.32 | Rake $0.01 | Jackpot $0 | Bingo $0 | Fortune $0
Board [Kh 7d 8c 8s]
Seat 1: c0464749 folded before Flop (didn't bet)
Seat 2: 2690b536 folded before Flop (didn't bet)
Seat 4: c918aaad (button) won ($0.31)
Seat 5: d2077923 (small blind) folded before Flop
Seat 6: Hero (big blind) folded on the Turn


Poker Hand #HD1163151554: Hold'em No Limit  ($0.02/$0.05) - 2023/03/16 19:59:10
Table 'NLHBlue100' 6-max Seat #2 is the button
Seat 1: c0464749 ($2.5 in chips)
Seat 2: 2690b536 ($5.22 in chips)
Seat 4: c918aaad ($6.29 in chips)
Seat 5: d2077923 ($5.14 in chips)
Seat 6: Hero ($5 in chips)
c918aaad: posts small blind $0.02
d2077923: posts big blind $0.05
*** HOLE CARDS ***
Dealt to c0464749 
Dealt to 2690b536 
Dealt to c918aaad 
Dealt to d2077923 
Dealt to Hero [6c 3d]
Hero: folds
c0464749: folds
2690b536: raises $0.08 to $0.13
c918aaad: folds
d2077923: folds
Uncalled bet ($0.08) returned to 2690b536
*** SHOWDOWN ***
2690b536 collected $0.12 from pot
*** SUMMARY ***
Total pot $0.12 | Rake $0 | Jackpot $0 | Bingo $0 | Fortune $0
Seat 1: c0464749 folded before Flop (didn't bet)
Seat 2: 2690b536 (button) collected ($0.12)
Seat 4: c918aaad (small blind) folded before Flop
Seat 5: d2077923 (big blind) folded before Flop
Seat 6: Hero folded before Flop (didn't bet)


Poker Hand #HD1163151496: Hold'em No Limit  ($0.02/$0.05) - 2023/03/16 19:58:53
Table 'NLHBlue100' 6-max Seat #1 is the button
Seat 1: c0464749 ($2.5 in chips)
Seat 2: 2690b536 ($5.24 in chips)
Seat 4: c918aaad ($6.34 in chips)
Seat 5: d2077923 ($5.07 in chips)
Seat 6: Hero ($5 in chips)
2690b536: posts small blind $0.02
c918aaad: posts big blind $0.05
*** HOLE CARDS ***
Dealt to c0464749 
Dealt to 2690b536 
Dealt to c918aaad 
Dealt to d2077923 
Dealt to Hero [9h Js]
d2077923: raises $0.08 to $0.13
Hero: folds
c0464749: folds
2690b536: folds
c918aaad: folds
Uncalled bet ($0.08) returned to d2077923
*** SHOWDOWN ***
d2077923 collected $0.12 from pot
*** SUMMARY ***
Total pot $0.12 | Rake $0 | Jackpot $0 | Bingo $0 | Fortune $0
Seat 1: c0464749 (button) folded before Flop (didn't bet)
Seat 2: 2690b536 (small blind) folded before Flop
Seat 4: c918aaad (big blind) folded before Flop
Seat 5: d2077923 collected ($0.12)
Seat 6: Hero folded before Flop (didn't bet)


Poker Hand #HD1163151330: Hold'em No Limit  ($0.02/$0.05) - 2023/03/16 19:57:56
Table 'NLHBlue100' 6-max Seat #6 is the button
Seat 1: c0464749 ($2.5 in chips)
Seat 2: 2690b536 ($5.29 in chips)
Seat 3: 26d039ab ($29.47 in chips)
Seat 4: c918aaad ($7.55 in chips)
Seat 5: d2077923 ($5.07 in chips)
Seat 6: Hero ($5 in chips)
c0464749: posts small blind $0.02
2690b536: posts big blind $0.05
*** HOLE CARDS ***
Dealt to c0464749 
Dealt to 2690b536 
Dealt to 26d039ab 
Dealt to c918aaad 
Dealt to d2077923 
Dealt to Hero [Jc 2h]
26d039ab: raises $0.08 to $0.13
c918aaad: calls $0.13
d2077923: folds
Hero: folds
c0464749: folds
2690b536: folds
*** FLOP *** [2s 4h Td]
26d039ab: bets $0.11
c918aaad: raises $0.19 to $0.3
26d039ab: raises $0.78 to $1.08
c918aaad: calls $0.78
*** TURN *** [2s 4h Td] [8c]
26d039ab: bets $2.1
c918aaad: folds
Uncalled bet ($2.1) returned to 26d039ab
*** SHOWDOWN ***
26d039ab collected $2.32 from pot
*** SUMMARY ***
Total pot $2.49 | Rake $0.12 | Jackpot $0.05 | Bingo $0 | Fortune $0
Board [2s 4h Td 8c]
Seat 1: c0464749 (small blind) folded before Flop
Seat 2: 2690b536 (big blind) folded before Flop
Seat 3: 26d039ab won ($2.32)
Seat 4: c918aaad folded on the Turn
Seat 5: d2077923 folded before Flop (didn't bet)
Seat 6: Hero (button) folded before Flop (didn't bet)


Poker Hand #HD1163151275: Hold'em No Limit  ($0.02/$0.05) - 2023/03/16 19:57:36
Table 'NLHBlue100' 6-max Seat #5 is the button
Seat 1: c0464749 ($2.5 in chips)
Seat 2: 2690b536 ($5.29 in chips)
Seat 3: 26d039ab ($29.47 in chips)
Seat 4: c918aaad ($7.55 in chips)
Seat 5: d2077923 ($5 in chips)
Seat 6: Hero ($5 in chips)
Hero: posts small blind $0.02
c0464749: posts big blind $0.05
*** HOLE CARDS ***
Dealt to c0464749 
Dealt to 2690b536 
Dealt to 26d039ab 
Dealt to c918aaad 
Dealt to d2077923 
Dealt to Hero [Jc 9h]
2690b536: folds
26d039ab: folds
c918aaad: folds
d2077923: raises $0.08 to $0.13
Hero: folds
c0464749: folds
Uncalled bet ($0.08) returned to d2077923
*** SHOWDOWN ***
d2077923 collected $0.12 from pot
*** SUMMARY ***
Total pot $0.12 | Rake $0 | Jackpot $0 | Bingo $0 | Fortune $0
Seat 1: c0464749 (big blind) folded before Flop
Seat 2: 2690b536 folded before Flop (didn't bet)
Seat 3: 26d039ab folded before Flop (didn't bet)
Seat 4: c918aaad folded before Flop (didn't bet)
Seat 5: d2077923 (button) collected ($0.12)
Seat 6: Hero (small blind) folded before Flop


Poker Hand #HD1163151238: Hold'em No Limit  ($0.02/$0.05) - 2023/03/16 19:57:24
Table 'NLHBlue100' 6-max Seat #4 is the button
Seat 2: 2690b536 ($5.29 in chips)
Seat 3: 26d039ab ($29.4 in chips)
Seat 4: c918aaad ($7.55 in chips)
Seat 5: d2077923 ($5 in chips)
Seat 6: Hero ($5 in chips)
d2077923: posts small blind $0.02
Hero: posts big blind $0.05
*** HOLE CARDS ***
Dealt to 2690b536 
Dealt to 26d039ab 
Dealt to c918aaad 
Dealt to d2077923 
Dealt to Hero [Jd 7h]
2690b536: folds
26d039ab: raises $0.08 to $0.13
c918aaad: folds
d2077923: folds
Hero: folds
Uncalled bet ($0.08) returned to 26d039ab
*** SHOWDOWN ***
26d039ab collected $0.12 from pot
*** SUMMARY ***
Total pot $0.12 | Rake $0 | Jackpot $0 | Bingo $0 | Fortune $0
Seat 2: 2690b536 folded before Flop (didn't bet)
Seat 3: 26d039ab collected ($0.12)
Seat 4: c918aaad (button) folded before Flop (didn't bet)
Seat 5: d2077923 (small blind) folded before Flop
Seat 6: Hero (big blind) folded before Flop


