Poker Hand #HD1183987265: Hold'em No Limit  ($0.02/$0.05) - 2023/03/31 20:50:11
Table 'NLHBlue87' 6-max Seat #6 is the button
Seat 1: 93b3391c ($0.95 in chips)
Seat 2: c5631b86 ($5.99 in chips)
Seat 3: Hero ($7.91 in chips)
Seat 4: 68beb82 ($4.92 in chips)
Seat 5: ebe9ff0f ($7.13 in chips)
Seat 6: 32b2445a ($14.16 in chips)
93b3391c: posts small blind $0.02
c5631b86: posts big blind $0.05
*** HOLE CARDS ***
Dealt to 93b3391c 
Dealt to c5631b86 
Dealt to Hero [5s Jc]
Dealt to 68beb82 
Dealt to ebe9ff0f 
Dealt to 32b2445a 
Hero: folds
68beb82: folds
ebe9ff0f: folds
32b2445a: calls $0.05
93b3391c: folds
c5631b86: checks
*** FLOP *** [7h 5h Qs]
c5631b86: bets $0.06
32b2445a: calls $0.06
*** TURN *** [7h 5h Qs] [3h]
c5631b86: checks
32b2445a: checks
*** RIVER *** [7h 5h Qs 3h] [8c]
c5631b86: checks
32b2445a: checks
c5631b86: shows [5d Kd] (Pair of Fives)
32b2445a: shows [9d 8h] (Pair of Eights)
*** SHOWDOWN ***
32b2445a collected $0.23 from pot
*** SUMMARY ***
Total pot $0.24 | Rake $0.01 | Jackpot $0 | Bingo $0 | Fortune $0
Board [7h 5h Qs 3h 8c]
Seat 1: 93b3391c (small blind) folded before Flop
Seat 2: c5631b86 (big blind) showed [5d Kd] and lost with Pair of Fives
Seat 3: Hero folded before Flop (didn't bet)
Seat 4: 68beb82 folded before Flop (didn't bet)
Seat 5: ebe9ff0f folded before Flop (didn't bet)
Seat 6: 32b2445a (button) showed [9d 8h] and won ($0.23) with Pair of Eights


Poker Hand #HD1183987230: Hold'em No Limit  ($0.02/$0.05) - 2023/03/31 20:49:52
Table 'NLHBlue87' 6-max Seat #5 is the button
Seat 1: 93b3391c ($1 in chips)
Seat 2: c5631b86 ($5.99 in chips)
Seat 3: Hero ($7.91 in chips)
Seat 4: 68beb82 ($4.85 in chips)
Seat 5: ebe9ff0f ($7.13 in chips)
Seat 6: 32b2445a ($14.18 in chips)
32b2445a: posts small blind $0.02
93b3391c: posts big blind $0.05
*** HOLE CARDS ***
Dealt to 93b3391c 
Dealt to c5631b86 
Dealt to Hero [3c 2s]
Dealt to 68beb82 
Dealt to ebe9ff0f 
Dealt to 32b2445a 
c5631b86: folds
Hero: folds
68beb82: raises $0.08 to $0.13
ebe9ff0f: folds
32b2445a: folds
93b3391c: folds
Uncalled bet ($0.08) returned to 68beb82
*** SHOWDOWN ***
68beb82 collected $0.12 from pot
*** SUMMARY ***
Total pot $0.12 | Rake $0 | Jackpot $0 | Bingo $0 | Fortune $0
Seat 1: 93b3391c (big blind) folded before Flop
Seat 2: c5631b86 folded before Flop (didn't bet)
Seat 3: Hero folded before Flop (didn't bet)
Seat 4: 68beb82 collected ($0.12)
Seat 5: ebe9ff0f (button) folded before Flop (didn't bet)
Seat 6: 32b2445a (small blind) folded before Flop


Poker Hand #HD1183987152: Hold'em No Limit  ($0.02/$0.05) - 2023/03/31 20:49:22
Table 'NLHBlue87' 6-max Seat #4 is the button
Seat 2: c5631b86 ($5.99 in chips)
Seat 3: Hero ($7.91 in chips)
Seat 4: 68beb82 ($4.78 in chips)
Seat 5: ebe9ff0f ($7.15 in chips)
Seat 6: 32b2445a ($14.23 in chips)
ebe9ff0f: posts small blind $0.02
32b2445a: posts big blind $0.05
*** HOLE CARDS ***
Dealt to c5631b86 
Dealt to Hero [8d Th]
Dealt to 68beb82 
Dealt to ebe9ff0f 
Dealt to 32b2445a 
c5631b86: folds
Hero: folds
68beb82: raises $0.08 to $0.13
ebe9ff0f: folds
32b2445a: folds
Uncalled bet ($0.08) returned to 68beb82
*** SHOWDOWN ***
68beb82 collected $0.12 from pot
*** SUMMARY ***
Total pot $0.12 | Rake $0 | Jackpot $0 | Bingo $0 | Fortune $0
Seat 2: c5631b86 folded before Flop (didn't bet)
Seat 3: Hero folded before Flop (didn't bet)
Seat 4: 68beb82 (button) collected ($0.12)
Seat 5: ebe9ff0f (small blind) folded before Flop
Seat 6: 32b2445a (big blind) folded before Flop


Poker Hand #HD1183987090: Hold'em No Limit  ($0.02/$0.05) - 2023/03/31 20:48:56
Table 'NLHBlue87' 6-max Seat #3 is the button
Seat 2: c5631b86 ($5.99 in chips)
Seat 3: Hero ($7.91 in chips)
Seat 4: 68beb82 ($4.73 in chips)
Seat 5: ebe9ff0f ($7.2 in chips)
Seat 6: 32b2445a ($14.23 in chips)
68beb82: posts small blind $0.02
ebe9ff0f: posts big blind $0.05
*** HOLE CARDS ***
Dealt to c5631b86 
Dealt to Hero [4d Th]
Dealt to 68beb82 
Dealt to ebe9ff0f 
Dealt to 32b2445a 
32b2445a: folds
c5631b86: folds
Hero: folds
68beb82: raises $0.1 to $0.15
ebe9ff0f: folds
Uncalled bet ($0.1) returned to 68beb82
*** SHOWDOWN ***
68beb82 collected $0.1 from pot
*** SUMMARY ***
Total pot $0.1 | Rake $0 | Jackpot $0 | Bingo $0 | Fortune $0
Seat 2: c5631b86 folded before Flop (didn't bet)
Seat 3: Hero (button) folded before Flop (didn't bet)
Seat 4: 68beb82 (small blind) collected ($0.1)
Seat 5: ebe9ff0f (big blind) folded before Flop
Seat 6: 32b2445a folded before Flop (didn't bet)


Poker Hand #HD1183987018: Hold'em No Limit  ($0.02/$0.05) - 2023/03/31 20:48:27
Table 'NLHBlue87' 6-max Seat #2 is the button
Seat 2: c5631b86 ($5.99 in chips)
Seat 3: Hero ($7.93 in chips)
Seat 4: 68beb82 ($4.86 in chips)
Seat 5: ebe9ff0f ($7.06 in chips)
Seat 6: 32b2445a ($14.23 in chips)
Hero: posts small blind $0.02
68beb82: posts big blind $0.05
*** HOLE CARDS ***
Dealt to c5631b86 
Dealt to Hero [7s Qh]
Dealt to 68beb82 
Dealt to ebe9ff0f 
Dealt to 32b2445a 
ebe9ff0f: raises $0.08 to $0.13
32b2445a: folds
c5631b86: folds
Hero: folds
68beb82: calls $0.08
*** FLOP *** [8d Js 7h]
68beb82: checks
ebe9ff0f: bets $0.09
68beb82: folds
Uncalled bet ($0.09) returned to ebe9ff0f
*** SHOWDOWN ***
ebe9ff0f collected $0.27 from pot
*** SUMMARY ***
Total pot $0.28 | Rake $0.01 | Jackpot $0 | Bingo $0 | Fortune $0
Board [8d Js 7h]
Seat 2: c5631b86 (button) folded before Flop (didn't bet)
Seat 3: Hero (small blind) folded before Flop
Seat 4: 68beb82 (big blind) folded on the Flop
Seat 5: ebe9ff0f won ($0.27)
Seat 6: 32b2445a folded before Flop (didn't bet)


Poker Hand #HD1183986859: Hold'em No Limit  ($0.02/$0.05) - 2023/03/31 20:47:24
Table 'NLHBlue87' 6-max Seat #6 is the button
Seat 1: c9de55a8 ($4.59 in chips)
Seat 2: c5631b86 ($6.04 in chips)
Seat 3: Hero ($7.93 in chips)
Seat 4: 68beb82 ($4.86 in chips)
Seat 5: ebe9ff0f ($6.25 in chips)
Seat 6: 32b2445a ($15.1 in chips)
c9de55a8: posts small blind $0.02
c5631b86: posts big blind $0.05
*** HOLE CARDS ***
Dealt to c9de55a8 
Dealt to c5631b86 
Dealt to Hero [5s 4h]
Dealt to 68beb82 
Dealt to ebe9ff0f 
Dealt to 32b2445a 
Hero: folds
68beb82: folds
ebe9ff0f: raises $0.08 to $0.13
32b2445a: calls $0.13
c9de55a8: folds
c5631b86: folds
*** FLOP *** [Qh Jd Jc]
ebe9ff0f: checks
32b2445a: bets $0.17
ebe9ff0f: calls $0.17
*** TURN *** [Qh Jd Jc] [3c]
ebe9ff0f: checks
32b2445a: checks
*** RIVER *** [Qh Jd Jc 3c] [4s]
ebe9ff0f: checks
32b2445a: bets $0.23
ebe9ff0f: raises $0.34 to $0.57
32b2445a: calls $0.34
ebe9ff0f: shows [Qd Ah] (Pair of Queens and Pair of Jacks)
32b2445a: shows [Qs 9s] (Pair of Queens and Pair of Jacks)
*** SHOWDOWN ***
ebe9ff0f collected $1.68 from pot
*** SUMMARY ***
Total pot $1.81 | Rake $0.08 | Jackpot $0.05 | Bingo $0 | Fortune $0
Board [Qh Jd Jc 3c 4s]
Seat 1: c9de55a8 (small blind) folded before Flop
Seat 2: c5631b86 (big blind) folded before Flop
Seat 3: Hero folded before Flop (didn't bet)
Seat 4: 68beb82 folded before Flop (didn't bet)
Seat 5: ebe9ff0f showed [Qd Ah] and won ($1.68) with Pair of Queens and Pair of Jacks
Seat 6: 32b2445a (button) showed [Qs 9s] and lost with Pair of Queens and Pair of Jacks


Poker Hand #HD1183986819: Hold'em No Limit  ($0.02/$0.05) - 2023/03/31 20:47:07
Table 'NLHBlue87' 6-max Seat #5 is the button
Seat 1: c9de55a8 ($4.64 in chips)
Seat 2: c5631b86 ($6.04 in chips)
Seat 3: Hero ($7.93 in chips)
Seat 4: 68beb82 ($4.86 in chips)
Seat 5: ebe9ff0f ($6.25 in chips)
Seat 6: 32b2445a ($15.05 in chips)
32b2445a: posts small blind $0.02
c9de55a8: posts big blind $0.05
*** HOLE CARDS ***
Dealt to c9de55a8 
Dealt to c5631b86 
Dealt to Hero [Qh 6s]
Dealt to 68beb82 
Dealt to ebe9ff0f 
Dealt to 32b2445a 
c5631b86: folds
Hero: folds
68beb82: folds
ebe9ff0f: folds
32b2445a: raises $0.1 to $0.15
c9de55a8: folds
Uncalled bet ($0.1) returned to 32b2445a
*** SHOWDOWN ***
32b2445a collected $0.1 from pot
*** SUMMARY ***
Total pot $0.1 | Rake $0 | Jackpot $0 | Bingo $0 | Fortune $0
Seat 1: c9de55a8 (big blind) folded before Flop
Seat 2: c5631b86 folded before Flop (didn't bet)
Seat 3: Hero folded before Flop (didn't bet)
Seat 4: 68beb82 folded before Flop (didn't bet)
Seat 5: ebe9ff0f (button) folded before Flop (didn't bet)
Seat 6: 32b2445a (small blind) collected ($0.1)


Poker Hand #HD1183986790: Hold'em No Limit  ($0.02/$0.05) - 2023/03/31 20:46:55
Table 'NLHBlue87' 6-max Seat #4 is the button
Seat 1: c9de55a8 ($4.64 in chips)
Seat 2: c5631b86 ($6.04 in chips)
Seat 3: Hero ($7.93 in chips)
Seat 4: 68beb82 ($4.86 in chips)
Seat 5: ebe9ff0f ($6.2 in chips)
Seat 6: 32b2445a ($15.1 in chips)
ebe9ff0f: posts small blind $0.02
32b2445a: posts big blind $0.05
*** HOLE CARDS ***
Dealt to c9de55a8 
Dealt to c5631b86 
Dealt to Hero [Jh 5s]
Dealt to 68beb82 
Dealt to ebe9ff0f 
Dealt to 32b2445a 
c9de55a8: folds
c5631b86: folds
Hero: folds
68beb82: folds
ebe9ff0f: raises $0.1 to $0.15
32b2445a: folds
Uncalled bet ($0.1) returned to ebe9ff0f
*** SHOWDOWN ***
ebe9ff0f collected $0.1 from pot
*** SUMMARY ***
Total pot $0.1 | Rake $0 | Jackpot $0 | Bingo $0 | Fortune $0
Seat 1: c9de55a8 folded before Flop (didn't bet)
Seat 2: c5631b86 folded before Flop (didn't bet)
Seat 3: Hero folded before Flop (didn't bet)
Seat 4: 68beb82 (button) folded before Flop (didn't bet)
Seat 5: ebe9ff0f (small blind) collected ($0.1)
Seat 6: 32b2445a (big blind) folded before Flop


Poker Hand #HD1183986742: Hold'em No Limit  ($0.02/$0.05) - 2023/03/31 20:46:35
Table 'NLHBlue87' 6-max Seat #3 is the button
Seat 1: c9de55a8 ($4.57 in chips)
Seat 2: c5631b86 ($6.04 in chips)
Seat 3: Hero ($7.93 in chips)
Seat 4: 68beb82 ($4.88 in chips)
Seat 5: ebe9ff0f ($6.25 in chips)
Seat 6: 32b2445a ($15.1 in chips)
68beb82: posts small blind $0.02
ebe9ff0f: posts big blind $0.05
*** HOLE CARDS ***
Dealt to c9de55a8 
Dealt to c5631b86 
Dealt to Hero [9s 3s]
Dealt to 68beb82 
Dealt to ebe9ff0f 
Dealt to 32b2445a 
32b2445a: folds
c9de55a8: raises $0.1 to $0.15
c5631b86: folds
Hero: folds
68beb82: folds
ebe9ff0f: folds
Uncalled bet ($0.1) returned to c9de55a8
*** SHOWDOWN ***
c9de55a8 collected $0.12 from pot
*** SUMMARY ***
Total pot $0.12 | Rake $0 | Jackpot $0 | Bingo $0 | Fortune $0
Seat 1: c9de55a8 collected ($0.12)
Seat 2: c5631b86 folded before Flop (didn't bet)
Seat 3: Hero (button) folded before Flop (didn't bet)
Seat 4: 68beb82 (small blind) folded before Flop
Seat 5: ebe9ff0f (big blind) folded before Flop
Seat 6: 32b2445a folded before Flop (didn't bet)


Poker Hand #HD1183986710: Hold'em No Limit  ($0.02/$0.05) - 2023/03/31 20:46:21
Table 'NLHBlue87' 6-max Seat #2 is the button
Seat 1: c9de55a8 ($4.57 in chips)
Seat 2: c5631b86 ($6.04 in chips)
Seat 3: Hero ($7.95 in chips)
Seat 4: 68beb82 ($4.86 in chips)
Seat 5: ebe9ff0f ($6.25 in chips)
Seat 6: 32b2445a ($15.1 in chips)
Hero: posts small blind $0.02
68beb82: posts big blind $0.05
*** HOLE CARDS ***
Dealt to c9de55a8 
Dealt to c5631b86 
Dealt to Hero [5h Jh]
Dealt to 68beb82 
Dealt to ebe9ff0f 
Dealt to 32b2445a 
ebe9ff0f: folds
32b2445a: folds
c9de55a8: folds
c5631b86: folds
Hero: folds
Uncalled bet ($0.03) returned to 68beb82
*** SHOWDOWN ***
68beb82 collected $0.04 from pot
*** SUMMARY ***
Total pot $0.04 | Rake $0 | Jackpot $0 | Bingo $0 | Fortune $0
Seat 1: c9de55a8 folded before Flop (didn't bet)
Seat 2: c5631b86 (button) folded before Flop (didn't bet)
Seat 3: Hero (small blind) folded before Flop
Seat 4: 68beb82 (big blind) collected ($0.04)
Seat 5: ebe9ff0f folded before Flop (didn't bet)
Seat 6: 32b2445a folded before Flop (didn't bet)


Poker Hand #HD1183986631: Hold'em No Limit  ($0.02/$0.05) - 2023/03/31 20:45:50
Table 'NLHBlue87' 6-max Seat #1 is the button
Seat 1: c9de55a8 ($4.7 in chips)
Seat 2: c5631b86 ($5.62 in chips)
Seat 3: Hero ($8 in chips)
Seat 4: 68beb82 ($4.86 in chips)
Seat 5: ebe9ff0f ($6.38 in chips)
Seat 6: 32b2445a ($15.23 in chips)
c5631b86: posts small blind $0.02
Hero: posts big blind $0.05
*** HOLE CARDS ***
Dealt to c9de55a8 
Dealt to c5631b86 
Dealt to Hero [Qs 5h]
Dealt to 68beb82 
Dealt to ebe9ff0f 
Dealt to 32b2445a 
68beb82: folds
ebe9ff0f: raises $0.08 to $0.13
32b2445a: calls $0.13
c9de55a8: calls $0.13
c5631b86: raises $0.92 to $1.05
Hero: folds
ebe9ff0f: folds
32b2445a: folds
c9de55a8: folds
Uncalled bet ($0.92) returned to c5631b86
*** SHOWDOWN ***
c5631b86 collected $0.55 from pot
*** SUMMARY ***
Total pot $0.57 | Rake $0.02 | Jackpot $0 | Bingo $0 | Fortune $0
Seat 1: c9de55a8 (button) folded before Flop
Seat 2: c5631b86 (small blind) collected ($0.55)
Seat 3: Hero (big blind) folded before Flop
Seat 4: 68beb82 folded before Flop (didn't bet)
Seat 5: ebe9ff0f folded before Flop
Seat 6: 32b2445a folded before Flop


Poker Hand #HD1183986476: Hold'em No Limit  ($0.02/$0.05) - 2023/03/31 20:44:43
Table 'NLHBlue87' 6-max Seat #6 is the button
Seat 1: c9de55a8 ($4.72 in chips)
Seat 2: c5631b86 ($5.62 in chips)
Seat 3: Hero ($8 in chips)
Seat 4: 68beb82 ($4.86 in chips)
Seat 5: ebe9ff0f ($6.38 in chips)
Seat 6: 32b2445a ($15.23 in chips)
c9de55a8: posts small blind $0.02
c5631b86: posts big blind $0.05
*** HOLE CARDS ***
Dealt to c9de55a8 
Dealt to c5631b86 
Dealt to Hero [5h 3h]
Dealt to 68beb82 
Dealt to ebe9ff0f 
Dealt to 32b2445a 
Hero: folds
68beb82: raises $0.08 to $0.13
ebe9ff0f: folds
32b2445a: folds
c9de55a8: folds
c5631b86: calls $0.08
*** FLOP *** [Th 5s 7h]
c5631b86: checks
68beb82: bets $0.14
c5631b86: calls $0.14
*** TURN *** [Th 5s 7h] [Ad]
c5631b86: checks
68beb82: checks
*** RIVER *** [Th 5s 7h Ad] [7d]
c5631b86: checks
68beb82: checks
c5631b86: shows [8s Ts] (Pair of Tens and Pair of Sevens)
68beb82: shows [Td Qd] (Pair of Tens and Pair of Sevens)
*** SHOWDOWN ***
c5631b86 collected $0.27 from pot
68beb82 collected $0.27 from pot
*** SUMMARY ***
Total pot $0.56 | Rake $0.02 | Jackpot $0 | Bingo $0 | Fortune $0
Board [Th 5s 7h Ad 7d]
Seat 1: c9de55a8 (small blind) folded before Flop
Seat 2: c5631b86 (big blind) showed [8s Ts] and won ($0.27) with Pair of Tens and Pair of Sevens
Seat 3: Hero folded before Flop (didn't bet)
Seat 4: 68beb82 showed [Td Qd] and won ($0.27) with Pair of Tens and Pair of Sevens
Seat 5: ebe9ff0f folded before Flop (didn't bet)
Seat 6: 32b2445a (button) folded before Flop (didn't bet)


Poker Hand #HD1183986366: Hold'em No Limit  ($0.02/$0.05) - 2023/03/31 20:43:50
Table 'NLHBlue87' 6-max Seat #5 is the button
Seat 1: c9de55a8 ($4.85 in chips)
Seat 2: c5631b86 ($5.62 in chips)
Seat 3: Hero ($8 in chips)
Seat 4: 68beb82 ($4.86 in chips)
Seat 5: ebe9ff0f ($6.24 in chips)
Seat 6: 32b2445a ($15.25 in chips)
32b2445a: posts small blind $0.02
c9de55a8: posts big blind $0.05
*** HOLE CARDS ***
Dealt to c9de55a8 
Dealt to c5631b86 
Dealt to Hero [Kd Th]
Dealt to 68beb82 
Dealt to ebe9ff0f 
Dealt to 32b2445a 
c5631b86: folds
Hero: folds
68beb82: folds
ebe9ff0f: raises $0.08 to $0.13
32b2445a: folds
c9de55a8: calls $0.08
*** FLOP *** [Jh Ac As]
c9de55a8: checks
ebe9ff0f: checks
*** TURN *** [Jh Ac As] [Qd]
c9de55a8: checks
ebe9ff0f: bets $0.21
c9de55a8: folds
Uncalled bet ($0.21) returned to ebe9ff0f
*** SHOWDOWN ***
ebe9ff0f collected $0.27 from pot
*** SUMMARY ***
Total pot $0.28 | Rake $0.01 | Jackpot $0 | Bingo $0 | Fortune $0
Board [Jh Ac As Qd]
Seat 1: c9de55a8 (big blind) folded on the Turn
Seat 2: c5631b86 folded before Flop (didn't bet)
Seat 3: Hero folded before Flop (didn't bet)
Seat 4: 68beb82 folded before Flop (didn't bet)
Seat 5: ebe9ff0f (button) won ($0.27)
Seat 6: 32b2445a (small blind) folded before Flop


Poker Hand #HD1183986262: Hold'em No Limit  ($0.02/$0.05) - 2023/03/31 20:43:04
Table 'NLHBlue87' 6-max Seat #4 is the button
Seat 1: c9de55a8 ($4.95 in chips)
Seat 2: c5631b86 ($5.41 in chips)
Seat 3: Hero ($8 in chips)
Seat 4: 68beb82 ($4.86 in chips)
Seat 5: ebe9ff0f ($6.26 in chips)
Seat 6: 32b2445a ($15.35 in chips)
ebe9ff0f: posts small blind $0.02
32b2445a: posts big blind $0.05
*** HOLE CARDS ***
Dealt to c9de55a8 
Dealt to c5631b86 
Dealt to Hero [Tc 2c]
Dealt to 68beb82 
Dealt to ebe9ff0f 
Dealt to 32b2445a 
c9de55a8: raises $0.05 to $0.1
c5631b86: calls $0.1
Hero: folds
68beb82: folds
ebe9ff0f: folds
32b2445a: calls $0.05
*** FLOP *** [6s 4h 6h]
32b2445a: checks
c9de55a8: checks
c5631b86: bets $0.16
32b2445a: folds
c9de55a8: folds
Uncalled bet ($0.16) returned to c5631b86
*** SHOWDOWN ***
c5631b86 collected $0.31 from pot
*** SUMMARY ***
Total pot $0.32 | Rake $0.01 | Jackpot $0 | Bingo $0 | Fortune $0
Board [6s 4h 6h]
Seat 1: c9de55a8 folded on the Flop
Seat 2: c5631b86 won ($0.31)
Seat 3: Hero folded before Flop (didn't bet)
Seat 4: 68beb82 (button) folded before Flop (didn't bet)
Seat 5: ebe9ff0f (small blind) folded before Flop
Seat 6: 32b2445a (big blind) folded on the Flop


Poker Hand #HD1183986183: Hold'em No Limit  ($0.02/$0.05) - 2023/03/31 20:42:30
Table 'NLHBlue87' 6-max Seat #3 is the button
Seat 1: c9de55a8 ($4.95 in chips)
Seat 2: c5631b86 ($5.41 in chips)
Seat 3: Hero ($8.12 in chips)
Seat 4: 68beb82 ($4.88 in chips)
Seat 5: ebe9ff0f ($6.13 in chips)
Seat 6: 32b2445a ($15.35 in chips)
68beb82: posts small blind $0.02
ebe9ff0f: posts big blind $0.05
*** HOLE CARDS ***
Dealt to c9de55a8 
Dealt to c5631b86 
Dealt to Hero [Ac Td]
Dealt to 68beb82 
Dealt to ebe9ff0f 
Dealt to 32b2445a 
32b2445a: folds
c9de55a8: folds
c5631b86: folds
Hero: raises $0.07 to $0.12
68beb82: folds
ebe9ff0f: calls $0.07
*** FLOP *** [Jc 7d 6h]
ebe9ff0f: checks
Hero: checks
*** TURN *** [Jc 7d 6h] [Kc]
ebe9ff0f: bets $0.32
Hero: folds
Uncalled bet ($0.32) returned to ebe9ff0f
*** SHOWDOWN ***
ebe9ff0f collected $0.25 from pot
*** SUMMARY ***
Total pot $0.26 | Rake $0.01 | Jackpot $0 | Bingo $0 | Fortune $0
Board [Jc 7d 6h Kc]
Seat 1: c9de55a8 folded before Flop (didn't bet)
Seat 2: c5631b86 folded before Flop (didn't bet)
Seat 3: Hero (button) folded on the Turn
Seat 4: 68beb82 (small blind) folded before Flop
Seat 5: ebe9ff0f (big blind) won ($0.25)
Seat 6: 32b2445a folded before Flop (didn't bet)


Poker Hand #HD1183986089: Hold'em No Limit  ($0.02/$0.05) - 2023/03/31 20:41:52
Table 'NLHBlue87' 6-max Seat #2 is the button
Seat 1: c9de55a8 ($4.76 in chips)
Seat 2: c5631b86 ($5.41 in chips)
Seat 3: Hero ($8.14 in chips)
Seat 4: 68beb82 ($4.93 in chips)
Seat 5: ebe9ff0f ($6.26 in chips)
Seat 6: 32b2445a ($15.35 in chips)
Hero: posts small blind $0.02
68beb82: posts big blind $0.05
*** HOLE CARDS ***
Dealt to c9de55a8 
Dealt to c5631b86 
Dealt to Hero [3s 9h]
Dealt to 68beb82 
Dealt to ebe9ff0f 
Dealt to 32b2445a 
ebe9ff0f: raises $0.08 to $0.13
32b2445a: folds
c9de55a8: raises $0.25 to $0.38
c5631b86: folds
Hero: folds
68beb82: folds
ebe9ff0f: folds
Uncalled bet ($0.25) returned to c9de55a8
*** SHOWDOWN ***
c9de55a8 collected $0.32 from pot
*** SUMMARY ***
Total pot $0.33 | Rake $0.01 | Jackpot $0 | Bingo $0 | Fortune $0
Seat 1: c9de55a8 collected ($0.32)
Seat 2: c5631b86 (button) folded before Flop (didn't bet)
Seat 3: Hero (small blind) folded before Flop
Seat 4: 68beb82 (big blind) folded before Flop
Seat 5: ebe9ff0f folded before Flop
Seat 6: 32b2445a folded before Flop (didn't bet)


Poker Hand #HD1183986035: Hold'em No Limit  ($0.02/$0.05) - 2023/03/31 20:41:23
Table 'NLHBlue87' 6-max Seat #1 is the button
Seat 1: c9de55a8 ($4.89 in chips)
Seat 2: c5631b86 ($5.43 in chips)
Seat 3: Hero ($7.88 in chips)
Seat 4: 68beb82 ($4.93 in chips)
Seat 5: ebe9ff0f ($6.39 in chips)
Seat 6: 32b2445a ($15.35 in chips)
c5631b86: posts small blind $0.02
Hero: posts big blind $0.05
*** HOLE CARDS ***
Dealt to c9de55a8 
Dealt to c5631b86 
Dealt to Hero [Kc Ks]
Dealt to 68beb82 
Dealt to ebe9ff0f 
Dealt to 32b2445a 
68beb82: folds
ebe9ff0f: raises $0.08 to $0.13
32b2445a: folds
c9de55a8: calls $0.13
c5631b86: folds
Hero: raises $0.62 to $0.75
ebe9ff0f: folds
c9de55a8: folds
Uncalled bet ($0.62) returned to Hero
*** SHOWDOWN ***
Hero collected $0.39 from pot
*** SUMMARY ***
Total pot $0.41 | Rake $0.02 | Jackpot $0 | Bingo $0 | Fortune $0
Seat 1: c9de55a8 (button) folded before Flop
Seat 2: c5631b86 (small blind) folded before Flop
Seat 3: Hero (big blind) collected ($0.39)
Seat 4: 68beb82 folded before Flop (didn't bet)
Seat 5: ebe9ff0f folded before Flop
Seat 6: 32b2445a folded before Flop (didn't bet)


Poker Hand #HD1183985919: Hold'em No Limit  ($0.02/$0.05) - 2023/03/31 20:40:32
Table 'NLHBlue87' 6-max Seat #6 is the button
Seat 1: c9de55a8 ($4.52 in chips)
Seat 2: c5631b86 ($5.48 in chips)
Seat 3: Hero ($7.88 in chips)
Seat 4: 68beb82 ($4.93 in chips)
Seat 5: ebe9ff0f ($6.39 in chips)
Seat 6: 32b2445a ($15.7 in chips)
c9de55a8: posts small blind $0.02
c5631b86: posts big blind $0.05
*** HOLE CARDS ***
Dealt to c9de55a8 
Dealt to c5631b86 
Dealt to Hero [5c 3s]
Dealt to 68beb82 
Dealt to ebe9ff0f 
Dealt to 32b2445a 
Hero: folds
68beb82: folds
ebe9ff0f: folds
32b2445a: raises $0.05 to $0.1
c9de55a8: raises $0.25 to $0.35
c5631b86: folds
32b2445a: calls $0.25
*** FLOP *** [6h 9h Jd]
c9de55a8: bets $0.38
32b2445a: folds
Uncalled bet ($0.38) returned to c9de55a8
c9de55a8: shows [Qd Qs] (Pair of Queens)
*** SHOWDOWN ***
c9de55a8 collected $0.72 from pot
*** SUMMARY ***
Total pot $0.75 | Rake $0.03 | Jackpot $0 | Bingo $0 | Fortune $0
Board [6h 9h Jd]
Seat 1: c9de55a8 (small blind) showed [Qd Qs] and won ($0.72) with Pair of Queens
Seat 2: c5631b86 (big blind) folded before Flop
Seat 3: Hero folded before Flop (didn't bet)
Seat 4: 68beb82 folded before Flop (didn't bet)
Seat 5: ebe9ff0f folded before Flop (didn't bet)
Seat 6: 32b2445a (button) folded on the Flop


Poker Hand #HD1183985888: Hold'em No Limit  ($0.02/$0.05) - 2023/03/31 20:40:18
Table 'NLHBlue87' 6-max Seat #5 is the button
Seat 1: c9de55a8 ($4.57 in chips)
Seat 2: c5631b86 ($5.48 in chips)
Seat 3: Hero ($7.88 in chips)
Seat 4: 68beb82 ($4.93 in chips)
Seat 5: ebe9ff0f ($6.32 in chips)
Seat 6: 32b2445a ($15.72 in chips)
32b2445a: posts small blind $0.02
c9de55a8: posts big blind $0.05
*** HOLE CARDS ***
Dealt to c9de55a8 
Dealt to c5631b86 
Dealt to Hero [3h Ts]
Dealt to 68beb82 
Dealt to ebe9ff0f 
Dealt to 32b2445a 
c5631b86: folds
Hero: folds
68beb82: folds
ebe9ff0f: raises $0.08 to $0.13
32b2445a: folds
c9de55a8: folds
Uncalled bet ($0.08) returned to ebe9ff0f
*** SHOWDOWN ***
ebe9ff0f collected $0.12 from pot
*** SUMMARY ***
Total pot $0.12 | Rake $0 | Jackpot $0 | Bingo $0 | Fortune $0
Seat 1: c9de55a8 (big blind) folded before Flop
Seat 2: c5631b86 folded before Flop (didn't bet)
Seat 3: Hero folded before Flop (didn't bet)
Seat 4: 68beb82 folded before Flop (didn't bet)
Seat 5: ebe9ff0f (button) collected ($0.12)
Seat 6: 32b2445a (small blind) folded before Flop


Poker Hand #HD1183985781: Hold'em No Limit  ($0.02/$0.05) - 2023/03/31 20:39:35
Table 'NLHBlue87' 6-max Seat #4 is the button
Seat 1: c9de55a8 ($4.57 in chips)
Seat 2: c5631b86 ($5.63 in chips)
Seat 3: Hero ($7.67 in chips)
Seat 4: 68beb82 ($4.93 in chips)
Seat 5: ebe9ff0f ($6.34 in chips)
Seat 6: 32b2445a ($15.77 in chips)
ebe9ff0f: posts small blind $0.02
32b2445a: posts big blind $0.05
*** HOLE CARDS ***
Dealt to c9de55a8 
Dealt to c5631b86 
Dealt to Hero [Kc Ac]
Dealt to 68beb82 
Dealt to ebe9ff0f 
Dealt to 32b2445a 
c9de55a8: folds
c5631b86: raises $0.1 to $0.15
Hero: raises $0.25 to $0.4
68beb82: folds
ebe9ff0f: folds
32b2445a: folds
c5631b86: folds
Uncalled bet ($0.25) returned to Hero
*** SHOWDOWN ***
Hero collected $0.36 from pot
*** SUMMARY ***
Total pot $0.37 | Rake $0.01 | Jackpot $0 | Bingo $0 | Fortune $0
Seat 1: c9de55a8 folded before Flop (didn't bet)
Seat 2: c5631b86 folded before Flop
Seat 3: Hero collected ($0.36)
Seat 4: 68beb82 (button) folded before Flop (didn't bet)
Seat 5: ebe9ff0f (small blind) folded before Flop
Seat 6: 32b2445a (big blind) folded before Flop


Poker Hand #HD1183985723: Hold'em No Limit  ($0.02/$0.05) - 2023/03/31 20:39:13
Table 'NLHBlue87' 6-max Seat #3 is the button
Seat 1: c9de55a8 ($4.57 in chips)
Seat 2: c5631b86 ($5.63 in chips)
Seat 3: Hero ($7.67 in chips)
Seat 4: 68beb82 ($4.95 in chips)
Seat 5: ebe9ff0f ($6.32 in chips)
Seat 6: 32b2445a ($15.77 in chips)
68beb82: posts small blind $0.02
ebe9ff0f: posts big blind $0.05
*** HOLE CARDS ***
Dealt to c9de55a8 
Dealt to c5631b86 
Dealt to Hero [5d 8h]
Dealt to 68beb82 
Dealt to ebe9ff0f 
Dealt to 32b2445a 
32b2445a: folds
c9de55a8: folds
c5631b86: folds
Hero: folds
68beb82: folds
Uncalled bet ($0.03) returned to ebe9ff0f
*** SHOWDOWN ***
ebe9ff0f collected $0.04 from pot
*** SUMMARY ***
Total pot $0.04 | Rake $0 | Jackpot $0 | Bingo $0 | Fortune $0
Seat 1: c9de55a8 folded before Flop (didn't bet)
Seat 2: c5631b86 folded before Flop (didn't bet)
Seat 3: Hero (button) folded before Flop (didn't bet)
Seat 4: 68beb82 (small blind) folded before Flop
Seat 5: ebe9ff0f (big blind) collected ($0.04)
Seat 6: 32b2445a folded before Flop (didn't bet)


Poker Hand #HD1183895591: Hold'em No Limit  ($0.02/$0.05) - 2023/03/31 20:38:17
Table 'NLHBlue87' 6-max Seat #2 is the button
Seat 1: c9de55a8 ($4.57 in chips)
Seat 2: c5631b86 ($5.63 in chips)
Seat 3: Hero ($7.47 in chips)
Seat 4: 68beb82 ($5 in chips)
Seat 5: ebe9ff0f ($6.32 in chips)
Seat 6: 32b2445a ($15.94 in chips)
Hero: posts small blind $0.02
68beb82: posts big blind $0.05
*** HOLE CARDS ***
Dealt to c9de55a8 
Dealt to c5631b86 
Dealt to Hero [Qh 8h]
Dealt to 68beb82 
Dealt to ebe9ff0f 
Dealt to 32b2445a 
ebe9ff0f: folds
32b2445a: calls $0.05
c9de55a8: folds
c5631b86: folds
Hero: calls $0.03
68beb82: checks
*** FLOP *** [Jh Th Ad]
Hero: bets $0.12
68beb82: folds
32b2445a: calls $0.12
*** TURN *** [Jh Th Ad] [Js]
Hero: bets $0.3
32b2445a: folds
Uncalled bet ($0.3) returned to Hero
*** SHOWDOWN ***
Hero collected $0.37 from pot
*** SUMMARY ***
Total pot $0.39 | Rake $0.02 | Jackpot $0 | Bingo $0 | Fortune $0
Board [Jh Th Ad Js]
Seat 1: c9de55a8 folded before Flop (didn't bet)
Seat 2: c5631b86 (button) folded before Flop (didn't bet)
Seat 3: Hero (small blind) won ($0.37)
Seat 4: 68beb82 (big blind) folded on the Flop
Seat 5: ebe9ff0f folded before Flop (didn't bet)
Seat 6: 32b2445a folded on the Turn


Poker Hand #HD1183895493: Hold'em No Limit  ($0.02/$0.05) - 2023/03/31 20:37:39
Table 'NLHBlue87' 6-max Seat #1 is the button
Seat 1: c9de55a8 ($4.57 in chips)
Seat 2: c5631b86 ($5.16 in chips)
Seat 3: Hero ($7.99 in chips)
Seat 5: ebe9ff0f ($6.32 in chips)
Seat 6: 32b2445a ($15.94 in chips)
c5631b86: posts small blind $0.02
Hero: posts big blind $0.05
*** HOLE CARDS ***
Dealt to c9de55a8 
Dealt to c5631b86 
Dealt to Hero [Qs Ad]
Dealt to ebe9ff0f 
Dealt to 32b2445a 
ebe9ff0f: folds
32b2445a: folds
c9de55a8: folds
c5631b86: raises $0.08 to $0.13
Hero: raises $0.39 to $0.52
c5631b86: raises $0.63 to $1.15
Hero: folds
Uncalled bet ($0.63) returned to c5631b86
*** SHOWDOWN ***
c5631b86 collected $0.99 from pot
*** SUMMARY ***
Total pot $1.04 | Rake $0.05 | Jackpot $0 | Bingo $0 | Fortune $0
Seat 1: c9de55a8 (button) folded before Flop (didn't bet)
Seat 2: c5631b86 (small blind) collected ($0.99)
Seat 3: Hero (big blind) folded before Flop
Seat 5: ebe9ff0f folded before Flop (didn't bet)
Seat 6: 32b2445a folded before Flop (didn't bet)


Poker Hand #HD1183895406: Hold'em No Limit  ($0.02/$0.05) - 2023/03/31 20:37:01
Table 'NLHBlue87' 6-max Seat #6 is the button
Seat 1: c9de55a8 ($4.08 in chips)
Seat 2: c5631b86 ($5.21 in chips)
Seat 3: Hero ($7.99 in chips)
Seat 5: ebe9ff0f ($6.67 in chips)
Seat 6: 32b2445a ($16.07 in chips)
c9de55a8: posts small blind $0.02
c5631b86: posts big blind $0.05
*** HOLE CARDS ***
Dealt to c9de55a8 
Dealt to c5631b86 
Dealt to Hero [6d 5c]
Dealt to ebe9ff0f 
Dealt to 32b2445a 
Hero: folds
ebe9ff0f: raises $0.08 to $0.13
32b2445a: calls $0.13
c9de55a8: calls $0.11
c5631b86: folds
*** FLOP *** [5h 9s Ac]
c9de55a8: checks
ebe9ff0f: checks
32b2445a: checks
*** TURN *** [5h 9s Ac] [4d]
c9de55a8: bets $0.22
ebe9ff0f: calls $0.22
32b2445a: folds
*** RIVER *** [5h 9s Ac 4d] [Qc]
c9de55a8: bets $0.88
ebe9ff0f: folds
Uncalled bet ($0.88) returned to c9de55a8
c9de55a8: shows [As 9h] (Pair of Aces and Pair of Nines)
*** SHOWDOWN ***
c9de55a8 collected $0.84 from pot
*** SUMMARY ***
Total pot $0.88 | Rake $0.04 | Jackpot $0 | Bingo $0 | Fortune $0
Board [5h 9s Ac 4d Qc]
Seat 1: c9de55a8 (small blind) showed [As 9h] and won ($0.84) with Pair of Aces and Pair of Nines
Seat 2: c5631b86 (big blind) folded before Flop
Seat 3: Hero folded before Flop (didn't bet)
Seat 5: ebe9ff0f folded on the River
Seat 6: 32b2445a (button) folded on the Turn


Poker Hand #HD1183895338: Hold'em No Limit  ($0.02/$0.05) - 2023/03/31 20:36:33
Table 'NLHBlue87' 6-max Seat #5 is the button
Seat 1: c9de55a8 ($4.13 in chips)
Seat 2: c5631b86 ($5 in chips)
Seat 3: Hero ($7.99 in chips)
Seat 5: ebe9ff0f ($6.82 in chips)
Seat 6: 32b2445a ($16.09 in chips)
32b2445a: posts small blind $0.02
c9de55a8: posts big blind $0.05
*** HOLE CARDS ***
Dealt to c9de55a8 
Dealt to c5631b86 
Dealt to Hero [7s 9d]
Dealt to ebe9ff0f 
Dealt to 32b2445a 
c5631b86: raises $0.1 to $0.15
Hero: folds
ebe9ff0f: calls $0.15
32b2445a: folds
c9de55a8: folds
*** FLOP *** [3d 3h 6d]
c5631b86: bets $0.19
ebe9ff0f: folds
Uncalled bet ($0.19) returned to c5631b86
*** SHOWDOWN ***
c5631b86 collected $0.36 from pot
*** SUMMARY ***
Total pot $0.37 | Rake $0.01 | Jackpot $0 | Bingo $0 | Fortune $0
Board [3d 3h 6d]
Seat 1: c9de55a8 (big blind) folded before Flop
Seat 2: c5631b86 won ($0.36)
Seat 3: Hero folded before Flop (didn't bet)
Seat 5: ebe9ff0f (button) folded on the Flop
Seat 6: 32b2445a (small blind) folded before Flop


Poker Hand #HD1183895180: Hold'em No Limit  ($0.02/$0.05) - 2023/03/31 20:35:34
Table 'NLHBlue87' 6-max Seat #3 is the button
Seat 1: c9de55a8 ($4.13 in chips)
Seat 2: c5631b86 ($5.21 in chips)
Seat 3: Hero ($7.99 in chips)
Seat 5: ebe9ff0f ($6.84 in chips)
Seat 6: 32b2445a ($15.82 in chips)
ebe9ff0f: posts small blind $0.02
32b2445a: posts big blind $0.05
*** HOLE CARDS ***
Dealt to c9de55a8 
Dealt to c5631b86 
Dealt to Hero [3h 3d]
Dealt to ebe9ff0f 
Dealt to 32b2445a 
c9de55a8: folds
c5631b86: raises $0.08 to $0.13
Hero: folds
ebe9ff0f: folds
32b2445a: calls $0.08
*** FLOP *** [3c 7c Qh]
32b2445a: checks
c5631b86: bets $0.14
32b2445a: calls $0.14
*** TURN *** [3c 7c Qh] [2c]
32b2445a: checks
c5631b86: checks
*** RIVER *** [3c 7c Qh 2c] [4s]
32b2445a: bets $0.42
c5631b86: folds
Uncalled bet ($0.42) returned to 32b2445a
*** SHOWDOWN ***
32b2445a collected $0.54 from pot
*** SUMMARY ***
Total pot $0.56 | Rake $0.02 | Jackpot $0 | Bingo $0 | Fortune $0
Board [3c 7c Qh 2c 4s]
Seat 1: c9de55a8 folded before Flop (didn't bet)
Seat 2: c5631b86 folded on the River
Seat 3: Hero (button) folded before Flop (didn't bet)
Seat 5: ebe9ff0f (small blind) folded before Flop
Seat 6: 32b2445a (big blind) won ($0.54)


Poker Hand #HD1183895126: Hold'em No Limit  ($0.02/$0.05) - 2023/03/31 20:35:08
Table 'NLHBlue87' 6-max Seat #2 is the button
Seat 1: c9de55a8 ($4.13 in chips)
Seat 2: c5631b86 ($5 in chips)
Seat 3: Hero ($8.01 in chips)
Seat 5: ebe9ff0f ($6.89 in chips)
Seat 6: 32b2445a ($15.97 in chips)
Hero: posts small blind $0.02
ebe9ff0f: posts big blind $0.05
*** HOLE CARDS ***
Dealt to c9de55a8 
Dealt to c5631b86 
Dealt to Hero [As 9s]
Dealt to ebe9ff0f 
Dealt to 32b2445a 
32b2445a: raises $0.1 to $0.15
c9de55a8: folds
c5631b86: raises $0.3 to $0.45
Hero: folds
ebe9ff0f: folds
32b2445a: folds
Uncalled bet ($0.3) returned to c5631b86
*** SHOWDOWN ***
c5631b86 collected $0.36 from pot
*** SUMMARY ***
Total pot $0.37 | Rake $0.01 | Jackpot $0 | Bingo $0 | Fortune $0
Seat 1: c9de55a8 folded before Flop (didn't bet)
Seat 2: c5631b86 (button) collected ($0.36)
Seat 3: Hero (small blind) folded before Flop
Seat 5: ebe9ff0f (big blind) folded before Flop
Seat 6: 32b2445a folded before Flop


Poker Hand #HD1183895070: Hold'em No Limit  ($0.02/$0.05) - 2023/03/31 20:34:47
Table 'NLHBlue87' 6-max Seat #1 is the button
Seat 1: c9de55a8 ($4.13 in chips)
Seat 2: c5631b86 ($5.02 in chips)
Seat 3: Hero ($7.99 in chips)
Seat 4: 29e98354 ($5 in chips)
Seat 5: ebe9ff0f ($6.89 in chips)
Seat 6: 32b2445a ($15.97 in chips)
c5631b86: posts small blind $0.02
Hero: posts big blind $0.05
*** HOLE CARDS ***
Dealt to c9de55a8 
Dealt to c5631b86 
Dealt to Hero [2d Th]
Dealt to 29e98354 
Dealt to ebe9ff0f 
Dealt to 32b2445a 
29e98354: folds
ebe9ff0f: folds
32b2445a: folds
c9de55a8: folds
c5631b86: folds
Uncalled bet ($0.03) returned to Hero
*** SHOWDOWN ***
Hero collected $0.04 from pot
*** SUMMARY ***
Total pot $0.04 | Rake $0 | Jackpot $0 | Bingo $0 | Fortune $0
Seat 1: c9de55a8 (button) folded before Flop (didn't bet)
Seat 2: c5631b86 (small blind) folded before Flop
Seat 3: Hero (big blind) collected ($0.04)
Seat 4: 29e98354 folded before Flop (didn't bet)
Seat 5: ebe9ff0f folded before Flop (didn't bet)
Seat 6: 32b2445a folded before Flop (didn't bet)


Poker Hand #HD1183894961: Hold'em No Limit  ($0.02/$0.05) - 2023/03/31 20:33:57
Table 'NLHBlue87' 6-max Seat #6 is the button
Seat 1: c9de55a8 ($3.07 in chips)
Seat 2: c5631b86 ($5.07 in chips)
Seat 3: Hero ($9.16 in chips)
Seat 4: 29e98354 ($5 in chips)
Seat 5: ebe9ff0f ($6.89 in chips)
Seat 6: 32b2445a ($15.97 in chips)
c9de55a8: posts small blind $0.02
c5631b86: posts big blind $0.05
*** HOLE CARDS ***
Dealt to c9de55a8 
Dealt to c5631b86 
Dealt to Hero [Ts Tc]
Dealt to 29e98354 
Dealt to ebe9ff0f 
Dealt to 32b2445a 
Hero: raises $0.07 to $0.12
29e98354: folds
ebe9ff0f: folds
32b2445a: folds
c9de55a8: raises $0.15 to $0.27
c5631b86: folds
Hero: calls $0.15
*** FLOP *** [Ah 4s 5s]
c9de55a8: bets $0.3
Hero: calls $0.3
*** TURN *** [Ah 4s 5s] [9h]
c9de55a8: bets $0.6
Hero: calls $0.6
*** RIVER *** [Ah 4s 5s 9h] [3d]
c9de55a8: checks
Hero: checks
c9de55a8: shows [Kc Ac] (Pair of Aces)
Hero: shows [Ts Tc] (Pair of Tens)
*** SHOWDOWN ***
c9de55a8 collected $2.23 from pot
*** SUMMARY ***
Total pot $2.39 | Rake $0.11 | Jackpot $0.05 | Bingo $0 | Fortune $0
Board [Ah 4s 5s 9h 3d]
Seat 1: c9de55a8 (small blind) showed [Kc Ac] and won ($2.23) with Pair of Aces
Seat 2: c5631b86 (big blind) folded before Flop
Seat 3: Hero showed [Ts Tc] and lost with Pair of Tens
Seat 4: 29e98354 folded before Flop (didn't bet)
Seat 5: ebe9ff0f folded before Flop (didn't bet)
Seat 6: 32b2445a (button) folded before Flop (didn't bet)


Poker Hand #HD1183894661: Hold'em No Limit  ($0.02/$0.05) - 2023/03/31 20:31:54
Table 'NLHBlue87' 6-max Seat #5 is the button
Seat 1: c9de55a8 ($5.88 in chips)
Seat 2: c5631b86 ($5.07 in chips)
Seat 3: Hero ($9.28 in chips)
Seat 4: 29e98354 ($7.27 in chips)
Seat 5: ebe9ff0f ($6.89 in chips)
Seat 6: 32b2445a ($10.7 in chips)
32b2445a: posts small blind $0.02
c9de55a8: posts big blind $0.05
*** HOLE CARDS ***
Dealt to c9de55a8 
Dealt to c5631b86 
Dealt to Hero [Ks Jh]
Dealt to 29e98354 
Dealt to ebe9ff0f 
Dealt to 32b2445a 
c5631b86: folds
Hero: raises $0.07 to $0.12
29e98354: calls $0.12
ebe9ff0f: folds
32b2445a: raises $0.41 to $0.53
c9de55a8: calls $0.48
Hero: folds
29e98354: calls $0.41
*** FLOP *** [Qs Jd 8s]
32b2445a: bets $0.86
c9de55a8: calls $0.86
29e98354: calls $0.86
*** TURN *** [Qs Jd 8s] [8h]
32b2445a: checks
c9de55a8: checks
29e98354: checks
*** RIVER *** [Qs Jd 8s 8h] [4c]
32b2445a: checks
c9de55a8: bets $1.42
29e98354: calls $1.42
32b2445a: calls $1.42
c9de55a8: shows [Ts 7s] (Pair of Eights)
29e98354: shows [Qd Kd] (Pair of Queens and Pair of Eights)
32b2445a: shows [Qh Ad] (Pair of Queens and Pair of Eights)
*** SHOWDOWN ***
32b2445a collected $8.08 from pot
*** SUMMARY ***
Total pot $8.55 | Rake $0.42 | Jackpot $0.05 | Bingo $0 | Fortune $0
Board [Qs Jd 8s 8h 4c]
Seat 1: c9de55a8 (big blind) showed [Ts 7s] and lost with Pair of Eights
Seat 2: c5631b86 folded before Flop (didn't bet)
Seat 3: Hero folded before Flop
Seat 4: 29e98354 showed [Qd Kd] and lost with Pair of Queens and Pair of Eights
Seat 5: ebe9ff0f (button) folded before Flop (didn't bet)
Seat 6: 32b2445a (small blind) showed [Qh Ad] and won ($8.08) with Pair of Queens and Pair of Eights


Poker Hand #HD1183894609: Hold'em No Limit  ($0.02/$0.05) - 2023/03/31 20:31:34
Table 'NLHBlue87' 6-max Seat #4 is the button
Seat 1: c9de55a8 ($5.88 in chips)
Seat 2: c5631b86 ($5 in chips)
Seat 3: Hero ($9.28 in chips)
Seat 4: 29e98354 ($7.27 in chips)
Seat 5: ebe9ff0f ($6.91 in chips)
Seat 6: 32b2445a ($10.75 in chips)
ebe9ff0f: posts small blind $0.02
32b2445a: posts big blind $0.05
*** HOLE CARDS ***
Dealt to c9de55a8 
Dealt to c5631b86 
Dealt to Hero [Qd 6s]
Dealt to 29e98354 
Dealt to ebe9ff0f 
Dealt to 32b2445a 
c9de55a8: folds
c5631b86: raises $0.1 to $0.15
Hero: folds
29e98354: folds
ebe9ff0f: folds
32b2445a: folds
Uncalled bet ($0.1) returned to c5631b86
*** SHOWDOWN ***
c5631b86 collected $0.12 from pot
*** SUMMARY ***
Total pot $0.12 | Rake $0 | Jackpot $0 | Bingo $0 | Fortune $0
Seat 1: c9de55a8 folded before Flop (didn't bet)
Seat 2: c5631b86 collected ($0.12)
Seat 3: Hero folded before Flop (didn't bet)
Seat 4: 29e98354 (button) folded before Flop (didn't bet)
Seat 5: ebe9ff0f (small blind) folded before Flop
Seat 6: 32b2445a (big blind) folded before Flop


Poker Hand #HD1183894466: Hold'em No Limit  ($0.02/$0.05) - 2023/03/31 20:30:39
Table 'NLHBlue87' 6-max Seat #3 is the button
Seat 1: c9de55a8 ($5.15 in chips)
Seat 2: c5631b86 ($5.14 in chips)
Seat 3: Hero ($9.28 in chips)
Seat 4: 29e98354 ($7.29 in chips)
Seat 5: ebe9ff0f ($6.96 in chips)
Seat 6: 32b2445a ($10.75 in chips)
29e98354: posts small blind $0.02
ebe9ff0f: posts big blind $0.05
*** HOLE CARDS ***
Dealt to c9de55a8 
Dealt to c5631b86 
Dealt to Hero [9c Qd]
Dealt to 29e98354 
Dealt to ebe9ff0f 
Dealt to 32b2445a 
32b2445a: folds
c9de55a8: raises $0.1 to $0.15
c5631b86: raises $0.3 to $0.45
Hero: folds
29e98354: folds
ebe9ff0f: folds
c9de55a8: raises $0.33 to $0.78
c5631b86: calls $0.33
*** FLOP *** [5c Jd 2h]
c9de55a8: bets $0.54
c5631b86: folds
Uncalled bet ($0.54) returned to c9de55a8
*** SHOWDOWN ***
c9de55a8 collected $1.51 from pot
*** SUMMARY ***
Total pot $1.63 | Rake $0.07 | Jackpot $0.05 | Bingo $0 | Fortune $0
Board [5c Jd 2h]
Seat 1: c9de55a8 won ($1.51)
Seat 2: c5631b86 folded on the Flop
Seat 3: Hero (button) folded before Flop (didn't bet)
Seat 4: 29e98354 (small blind) folded before Flop
Seat 5: ebe9ff0f (big blind) folded before Flop
Seat 6: 32b2445a folded before Flop (didn't bet)


Poker Hand #HD1183894385: Hold'em No Limit  ($0.02/$0.05) - 2023/03/31 20:30:03
Table 'NLHBlue87' 6-max Seat #2 is the button
Seat 1: c9de55a8 ($5.15 in chips)
Seat 2: c5631b86 ($5 in chips)
Seat 3: Hero ($9.3 in chips)
Seat 4: 29e98354 ($7.42 in chips)
Seat 5: ebe9ff0f ($6.96 in chips)
Seat 6: 32b2445a ($10.75 in chips)
Hero: posts small blind $0.02
29e98354: posts big blind $0.05
*** HOLE CARDS ***
Dealt to c9de55a8 
Dealt to c5631b86 
Dealt to Hero [7d 4h]
Dealt to 29e98354 
Dealt to ebe9ff0f 
Dealt to 32b2445a 
ebe9ff0f: folds
32b2445a: folds
c9de55a8: folds
c5631b86: raises $0.08 to $0.13
Hero: folds
29e98354: calls $0.08
*** FLOP *** [2s 3d Jd]
29e98354: checks
c5631b86: bets $0.14
29e98354: folds
Uncalled bet ($0.14) returned to c5631b86
*** SHOWDOWN ***
c5631b86 collected $0.27 from pot
*** SUMMARY ***
Total pot $0.28 | Rake $0.01 | Jackpot $0 | Bingo $0 | Fortune $0
Board [2s 3d Jd]
Seat 1: c9de55a8 folded before Flop (didn't bet)
Seat 2: c5631b86 (button) won ($0.27)
Seat 3: Hero (small blind) folded before Flop
Seat 4: 29e98354 (big blind) folded on the Flop
Seat 5: ebe9ff0f folded before Flop (didn't bet)
Seat 6: 32b2445a folded before Flop (didn't bet)


Poker Hand #HD1183894349: Hold'em No Limit  ($0.02/$0.05) - 2023/03/31 20:29:50
Table 'NLHBlue87' 6-max Seat #1 is the button
Seat 1: c9de55a8 ($5.15 in chips)
Seat 2: c5631b86 ($5.02 in chips)
Seat 3: Hero ($9.28 in chips)
Seat 4: 29e98354 ($7.42 in chips)
Seat 5: ebe9ff0f ($6.96 in chips)
Seat 6: 32b2445a ($10.75 in chips)
c5631b86: posts small blind $0.02
Hero: posts big blind $0.05
*** HOLE CARDS ***
Dealt to c9de55a8 
Dealt to c5631b86 
Dealt to Hero [9s Ad]
Dealt to 29e98354 
Dealt to ebe9ff0f 
Dealt to 32b2445a 
29e98354: folds
ebe9ff0f: folds
32b2445a: folds
c9de55a8: folds
c5631b86: folds
Uncalled bet ($0.03) returned to Hero
*** SHOWDOWN ***
Hero collected $0.04 from pot
*** SUMMARY ***
Total pot $0.04 | Rake $0 | Jackpot $0 | Bingo $0 | Fortune $0
Seat 1: c9de55a8 (button) folded before Flop (didn't bet)
Seat 2: c5631b86 (small blind) folded before Flop
Seat 3: Hero (big blind) collected ($0.04)
Seat 4: 29e98354 folded before Flop (didn't bet)
Seat 5: ebe9ff0f folded before Flop (didn't bet)
Seat 6: 32b2445a folded before Flop (didn't bet)


Poker Hand #HD1183894255: Hold'em No Limit  ($0.02/$0.05) - 2023/03/31 20:29:09
Table 'NLHBlue87' 6-max Seat #6 is the button
Seat 1: c9de55a8 ($5.28 in chips)
Seat 2: c5631b86 ($5.07 in chips)
Seat 3: Hero ($9.28 in chips)
Seat 4: 29e98354 ($7.42 in chips)
Seat 5: ebe9ff0f ($6.79 in chips)
Seat 6: 32b2445a ($10.75 in chips)
c9de55a8: posts small blind $0.02
c5631b86: posts big blind $0.05
*** HOLE CARDS ***
Dealt to c9de55a8 
Dealt to c5631b86 
Dealt to Hero [3c Js]
Dealt to 29e98354 
Dealt to ebe9ff0f 
Dealt to 32b2445a 
Hero: folds
29e98354: folds
ebe9ff0f: raises $0.08 to $0.13
32b2445a: folds
c9de55a8: calls $0.11
c5631b86: folds
*** FLOP *** [2c 4c Kc]
c9de55a8: checks
ebe9ff0f: bets $0.14
c9de55a8: folds
Uncalled bet ($0.14) returned to ebe9ff0f
*** SHOWDOWN ***
ebe9ff0f collected $0.3 from pot
*** SUMMARY ***
Total pot $0.31 | Rake $0.01 | Jackpot $0 | Bingo $0 | Fortune $0
Board [2c 4c Kc]
Seat 1: c9de55a8 (small blind) folded on the Flop
Seat 2: c5631b86 (big blind) folded before Flop
Seat 3: Hero folded before Flop (didn't bet)
Seat 4: 29e98354 folded before Flop (didn't bet)
Seat 5: ebe9ff0f won ($0.3)
Seat 6: 32b2445a (button) folded before Flop (didn't bet)


Poker Hand #HD1183894206: Hold'em No Limit  ($0.02/$0.05) - 2023/03/31 20:28:44
Table 'NLHBlue87' 6-max Seat #5 is the button
Seat 1: c9de55a8 ($5.33 in chips)
Seat 2: c5631b86 ($5.07 in chips)
Seat 3: Hero ($9.21 in chips)
Seat 4: 29e98354 ($7.42 in chips)
Seat 5: ebe9ff0f ($6.79 in chips)
Seat 6: 32b2445a ($10.77 in chips)
32b2445a: posts small blind $0.02
c9de55a8: posts big blind $0.05
*** HOLE CARDS ***
Dealt to c9de55a8 
Dealt to c5631b86 
Dealt to Hero [Tc Th]
Dealt to 29e98354 
Dealt to ebe9ff0f 
Dealt to 32b2445a 
c5631b86: folds
Hero: raises $0.07 to $0.12
29e98354: folds
ebe9ff0f: folds
32b2445a: folds
c9de55a8: folds
Uncalled bet ($0.07) returned to Hero
*** SHOWDOWN ***
Hero collected $0.12 from pot
*** SUMMARY ***
Total pot $0.12 | Rake $0 | Jackpot $0 | Bingo $0 | Fortune $0
Seat 1: c9de55a8 (big blind) folded before Flop
Seat 2: c5631b86 folded before Flop (didn't bet)
Seat 3: Hero collected ($0.12)
Seat 4: 29e98354 folded before Flop (didn't bet)
Seat 5: ebe9ff0f (button) folded before Flop (didn't bet)
Seat 6: 32b2445a (small blind) folded before Flop


Poker Hand #HD1183894084: Hold'em No Limit  ($0.02/$0.05) - 2023/03/31 20:27:54
Table 'NLHBlue87' 6-max Seat #4 is the button
Seat 1: c9de55a8 ($5.33 in chips)
Seat 2: c5631b86 ($5.07 in chips)
Seat 3: Hero ($9.21 in chips)
Seat 4: 29e98354 ($7.15 in chips)
Seat 5: ebe9ff0f ($6.81 in chips)
Seat 6: 32b2445a ($11.04 in chips)
ebe9ff0f: posts small blind $0.02
32b2445a: posts big blind $0.05
*** HOLE CARDS ***
Dealt to c9de55a8 
Dealt to c5631b86 
Dealt to Hero [9h 7c]
Dealt to 29e98354 
Dealt to ebe9ff0f 
Dealt to 32b2445a 
c9de55a8: folds
c5631b86: folds
Hero: folds
29e98354: raises $0.08 to $0.13
ebe9ff0f: folds
32b2445a: calls $0.08
*** FLOP *** [2d 9d Ad]
32b2445a: checks
29e98354: checks
*** TURN *** [2d 9d Ad] [4h]
32b2445a: checks
29e98354: checks
*** RIVER *** [2d 9d Ad 4h] [As]
32b2445a: bets $0.14
29e98354: calls $0.14
32b2445a: shows [Jd Qc] (Pair of Aces)
29e98354: shows [9s Ks] (Pair of Aces and Pair of Nines)
*** SHOWDOWN ***
29e98354 collected $0.54 from pot
*** SUMMARY ***
Total pot $0.56 | Rake $0.02 | Jackpot $0 | Bingo $0 | Fortune $0
Board [2d 9d Ad 4h As]
Seat 1: c9de55a8 folded before Flop (didn't bet)
Seat 2: c5631b86 folded before Flop (didn't bet)
Seat 3: Hero folded before Flop (didn't bet)
Seat 4: 29e98354 (button) showed [9s Ks] and won ($0.54) with Pair of Aces and Pair of Nines
Seat 5: ebe9ff0f (small blind) folded before Flop
Seat 6: 32b2445a (big blind) showed [Jd Qc] and lost with Pair of Aces


Poker Hand #HD1183894033: Hold'em No Limit  ($0.02/$0.05) - 2023/03/31 20:27:35
Table 'NLHBlue87' 6-max Seat #3 is the button
Seat 1: c9de55a8 ($5.33 in chips)
Seat 2: c5631b86 ($5 in chips)
Seat 3: Hero ($9.21 in chips)
Seat 4: 29e98354 ($7.17 in chips)
Seat 5: ebe9ff0f ($6.86 in chips)
Seat 6: 32b2445a ($11.04 in chips)
29e98354: posts small blind $0.02
ebe9ff0f: posts big blind $0.05
*** HOLE CARDS ***
Dealt to c9de55a8 
Dealt to c5631b86 
Dealt to Hero [Jc Qh]
Dealt to 29e98354 
Dealt to ebe9ff0f 
Dealt to 32b2445a 
32b2445a: folds
c9de55a8: folds
c5631b86: raises $0.08 to $0.13
Hero: folds
29e98354: folds
ebe9ff0f: folds
Uncalled bet ($0.08) returned to c5631b86
*** SHOWDOWN ***
c5631b86 collected $0.12 from pot
*** SUMMARY ***
Total pot $0.12 | Rake $0 | Jackpot $0 | Bingo $0 | Fortune $0
Seat 1: c9de55a8 folded before Flop (didn't bet)
Seat 2: c5631b86 collected ($0.12)
Seat 3: Hero (button) folded before Flop (didn't bet)
Seat 4: 29e98354 (small blind) folded before Flop
Seat 5: ebe9ff0f (big blind) folded before Flop
Seat 6: 32b2445a folded before Flop (didn't bet)


Poker Hand #HD1183893948: Hold'em No Limit  ($0.02/$0.05) - 2023/03/31 20:26:53
Table 'NLHBlue87' 6-max Seat #2 is the button
Seat 1: c9de55a8 ($4.83 in chips)
Seat 2: c5631b86 ($5 in chips)
Seat 3: Hero ($9.23 in chips)
Seat 4: 29e98354 ($7.22 in chips)
Seat 5: ebe9ff0f ($7.34 in chips)
Seat 6: 32b2445a ($11.04 in chips)
Hero: posts small blind $0.02
29e98354: posts big blind $0.05
*** HOLE CARDS ***
Dealt to c9de55a8 
Dealt to c5631b86 
Dealt to Hero [Kd 7s]
Dealt to 29e98354 
Dealt to ebe9ff0f 
Dealt to 32b2445a 
ebe9ff0f: raises $0.08 to $0.13
32b2445a: folds
c9de55a8: calls $0.13
c5631b86: folds
Hero: folds
29e98354: folds
*** FLOP *** [Ts 5d 2c]
ebe9ff0f: bets $0.14
c9de55a8: raises $0.21 to $0.35
ebe9ff0f: calls $0.21
*** TURN *** [Ts 5d 2c] [Jc]
ebe9ff0f: checks
c9de55a8: bets $0.34
ebe9ff0f: folds
Uncalled bet ($0.34) returned to c9de55a8
*** SHOWDOWN ***
c9de55a8 collected $0.98 from pot
*** SUMMARY ***
Total pot $1.03 | Rake $0.05 | Jackpot $0 | Bingo $0 | Fortune $0
Board [Ts 5d 2c Jc]
Seat 1: c9de55a8 won ($0.98)
Seat 2: c5631b86 (button) folded before Flop (didn't bet)
Seat 3: Hero (small blind) folded before Flop
Seat 4: 29e98354 (big blind) folded before Flop
Seat 5: ebe9ff0f folded on the Turn
Seat 6: 32b2445a folded before Flop (didn't bet)


Poker Hand #HD1183893917: Hold'em No Limit  ($0.02/$0.05) - 2023/03/31 20:26:38
Table 'NLHBlue87' 6-max Seat #1 is the button
Seat 1: c9de55a8 ($4.76 in chips)
Seat 2: c5631b86 ($5 in chips)
Seat 3: Hero ($9.28 in chips)
Seat 4: 29e98354 ($7.22 in chips)
Seat 5: ebe9ff0f ($7.34 in chips)
Seat 6: 32b2445a ($11.04 in chips)
c5631b86: posts small blind $0.02
Hero: posts big blind $0.05
*** HOLE CARDS ***
Dealt to c9de55a8 
Dealt to c5631b86 
Dealt to Hero [Kc 3h]
Dealt to 29e98354 
Dealt to ebe9ff0f 
Dealt to 32b2445a 
29e98354: folds
ebe9ff0f: folds
32b2445a: folds
c9de55a8: raises $0.05 to $0.1
c5631b86: folds
Hero: folds
Uncalled bet ($0.05) returned to c9de55a8
*** SHOWDOWN ***
c9de55a8 collected $0.12 from pot
*** SUMMARY ***
Total pot $0.12 | Rake $0 | Jackpot $0 | Bingo $0 | Fortune $0
Seat 1: c9de55a8 (button) collected ($0.12)
Seat 2: c5631b86 (small blind) folded before Flop
Seat 3: Hero (big blind) folded before Flop
Seat 4: 29e98354 folded before Flop (didn't bet)
Seat 5: ebe9ff0f folded before Flop (didn't bet)
Seat 6: 32b2445a folded before Flop (didn't bet)


Poker Hand #HD1183893798: Hold'em No Limit  ($0.02/$0.05) - 2023/03/31 20:25:45
Table 'NLHBlue87' 6-max Seat #6 is the button
Seat 1: c9de55a8 ($4.78 in chips)
Seat 2: c5631b86 ($5.12 in chips)
Seat 3: Hero ($9.28 in chips)
Seat 4: 29e98354 ($7.22 in chips)
Seat 5: ebe9ff0f ($6.46 in chips)
Seat 6: 32b2445a ($11.04 in chips)
c9de55a8: posts small blind $0.02
c5631b86: posts big blind $0.05
*** HOLE CARDS ***
Dealt to c9de55a8 
Dealt to c5631b86 
Dealt to Hero [5s Ad]
Dealt to 29e98354 
Dealt to ebe9ff0f 
Dealt to 32b2445a 
Hero: folds
29e98354: folds
ebe9ff0f: raises $0.08 to $0.13
32b2445a: folds
c9de55a8: folds
c5631b86: raises $0.37 to $0.5
ebe9ff0f: calls $0.37
*** FLOP *** [Qc Tc Jd]
c5631b86: bets $0.51
ebe9ff0f: raises $1.02 to $1.53
c5631b86: folds
Uncalled bet ($1.02) returned to ebe9ff0f
*** SHOWDOWN ***
ebe9ff0f collected $1.89 from pot
*** SUMMARY ***
Total pot $2.04 | Rake $0.1 | Jackpot $0.05 | Bingo $0 | Fortune $0
Board [Qc Tc Jd]
Seat 1: c9de55a8 (small blind) folded before Flop
Seat 2: c5631b86 (big blind) folded on the Flop
Seat 3: Hero folded before Flop (didn't bet)
Seat 4: 29e98354 folded before Flop (didn't bet)
Seat 5: ebe9ff0f won ($1.89)
Seat 6: 32b2445a (button) folded before Flop (didn't bet)


Poker Hand #HD1183893698: Hold'em No Limit  ($0.02/$0.05) - 2023/03/31 20:25:02
Table 'NLHBlue87' 6-max Seat #5 is the button
Seat 1: c9de55a8 ($5.05 in chips)
Seat 2: c5631b86 ($5.12 in chips)
Seat 3: Hero ($9.28 in chips)
Seat 4: 29e98354 ($7.22 in chips)
Seat 5: ebe9ff0f ($6.19 in chips)
Seat 6: 32b2445a ($11.06 in chips)
32b2445a: posts small blind $0.02
c9de55a8: posts big blind $0.05
*** HOLE CARDS ***
Dealt to c9de55a8 
Dealt to c5631b86 
Dealt to Hero [Td Js]
Dealt to 29e98354 
Dealt to ebe9ff0f 
Dealt to 32b2445a 
c5631b86: folds
Hero: folds
29e98354: folds
ebe9ff0f: raises $0.08 to $0.13
32b2445a: folds
c9de55a8: calls $0.08
*** FLOP *** [8s Kh Ah]
c9de55a8: checks
ebe9ff0f: checks
*** TURN *** [8s Kh Ah] [8d]
c9de55a8: bets $0.14
ebe9ff0f: calls $0.14
*** RIVER *** [8s Kh Ah 8d] [4s]
c9de55a8: checks
ebe9ff0f: bets $0.46
c9de55a8: folds
Uncalled bet ($0.46) returned to ebe9ff0f
32b2445a: shows [8c Kd] (Eights Full over Kings)
*** SHOWDOWN ***
ebe9ff0f collected $0.54 from pot
*** SUMMARY ***
Total pot $0.56 | Rake $0.02 | Jackpot $0 | Bingo $0 | Fortune $0
Board [8s Kh Ah 8d 4s]
Seat 1: c9de55a8 (big blind) folded on the River
Seat 2: c5631b86 folded before Flop (didn't bet)
Seat 3: Hero folded before Flop (didn't bet)
Seat 4: 29e98354 folded before Flop (didn't bet)
Seat 5: ebe9ff0f (button) won ($0.54)
Seat 6: 32b2445a (small blind) folded before Flop


Poker Hand #HD1183893661: Hold'em No Limit  ($0.02/$0.05) - 2023/03/31 20:24:47
Table 'NLHBlue87' 6-max Seat #4 is the button
Seat 1: c9de55a8 ($5.05 in chips)
Seat 2: c5631b86 ($5.05 in chips)
Seat 3: Hero ($9.28 in chips)
Seat 4: 29e98354 ($7.22 in chips)
Seat 5: ebe9ff0f ($6.21 in chips)
Seat 6: 32b2445a ($11.11 in chips)
ebe9ff0f: posts small blind $0.02
32b2445a: posts big blind $0.05
*** HOLE CARDS ***
Dealt to c9de55a8 
Dealt to c5631b86 
Dealt to Hero [4s 5s]
Dealt to 29e98354 
Dealt to ebe9ff0f 
Dealt to 32b2445a 
c9de55a8: folds
c5631b86: raises $0.1 to $0.15
Hero: folds
29e98354: folds
ebe9ff0f: folds
32b2445a: folds
Uncalled bet ($0.1) returned to c5631b86
*** SHOWDOWN ***
c5631b86 collected $0.12 from pot
*** SUMMARY ***
Total pot $0.12 | Rake $0 | Jackpot $0 | Bingo $0 | Fortune $0
Seat 1: c9de55a8 folded before Flop (didn't bet)
Seat 2: c5631b86 collected ($0.12)
Seat 3: Hero folded before Flop (didn't bet)
Seat 4: 29e98354 (button) folded before Flop (didn't bet)
Seat 5: ebe9ff0f (small blind) folded before Flop
Seat 6: 32b2445a (big blind) folded before Flop


Poker Hand #HD1183893590: Hold'em No Limit  ($0.02/$0.05) - 2023/03/31 20:24:16
Table 'NLHBlue87' 6-max Seat #3 is the button
Seat 1: c9de55a8 ($5.15 in chips)
Seat 2: c5631b86 ($5.05 in chips)
Seat 3: Hero ($9.28 in chips)
Seat 4: 29e98354 ($7.24 in chips)
Seat 5: ebe9ff0f ($6.26 in chips)
Seat 6: 32b2445a ($10.95 in chips)
29e98354: posts small blind $0.02
ebe9ff0f: posts big blind $0.05
*** HOLE CARDS ***
Dealt to c9de55a8 
Dealt to c5631b86 
Dealt to Hero [5c 2d]
Dealt to 29e98354 
Dealt to ebe9ff0f 
Dealt to 32b2445a 
32b2445a: raises $0.05 to $0.1
c9de55a8: calls $0.1
c5631b86: folds
Hero: folds
29e98354: folds
ebe9ff0f: folds
*** FLOP *** [Js Ad Td]
32b2445a: bets $0.09
c9de55a8: folds
Uncalled bet ($0.09) returned to 32b2445a
*** SHOWDOWN ***
32b2445a collected $0.26 from pot
*** SUMMARY ***
Total pot $0.27 | Rake $0.01 | Jackpot $0 | Bingo $0 | Fortune $0
Board [Js Ad Td]
Seat 1: c9de55a8 folded on the Flop
Seat 2: c5631b86 folded before Flop (didn't bet)
Seat 3: Hero (button) folded before Flop (didn't bet)
Seat 4: 29e98354 (small blind) folded before Flop
Seat 5: ebe9ff0f (big blind) folded before Flop
Seat 6: 32b2445a won ($0.26)


Poker Hand #HD1183893547: Hold'em No Limit  ($0.02/$0.05) - 2023/03/31 20:23:59
Table 'NLHBlue87' 6-max Seat #2 is the button
Seat 1: c9de55a8 ($5.15 in chips)
Seat 2: c5631b86 ($5.05 in chips)
Seat 3: Hero ($9.23 in chips)
Seat 4: 29e98354 ($7.29 in chips)
Seat 5: ebe9ff0f ($6.26 in chips)
Seat 6: 32b2445a ($10.95 in chips)
Hero: posts small blind $0.02
29e98354: posts big blind $0.05
*** HOLE CARDS ***
Dealt to c9de55a8 
Dealt to c5631b86 
Dealt to Hero [Jc Kd]
Dealt to 29e98354 
Dealt to ebe9ff0f 
Dealt to 32b2445a 
ebe9ff0f: folds
32b2445a: folds
c9de55a8: folds
c5631b86: folds
Hero: raises $0.09 to $0.14
29e98354: folds
Uncalled bet ($0.09) returned to Hero
*** SHOWDOWN ***
Hero collected $0.1 from pot
*** SUMMARY ***
Total pot $0.1 | Rake $0 | Jackpot $0 | Bingo $0 | Fortune $0
Seat 1: c9de55a8 folded before Flop (didn't bet)
Seat 2: c5631b86 (button) folded before Flop (didn't bet)
Seat 3: Hero (small blind) collected ($0.1)
Seat 4: 29e98354 (big blind) folded before Flop
Seat 5: ebe9ff0f folded before Flop (didn't bet)
Seat 6: 32b2445a folded before Flop (didn't bet)


Poker Hand #HD1183893502: Hold'em No Limit  ($0.02/$0.05) - 2023/03/31 20:23:40
Table 'NLHBlue87' 6-max Seat #1 is the button
Seat 1: c9de55a8 ($5.15 in chips)
Seat 2: c5631b86 ($5 in chips)
Seat 3: Hero ($9.28 in chips)
Seat 4: 29e98354 ($7.29 in chips)
Seat 5: ebe9ff0f ($6.26 in chips)
Seat 6: 32b2445a ($10.95 in chips)
c5631b86: posts small blind $0.02
Hero: posts big blind $0.05
*** HOLE CARDS ***
Dealt to c9de55a8 
Dealt to c5631b86 
Dealt to Hero [4d 9h]
Dealt to 29e98354 
Dealt to ebe9ff0f 
Dealt to 32b2445a 
29e98354: folds
ebe9ff0f: folds
32b2445a: folds
c9de55a8: folds
c5631b86: raises $0.08 to $0.13
Hero: folds
Uncalled bet ($0.08) returned to c5631b86
*** SHOWDOWN ***
c5631b86 collected $0.1 from pot
*** SUMMARY ***
Total pot $0.1 | Rake $0 | Jackpot $0 | Bingo $0 | Fortune $0
Seat 1: c9de55a8 (button) folded before Flop (didn't bet)
Seat 2: c5631b86 (small blind) collected ($0.1)
Seat 3: Hero (big blind) folded before Flop
Seat 4: 29e98354 folded before Flop (didn't bet)
Seat 5: ebe9ff0f folded before Flop (didn't bet)
Seat 6: 32b2445a folded before Flop (didn't bet)


Poker Hand #HD1183893455: Hold'em No Limit  ($0.02/$0.05) - 2023/03/31 20:23:18
Table 'NLHBlue87' 6-max Seat #6 is the button
Seat 1: c9de55a8 ($5.17 in chips)
Seat 2: c5631b86 ($5 in chips)
Seat 3: Hero ($9.28 in chips)
Seat 4: 29e98354 ($7.29 in chips)
Seat 5: ebe9ff0f ($6.19 in chips)
Seat 6: 32b2445a ($10.95 in chips)
c9de55a8: posts small blind $0.02
c5631b86: posts big blind $0.05
*** HOLE CARDS ***
Dealt to c9de55a8 
Dealt to c5631b86 
Dealt to Hero [9c Jh]
Dealt to 29e98354 
Dealt to ebe9ff0f 
Dealt to 32b2445a 
Hero: folds
29e98354: folds
ebe9ff0f: raises $0.08 to $0.13
32b2445a: folds
c9de55a8: folds
c5631b86: folds
Uncalled bet ($0.08) returned to ebe9ff0f
*** SHOWDOWN ***
ebe9ff0f collected $0.12 from pot
*** SUMMARY ***
Total pot $0.12 | Rake $0 | Jackpot $0 | Bingo $0 | Fortune $0
Seat 1: c9de55a8 (small blind) folded before Flop
Seat 2: c5631b86 (big blind) folded before Flop
Seat 3: Hero folded before Flop (didn't bet)
Seat 4: 29e98354 folded before Flop (didn't bet)
Seat 5: ebe9ff0f collected ($0.12)
Seat 6: 32b2445a (button) folded before Flop (didn't bet)


Poker Hand #HD1183893343: Hold'em No Limit  ($0.02/$0.05) - 2023/03/31 20:22:25
Table 'NLHBlue87' 6-max Seat #5 is the button
Seat 1: c9de55a8 ($4.94 in chips)
Seat 3: Hero ($9.28 in chips)
Seat 4: 29e98354 ($7.29 in chips)
Seat 5: ebe9ff0f ($6.42 in chips)
Seat 6: 32b2445a ($10.97 in chips)
32b2445a: posts small blind $0.02
c9de55a8: posts big blind $0.05
*** HOLE CARDS ***
Dealt to c9de55a8 
Dealt to Hero [7s Td]
Dealt to 29e98354 
Dealt to ebe9ff0f 
Dealt to 32b2445a 
Hero: folds
29e98354: folds
ebe9ff0f: raises $0.08 to $0.13
32b2445a: folds
c9de55a8: calls $0.08
*** FLOP *** [8h 5d 4s]
c9de55a8: checks
ebe9ff0f: bets $0.1
c9de55a8: calls $0.1
*** TURN *** [8h 5d 4s] [Jc]
c9de55a8: checks
ebe9ff0f: checks
*** RIVER *** [8h 5d 4s Jc] [6s]
c9de55a8: bets $0.36
ebe9ff0f: folds
Uncalled bet ($0.36) returned to c9de55a8
*** SHOWDOWN ***
c9de55a8 collected $0.46 from pot
*** SUMMARY ***
Total pot $0.48 | Rake $0.02 | Jackpot $0 | Bingo $0 | Fortune $0
Board [8h 5d 4s Jc 6s]
Seat 1: c9de55a8 (big blind) won ($0.46)
Seat 3: Hero folded before Flop (didn't bet)
Seat 4: 29e98354 folded before Flop (didn't bet)
Seat 5: ebe9ff0f (button) folded on the River
Seat 6: 32b2445a (small blind) folded before Flop


Poker Hand #HD1183893262: Hold'em No Limit  ($0.02/$0.05) - 2023/03/31 20:21:54
Table 'NLHBlue87' 6-max Seat #4 is the button
Seat 1: c9de55a8 ($4.94 in chips)
Seat 3: Hero ($9.28 in chips)
Seat 4: 29e98354 ($7.42 in chips)
Seat 5: ebe9ff0f ($6.25 in chips)
Seat 6: 32b2445a ($11.02 in chips)
ebe9ff0f: posts small blind $0.02
32b2445a: posts big blind $0.05
*** HOLE CARDS ***
Dealt to c9de55a8 
Dealt to Hero [Kc 7h]
Dealt to 29e98354 
Dealt to ebe9ff0f 
Dealt to 32b2445a 
c9de55a8: folds
Hero: folds
29e98354: raises $0.08 to $0.13
ebe9ff0f: raises $0.43 to $0.56
32b2445a: folds
29e98354: folds
Uncalled bet ($0.43) returned to ebe9ff0f
*** SHOWDOWN ***
ebe9ff0f collected $0.3 from pot
*** SUMMARY ***
Total pot $0.31 | Rake $0.01 | Jackpot $0 | Bingo $0 | Fortune $0
Seat 1: c9de55a8 folded before Flop (didn't bet)
Seat 3: Hero folded before Flop (didn't bet)
Seat 4: 29e98354 (button) folded before Flop
Seat 5: ebe9ff0f (small blind) collected ($0.3)
Seat 6: 32b2445a (big blind) folded before Flop


Poker Hand #HD1183893162: Hold'em No Limit  ($0.02/$0.05) - 2023/03/31 20:21:08
Table 'NLHBlue87' 6-max Seat #3 is the button
Seat 1: c9de55a8 ($4.94 in chips)
Seat 2: b58c73f7 ($2.66 in chips)
Seat 3: Hero ($9.28 in chips)
Seat 4: 29e98354 ($5.02 in chips)
Seat 5: ebe9ff0f ($6.3 in chips)
Seat 6: 32b2445a ($11.02 in chips)
29e98354: posts small blind $0.02
ebe9ff0f: posts big blind $0.05
*** HOLE CARDS ***
Dealt to c9de55a8 
Dealt to b58c73f7 
Dealt to Hero [Qh 2d]
Dealt to 29e98354 
Dealt to ebe9ff0f 
Dealt to 32b2445a 
32b2445a: folds
c9de55a8: folds
b58c73f7: raises $0.05 to $0.1
Hero: folds
29e98354: raises $0.19 to $0.29
ebe9ff0f: folds
b58c73f7: calls $0.19
*** FLOP *** [Qc Kc Ts]
29e98354: bets $0.48
b58c73f7: raises $1.89 to $2.37 and is all-in
29e98354: calls $1.89
b58c73f7: shows [4h Kh] (Pair of Kings)
29e98354: shows [Jh Ks] (Pair of Kings)
*** TURN *** [Qc Kc Ts] [5d]
*** RIVER *** [Qc Kc Ts 5d] [9d]
*** SHOWDOWN ***
29e98354 collected $5.06 from pot
*** SUMMARY ***
Total pot $5.37 | Rake $0.26 | Jackpot $0.05 | Bingo $0 | Fortune $0
Board [Qc Kc Ts 5d 9d]
Seat 1: c9de55a8 folded before Flop (didn't bet)
Seat 2: b58c73f7 showed [4h Kh] and lost with Pair of Kings
Seat 3: Hero (button) folded before Flop (didn't bet)
Seat 4: 29e98354 (small blind) showed [Jh Ks] and won ($5.06) with Kings-High Straight
Seat 5: ebe9ff0f (big blind) folded before Flop
Seat 6: 32b2445a folded before Flop (didn't bet)


Poker Hand #HD1183893123: Hold'em No Limit  ($0.02/$0.05) - 2023/03/31 20:20:52
Table 'NLHBlue87' 6-max Seat #2 is the button
Seat 1: c9de55a8 ($4.94 in chips)
Seat 2: b58c73f7 ($2.66 in chips)
Seat 3: Hero ($9.3 in chips)
Seat 4: 29e98354 ($5 in chips)
Seat 5: ebe9ff0f ($6.3 in chips)
Seat 6: 32b2445a ($11.02 in chips)
Hero: posts small blind $0.02
29e98354: posts big blind $0.05
*** HOLE CARDS ***
Dealt to c9de55a8 
Dealt to b58c73f7 
Dealt to Hero [6c 4h]
Dealt to 29e98354 
Dealt to ebe9ff0f 
Dealt to 32b2445a 
ebe9ff0f: folds
32b2445a: folds
c9de55a8: folds
b58c73f7: folds
Hero: folds
Uncalled bet ($0.03) returned to 29e98354
*** SHOWDOWN ***
29e98354 collected $0.04 from pot
*** SUMMARY ***
Total pot $0.04 | Rake $0 | Jackpot $0 | Bingo $0 | Fortune $0
Seat 1: c9de55a8 folded before Flop (didn't bet)
Seat 2: b58c73f7 (button) folded before Flop (didn't bet)
Seat 3: Hero (small blind) folded before Flop
Seat 4: 29e98354 (big blind) collected ($0.04)
Seat 5: ebe9ff0f folded before Flop (didn't bet)
Seat 6: 32b2445a folded before Flop (didn't bet)


Poker Hand #HD1183892969: Hold'em No Limit  ($0.02/$0.05) - 2023/03/31 20:19:43
Table 'NLHBlue87' 6-max Seat #1 is the button
Seat 1: c9de55a8 ($5.04 in chips)
Seat 2: b58c73f7 ($2.76 in chips)
Seat 3: Hero ($9.02 in chips)
Seat 4: 29e98354 ($5 in chips)
Seat 5: ebe9ff0f ($6.3 in chips)
Seat 6: 32b2445a ($11.12 in chips)
b58c73f7: posts small blind $0.02
Hero: posts big blind $0.05
*** HOLE CARDS ***
Dealt to c9de55a8 
Dealt to b58c73f7 
Dealt to Hero [Jh 7h]
Dealt to 29e98354 
Dealt to ebe9ff0f 
Dealt to 32b2445a 
29e98354: folds
ebe9ff0f: folds
32b2445a: raises $0.05 to $0.1
c9de55a8: calls $0.1
b58c73f7: calls $0.08
Hero: calls $0.05
*** FLOP *** [Td Kd As]
b58c73f7: checks
Hero: checks
32b2445a: checks
c9de55a8: checks
*** TURN *** [Td Kd As] [2c]
b58c73f7: checks
Hero: checks
32b2445a: checks
c9de55a8: checks
*** RIVER *** [Td Kd As 2c] [Ad]
b58c73f7: checks
Hero: checks
32b2445a: checks
c9de55a8: checks
b58c73f7: shows [6d 5h] (Pair of Aces)
Hero: shows [Jh 7h] (Pair of Aces)
32b2445a: shows [7c 9c] (Pair of Aces)
c9de55a8: shows [7s 6c] (Pair of Aces)
*** SHOWDOWN ***
Hero collected $0.38 from pot
*** SUMMARY ***
Total pot $0.4 | Rake $0.02 | Jackpot $0 | Bingo $0 | Fortune $0
Board [Td Kd As 2c Ad]
Seat 1: c9de55a8 (button) showed [7s 6c] and lost with Pair of Aces
Seat 2: b58c73f7 (small blind) showed [6d 5h] and lost with Pair of Aces
Seat 3: Hero (big blind) showed [Jh 7h] and won ($0.38) with Pair of Aces
Seat 4: 29e98354 folded before Flop (didn't bet)
Seat 5: ebe9ff0f folded before Flop (didn't bet)
Seat 6: 32b2445a showed [7c 9c] and lost with Pair of Aces


Poker Hand #HD1183892877: Hold'em No Limit  ($0.02/$0.05) - 2023/03/31 20:19:07
Table 'NLHBlue87' 6-max Seat #6 is the button
Seat 1: c9de55a8 ($5.06 in chips)
Seat 2: b58c73f7 ($2.81 in chips)
Seat 3: Hero ($9.02 in chips)
Seat 4: 29e98354 ($5 in chips)
Seat 5: ebe9ff0f ($6.43 in chips)
Seat 6: 32b2445a ($10.93 in chips)
c9de55a8: posts small blind $0.02
b58c73f7: posts big blind $0.05
*** HOLE CARDS ***
Dealt to c9de55a8 
Dealt to b58c73f7 
Dealt to Hero [8d Kd]
Dealt to 29e98354 
Dealt to ebe9ff0f 
Dealt to 32b2445a 
Hero: folds
29e98354: folds
ebe9ff0f: raises $0.08 to $0.13
32b2445a: raises $0.33 to $0.46
c9de55a8: folds
b58c73f7: folds
ebe9ff0f: folds
Uncalled bet ($0.33) returned to 32b2445a
*** SHOWDOWN ***
32b2445a collected $0.32 from pot
*** SUMMARY ***
Total pot $0.33 | Rake $0.01 | Jackpot $0 | Bingo $0 | Fortune $0
Seat 1: c9de55a8 (small blind) folded before Flop
Seat 2: b58c73f7 (big blind) folded before Flop
Seat 3: Hero folded before Flop (didn't bet)
Seat 4: 29e98354 folded before Flop (didn't bet)
Seat 5: ebe9ff0f folded before Flop
Seat 6: 32b2445a (button) collected ($0.32)


Poker Hand #HD1183892780: Hold'em No Limit  ($0.02/$0.05) - 2023/03/31 20:18:27
Table 'NLHBlue87' 6-max Seat #5 is the button
Seat 1: c9de55a8 ($5.11 in chips)
Seat 2: b58c73f7 ($2.56 in chips)
Seat 3: Hero ($9.22 in chips)
Seat 4: 29e98354 ($5 in chips)
Seat 5: ebe9ff0f ($6.43 in chips)
Seat 6: 32b2445a ($10.95 in chips)
32b2445a: posts small blind $0.02
c9de55a8: posts big blind $0.05
*** HOLE CARDS ***
Dealt to c9de55a8 
Dealt to b58c73f7 
Dealt to Hero [Jc Ad]
Dealt to 29e98354 
Dealt to ebe9ff0f 
Dealt to 32b2445a 
b58c73f7: calls $0.05
Hero: raises $0.15 to $0.2
29e98354: folds
ebe9ff0f: folds
32b2445a: folds
c9de55a8: folds
b58c73f7: calls $0.15
*** FLOP *** [9h Th 6d]
b58c73f7: checks
Hero: checks
*** TURN *** [9h Th 6d] [5d]
b58c73f7: bets $0.16
Hero: folds
Uncalled bet ($0.16) returned to b58c73f7
*** SHOWDOWN ***
b58c73f7 collected $0.45 from pot
*** SUMMARY ***
Total pot $0.47 | Rake $0.02 | Jackpot $0 | Bingo $0 | Fortune $0
Board [9h Th 6d 5d]
Seat 1: c9de55a8 (big blind) folded before Flop
Seat 2: b58c73f7 won ($0.45)
Seat 3: Hero folded on the Turn
Seat 4: 29e98354 folded before Flop (didn't bet)
Seat 5: ebe9ff0f (button) folded before Flop (didn't bet)
Seat 6: 32b2445a (small blind) folded before Flop


Poker Hand #HD1183892673: Hold'em No Limit  ($0.02/$0.05) - 2023/03/31 20:17:40
Table 'NLHBlue87' 6-max Seat #4 is the button
Seat 1: c9de55a8 ($5.67 in chips)
Seat 2: b58c73f7 ($2.56 in chips)
Seat 3: Hero ($8.65 in chips)
Seat 4: 29e98354 ($5 in chips)
Seat 5: ebe9ff0f ($6.45 in chips)
Seat 6: 32b2445a ($11 in chips)
ebe9ff0f: posts small blind $0.02
32b2445a: posts big blind $0.05
*** HOLE CARDS ***
Dealt to c9de55a8 
Dealt to b58c73f7 
Dealt to Hero [Jc Js]
Dealt to 29e98354 
Dealt to ebe9ff0f 
Dealt to 32b2445a 
c9de55a8: raises $0.15 to $0.2
b58c73f7: folds
Hero: calls $0.2
29e98354: folds
ebe9ff0f: folds
32b2445a: folds
*** FLOP *** [Qs 3c Tc]
c9de55a8: checks
Hero: checks
*** TURN *** [Qs 3c Tc] [Qc]
c9de55a8: bets $0.36
Hero: calls $0.36
*** RIVER *** [Qs 3c Tc Qc] [Th]
c9de55a8: checks
Hero: checks
c9de55a8: shows [6c 6d] (Pair of Queens and Pair of Tens)
Hero: shows [Jc Js] (Pair of Queens and Pair of Jacks)
*** SHOWDOWN ***
Hero collected $1.13 from pot
*** SUMMARY ***
Total pot $1.19 | Rake $0.06 | Jackpot $0 | Bingo $0 | Fortune $0
Board [Qs 3c Tc Qc Th]
Seat 1: c9de55a8 showed [6c 6d] and lost with Pair of Queens and Pair of Tens
Seat 2: b58c73f7 folded before Flop (didn't bet)
Seat 3: Hero showed [Jc Js] and won ($1.13) with Pair of Queens and Pair of Jacks
Seat 4: 29e98354 (button) folded before Flop (didn't bet)
Seat 5: ebe9ff0f (small blind) folded before Flop
Seat 6: 32b2445a (big blind) folded before Flop


Poker Hand #HD1183892603: Hold'em No Limit  ($0.02/$0.05) - 2023/03/31 20:17:08
Table 'NLHBlue87' 6-max Seat #3 is the button
Seat 1: c9de55a8 ($5.67 in chips)
Seat 2: b58c73f7 ($2.49 in chips)
Seat 3: Hero ($8.65 in chips)
Seat 4: 29e98354 ($5 in chips)
Seat 5: ebe9ff0f ($6.5 in chips)
Seat 6: 32b2445a ($11 in chips)
29e98354: posts small blind $0.02
ebe9ff0f: posts big blind $0.05
*** HOLE CARDS ***
Dealt to c9de55a8 
Dealt to b58c73f7 
Dealt to Hero [Qs 8d]
Dealt to 29e98354 
Dealt to ebe9ff0f 
Dealt to 32b2445a 
32b2445a: folds
c9de55a8: folds
b58c73f7: calls $0.05
Hero: folds
29e98354: folds
ebe9ff0f: checks
*** FLOP *** [4s Jh Qc]
ebe9ff0f: checks
b58c73f7: bets $0.06
ebe9ff0f: folds
Uncalled bet ($0.06) returned to b58c73f7
*** SHOWDOWN ***
b58c73f7 collected $0.12 from pot
*** SUMMARY ***
Total pot $0.12 | Rake $0 | Jackpot $0 | Bingo $0 | Fortune $0
Board [4s Jh Qc]
Seat 1: c9de55a8 folded before Flop (didn't bet)
Seat 2: b58c73f7 won ($0.12)
Seat 3: Hero (button) folded before Flop (didn't bet)
Seat 4: 29e98354 (small blind) folded before Flop
Seat 5: ebe9ff0f (big blind) folded on the Flop
Seat 6: 32b2445a folded before Flop (didn't bet)


Poker Hand #HD1183892490: Hold'em No Limit  ($0.02/$0.05) - 2023/03/31 20:16:18
Table 'NLHBlue87' 6-max Seat #2 is the button
Seat 1: c9de55a8 ($5.67 in chips)
Seat 2: b58c73f7 ($2.83 in chips)
Seat 3: Hero ($8.67 in chips)
Seat 4: 29e98354 ($5 in chips)
Seat 5: ebe9ff0f ($6.5 in chips)
Seat 6: 32b2445a ($10.58 in chips)
Hero: posts small blind $0.02
29e98354: posts big blind $0.05
*** HOLE CARDS ***
Dealt to c9de55a8 
Dealt to b58c73f7 
Dealt to Hero [9d Ts]
Dealt to 29e98354 
Dealt to ebe9ff0f 
Dealt to 32b2445a 
ebe9ff0f: folds
32b2445a: raises $0.05 to $0.1
c9de55a8: folds
b58c73f7: calls $0.1
Hero: folds
29e98354: calls $0.05
*** FLOP *** [6h Kc 9s]
29e98354: checks
32b2445a: bets $0.24
b58c73f7: calls $0.24
29e98354: folds
*** TURN *** [6h Kc 9s] [Jc]
32b2445a: bets $0.6
b58c73f7: folds
Uncalled bet ($0.6) returned to 32b2445a
*** SHOWDOWN ***
32b2445a collected $0.76 from pot
*** SUMMARY ***
Total pot $0.8 | Rake $0.04 | Jackpot $0 | Bingo $0 | Fortune $0
Board [6h Kc 9s Jc]
Seat 1: c9de55a8 folded before Flop (didn't bet)
Seat 2: b58c73f7 (button) folded on the Turn
Seat 3: Hero (small blind) folded before Flop
Seat 4: 29e98354 (big blind) folded on the Flop
Seat 5: ebe9ff0f folded before Flop (didn't bet)
Seat 6: 32b2445a won ($0.76)


Poker Hand #HD1183892383: Hold'em No Limit  ($0.02/$0.05) - 2023/03/31 20:15:30
Table 'NLHBlue87' 6-max Seat #1 is the button
Seat 1: c9de55a8 ($6.61 in chips)
Seat 2: b58c73f7 ($1.98 in chips)
Seat 3: Hero ($8.72 in chips)
Seat 4: 29e98354 ($5 in chips)
Seat 5: ebe9ff0f ($6.5 in chips)
Seat 6: 32b2445a ($10.58 in chips)
b58c73f7: posts small blind $0.02
Hero: posts big blind $0.05
*** HOLE CARDS ***
Dealt to c9de55a8 
Dealt to b58c73f7 
Dealt to Hero [2s Ad]
Dealt to 29e98354 
Dealt to ebe9ff0f 
Dealt to 32b2445a 
29e98354: folds
ebe9ff0f: folds
32b2445a: folds
c9de55a8: raises $0.1 to $0.15
b58c73f7: raises $0.21 to $0.36
Hero: folds
c9de55a8: calls $0.21
*** FLOP *** [8d Kd 3c]
b58c73f7: checks
c9de55a8: bets $0.58
b58c73f7: raises $1.04 to $1.62 and is all-in
c9de55a8: folds
Uncalled bet ($1.04) returned to b58c73f7
*** SHOWDOWN ***
b58c73f7 collected $1.79 from pot
*** SUMMARY ***
Total pot $1.93 | Rake $0.09 | Jackpot $0.05 | Bingo $0 | Fortune $0
Board [8d Kd 3c]
Seat 1: c9de55a8 (button) folded on the Flop
Seat 2: b58c73f7 (small blind) won ($1.79)
Seat 3: Hero (big blind) folded before Flop
Seat 4: 29e98354 folded before Flop (didn't bet)
Seat 5: ebe9ff0f folded before Flop (didn't bet)
Seat 6: 32b2445a folded before Flop (didn't bet)


Poker Hand #HD1183892265: Hold'em No Limit  ($0.02/$0.05) - 2023/03/31 20:14:36
Table 'NLHBlue87' 6-max Seat #6 is the button
Seat 1: c9de55a8 ($6.63 in chips)
Seat 2: b58c73f7 ($0.99 in chips)
Seat 3: Hero ($8.72 in chips)
Seat 4: 29e98354 ($5 in chips)
Seat 5: ebe9ff0f ($6.63 in chips)
Seat 6: 32b2445a ($11.57 in chips)
c9de55a8: posts small blind $0.02
b58c73f7: posts big blind $0.05
*** HOLE CARDS ***
Dealt to c9de55a8 
Dealt to b58c73f7 
Dealt to Hero [Kc 2s]
Dealt to 29e98354 
Dealt to ebe9ff0f 
Dealt to 32b2445a 
Hero: folds
29e98354: folds
ebe9ff0f: raises $0.08 to $0.13
32b2445a: raises $0.25 to $0.38
c9de55a8: folds
b58c73f7: raises $0.61 to $0.99 and is all-in
ebe9ff0f: folds
32b2445a: calls $0.61
b58c73f7: shows [9h Th]
32b2445a: shows [Jd Js]
*** FLOP *** [7h Td 6c]
32b2445a: Chooses to EV Cashout 
*** TURN *** [7h Td 6c] [Kh]
32b2445a: Pays Cashout Risk ($0.33)
32b2445a: Chooses to EV Cashout 
*** RIVER *** [7h Td 6c Kh] [8c]
32b2445a: Receives Cashout ($0.33)
*** SHOWDOWN ***
b58c73f7 collected $1.98 from pot
*** SUMMARY ***
Total pot $2.13 | Rake $0.1 | Jackpot $0.05 | Bingo $0 | Fortune $0
Board [7h Td 6c Kh 8c]
Seat 1: c9de55a8 (small blind) folded before Flop
Seat 2: b58c73f7 (big blind) showed [9h Th] and won ($1.98) with Tens-High Straight
Seat 3: Hero folded before Flop (didn't bet)
Seat 4: 29e98354 folded before Flop (didn't bet)
Seat 5: ebe9ff0f folded before Flop
Seat 6: 32b2445a (button) showed [Jd Js] and lost with Pair of Jacks, Cashout Risk ($0.33), EV Cashout ($0)


Poker Hand #HD1183892136: Hold'em No Limit  ($0.02/$0.05) - 2023/03/31 20:13:44
Table 'NLHBlue87' 6-max Seat #5 is the button
Seat 1: c9de55a8 ($6.36 in chips)
Seat 2: b58c73f7 ($0.99 in chips)
Seat 3: Hero ($8.72 in chips)
Seat 4: 29e98354 ($5 in chips)
Seat 5: ebe9ff0f ($6.63 in chips)
Seat 6: 32b2445a ($11.87 in chips)
32b2445a: posts small blind $0.02
c9de55a8: posts big blind $0.05
*** HOLE CARDS ***
Dealt to c9de55a8 
Dealt to b58c73f7 
Dealt to Hero [5s 6d]
Dealt to 29e98354 
Dealt to ebe9ff0f 
Dealt to 32b2445a 
b58c73f7: folds
Hero: folds
29e98354: folds
ebe9ff0f: folds
32b2445a: raises $0.1 to $0.15
c9de55a8: calls $0.1
*** FLOP *** [9c 6c 4h]
32b2445a: bets $0.15
c9de55a8: raises $0.45 to $0.6
32b2445a: folds
Uncalled bet ($0.45) returned to c9de55a8
32b2445a: shows [9s]
*** SHOWDOWN ***
c9de55a8 collected $0.57 from pot
*** SUMMARY ***
Total pot $0.6 | Rake $0.03 | Jackpot $0 | Bingo $0 | Fortune $0
Board [9c 6c 4h]
Seat 1: c9de55a8 (big blind) won ($0.57)
Seat 2: b58c73f7 folded before Flop (didn't bet)
Seat 3: Hero folded before Flop (didn't bet)
Seat 4: 29e98354 folded before Flop (didn't bet)
Seat 5: ebe9ff0f (button) folded before Flop (didn't bet)
Seat 6: 32b2445a (small blind) folded on the Flop


Poker Hand #HD1183892027: Hold'em No Limit  ($0.02/$0.05) - 2023/03/31 20:12:54
Table 'NLHBlue87' 6-max Seat #4 is the button
Seat 1: c9de55a8 ($6.36 in chips)
Seat 2: b58c73f7 ($1.38 in chips)
Seat 3: Hero ($8.25 in chips)
Seat 4: 29e98354 ($5 in chips)
Seat 5: ebe9ff0f ($6.65 in chips)
Seat 6: 32b2445a ($11.97 in chips)
ebe9ff0f: posts small blind $0.02
32b2445a: posts big blind $0.05
*** HOLE CARDS ***
Dealt to c9de55a8 
Dealt to b58c73f7 
Dealt to Hero [7h 7c]
Dealt to 29e98354 
Dealt to ebe9ff0f 
Dealt to 32b2445a 
c9de55a8: folds
b58c73f7: raises $0.05 to $0.1
Hero: calls $0.1
29e98354: folds
ebe9ff0f: folds
32b2445a: calls $0.05
*** FLOP *** [4d Qh 2d]
32b2445a: checks
b58c73f7: bets $0.11
Hero: calls $0.11
32b2445a: folds
*** TURN *** [4d Qh 2d] [8s]
b58c73f7: bets $0.18
Hero: calls $0.18
*** RIVER *** [4d Qh 2d 8s] [Th]
b58c73f7: checks
Hero: checks
b58c73f7: shows [5h Ah] (Ace-High)
Hero: shows [7h 7c] (Pair of Sevens)
*** SHOWDOWN ***
Hero collected $0.86 from pot
*** SUMMARY ***
Total pot $0.9 | Rake $0.04 | Jackpot $0 | Bingo $0 | Fortune $0
Board [4d Qh 2d 8s Th]
Seat 1: c9de55a8 folded before Flop (didn't bet)
Seat 2: b58c73f7 showed [5h Ah] and lost with Ace-High
Seat 3: Hero showed [7h 7c] and won ($0.86) with Pair of Sevens
Seat 4: 29e98354 (button) folded before Flop (didn't bet)
Seat 5: ebe9ff0f (small blind) folded before Flop
Seat 6: 32b2445a (big blind) folded on the Flop


Poker Hand #HD1183891945: Hold'em No Limit  ($0.02/$0.05) - 2023/03/31 20:12:19
Table 'NLHBlue87' 6-max Seat #3 is the button
Seat 1: c9de55a8 ($6.36 in chips)
Seat 2: b58c73f7 ($1.31 in chips)
Seat 3: Hero ($8.25 in chips)
Seat 4: 29e98354 ($5 in chips)
Seat 5: ebe9ff0f ($6.7 in chips)
Seat 6: 32b2445a ($11.97 in chips)
29e98354: posts small blind $0.02
ebe9ff0f: posts big blind $0.05
*** HOLE CARDS ***
Dealt to c9de55a8 
Dealt to b58c73f7 
Dealt to Hero [Jc 3s]
Dealt to 29e98354 
Dealt to ebe9ff0f 
Dealt to 32b2445a 
32b2445a: folds
c9de55a8: folds
b58c73f7: calls $0.05
Hero: folds
29e98354: folds
ebe9ff0f: checks
*** FLOP *** [4d 7h 4c]
ebe9ff0f: checks
b58c73f7: checks
*** TURN *** [4d 7h 4c] [Qh]
ebe9ff0f: checks
b58c73f7: checks
*** RIVER *** [4d 7h 4c Qh] [Kh]
ebe9ff0f: checks
b58c73f7: bets $0.09
ebe9ff0f: folds
Uncalled bet ($0.09) returned to b58c73f7
*** SHOWDOWN ***
b58c73f7 collected $0.12 from pot
*** SUMMARY ***
Total pot $0.12 | Rake $0 | Jackpot $0 | Bingo $0 | Fortune $0
Board [4d 7h 4c Qh Kh]
Seat 1: c9de55a8 folded before Flop (didn't bet)
Seat 2: b58c73f7 won ($0.12)
Seat 3: Hero (button) folded before Flop (didn't bet)
Seat 4: 29e98354 (small blind) folded before Flop
Seat 5: ebe9ff0f (big blind) folded on the River
Seat 6: 32b2445a folded before Flop (didn't bet)


Poker Hand #HD1183891877: Hold'em No Limit  ($0.02/$0.05) - 2023/03/31 20:11:47
Table 'NLHBlue87' 6-max Seat #2 is the button
Seat 1: c9de55a8 ($6.36 in chips)
Seat 2: b58c73f7 ($1.79 in chips)
Seat 3: Hero ($7.77 in chips)
Seat 4: 29e98354 ($5 in chips)
Seat 5: ebe9ff0f ($6.7 in chips)
Seat 6: 32b2445a ($11.97 in chips)
Hero: posts small blind $0.02
29e98354: posts big blind $0.05
*** HOLE CARDS ***
Dealt to c9de55a8 
Dealt to b58c73f7 
Dealt to Hero [Qh Ah]
Dealt to 29e98354 
Dealt to ebe9ff0f 
Dealt to 32b2445a 
ebe9ff0f: folds
32b2445a: folds
c9de55a8: folds
b58c73f7: raises $0.05 to $0.1
Hero: raises $0.38 to $0.48
29e98354: folds
b58c73f7: calls $0.38
*** FLOP *** [6h Ts Jh]
Hero: bets $1.52
b58c73f7: folds
Uncalled bet ($1.52) returned to Hero
*** SHOWDOWN ***
Hero collected $0.96 from pot
*** SUMMARY ***
Total pot $1.01 | Rake $0.05 | Jackpot $0 | Bingo $0 | Fortune $0
Board [6h Ts Jh]
Seat 1: c9de55a8 folded before Flop (didn't bet)
Seat 2: b58c73f7 (button) folded on the Flop
Seat 3: Hero (small blind) won ($0.96)
Seat 4: 29e98354 (big blind) folded before Flop
Seat 5: ebe9ff0f folded before Flop (didn't bet)
Seat 6: 32b2445a folded before Flop (didn't bet)


Poker Hand #HD1183891790: Hold'em No Limit  ($0.02/$0.05) - 2023/03/31 20:11:01
Table 'NLHBlue87' 6-max Seat #1 is the button
Seat 1: c9de55a8 ($6.36 in chips)
Seat 2: b58c73f7 ($1.81 in chips)
Seat 3: Hero ($8.4 in chips)
Seat 4: 29e98354 ($5 in chips)
Seat 5: ebe9ff0f ($6.7 in chips)
Seat 6: 32b2445a ($11.38 in chips)
b58c73f7: posts small blind $0.02
Hero: posts big blind $0.05
*** HOLE CARDS ***
Dealt to c9de55a8 
Dealt to b58c73f7 
Dealt to Hero [9h Qc]
Dealt to 29e98354 
Dealt to ebe9ff0f 
Dealt to 32b2445a 
29e98354: folds
ebe9ff0f: folds
32b2445a: raises $0.1 to $0.15
c9de55a8: folds
b58c73f7: folds
Hero: calls $0.1
*** FLOP *** [Jh 6h Qs]
Hero: checks
32b2445a: bets $0.16
Hero: calls $0.16
*** TURN *** [Jh 6h Qs] [Ts]
Hero: checks
32b2445a: checks
*** RIVER *** [Jh 6h Qs Ts] [3c]
Hero: bets $0.32
32b2445a: calls $0.32
Hero: shows [9h Qc] (Pair of Queens)
32b2445a: shows [Ad Ac] (Pair of Aces)
*** SHOWDOWN ***
32b2445a collected $1.22 from pot
*** SUMMARY ***
Total pot $1.28 | Rake $0.06 | Jackpot $0 | Bingo $0 | Fortune $0
Board [Jh 6h Qs Ts 3c]
Seat 1: c9de55a8 (button) folded before Flop (didn't bet)
Seat 2: b58c73f7 (small blind) folded before Flop
Seat 3: Hero (big blind) showed [9h Qc] and lost with Pair of Queens
Seat 4: 29e98354 folded before Flop (didn't bet)
Seat 5: ebe9ff0f folded before Flop (didn't bet)
Seat 6: 32b2445a showed [Ad Ac] and won ($1.22) with Pair of Aces


Poker Hand #HD1183891739: Hold'em No Limit  ($0.02/$0.05) - 2023/03/31 20:10:39
Table 'NLHBlue87' 6-max Seat #6 is the button
Seat 1: c9de55a8 ($6.22 in chips)
Seat 2: b58c73f7 ($1.96 in chips)
Seat 3: Hero ($8.4 in chips)
Seat 4: 29e98354 ($5 in chips)
Seat 5: ebe9ff0f ($6.7 in chips)
Seat 6: 32b2445a ($11.38 in chips)
c9de55a8: posts small blind $0.02
b58c73f7: posts big blind $0.05
*** HOLE CARDS ***
Dealt to c9de55a8 
Dealt to b58c73f7 
Dealt to Hero [6h 2c]
Dealt to 29e98354 
Dealt to ebe9ff0f 
Dealt to 32b2445a 
Hero: folds
29e98354: folds
ebe9ff0f: folds
32b2445a: folds
c9de55a8: raises $0.1 to $0.15
b58c73f7: calls $0.1
*** FLOP *** [Kd 6c 8c]
c9de55a8: bets $0.23
b58c73f7: folds
Uncalled bet ($0.23) returned to c9de55a8
*** SHOWDOWN ***
c9de55a8 collected $0.29 from pot
*** SUMMARY ***
Total pot $0.3 | Rake $0.01 | Jackpot $0 | Bingo $0 | Fortune $0
Board [Kd 6c 8c]
Seat 1: c9de55a8 (small blind) won ($0.29)
Seat 2: b58c73f7 (big blind) folded on the Flop
Seat 3: Hero folded before Flop (didn't bet)
Seat 4: 29e98354 folded before Flop (didn't bet)
Seat 5: ebe9ff0f folded before Flop (didn't bet)
Seat 6: 32b2445a (button) folded before Flop (didn't bet)


Poker Hand #HD1183891719: Hold'em No Limit  ($0.02/$0.05) - 2023/03/31 20:10:28
Table 'NLHBlue87' 6-max Seat #5 is the button
Seat 1: c9de55a8 ($6.27 in chips)
Seat 2: b58c73f7 ($1.89 in chips)
Seat 3: Hero ($8.4 in chips)
Seat 4: 29e98354 ($5 in chips)
Seat 5: ebe9ff0f ($6.7 in chips)
Seat 6: 32b2445a ($11.4 in chips)
32b2445a: posts small blind $0.02
c9de55a8: posts big blind $0.05
*** HOLE CARDS ***
Dealt to c9de55a8 
Dealt to b58c73f7 
Dealt to Hero [Kc 6h]
Dealt to 29e98354 
Dealt to ebe9ff0f 
Dealt to 32b2445a 
b58c73f7: raises $0.1 to $0.15
Hero: folds
29e98354: folds
ebe9ff0f: folds
32b2445a: folds
c9de55a8: folds
Uncalled bet ($0.1) returned to b58c73f7
*** SHOWDOWN ***
b58c73f7 collected $0.12 from pot
*** SUMMARY ***
Total pot $0.12 | Rake $0 | Jackpot $0 | Bingo $0 | Fortune $0
Seat 1: c9de55a8 (big blind) folded before Flop
Seat 2: b58c73f7 collected ($0.12)
Seat 3: Hero folded before Flop (didn't bet)
Seat 4: 29e98354 folded before Flop (didn't bet)
Seat 5: ebe9ff0f (button) folded before Flop (didn't bet)
Seat 6: 32b2445a (small blind) folded before Flop


Poker Hand #HD1183891652: Hold'em No Limit  ($0.02/$0.05) - 2023/03/31 20:10:00
Table 'NLHBlue87' 6-max Seat #4 is the button
Seat 1: c9de55a8 ($6.27 in chips)
Seat 2: b58c73f7 ($1.78 in chips)
Seat 3: Hero ($8.4 in chips)
Seat 4: 29e98354 ($5 in chips)
Seat 5: ebe9ff0f ($6.72 in chips)
Seat 6: 32b2445a ($11.5 in chips)
ebe9ff0f: posts small blind $0.02
32b2445a: posts big blind $0.05
*** HOLE CARDS ***
Dealt to c9de55a8 
Dealt to b58c73f7 
Dealt to Hero [7s 9d]
Dealt to 29e98354 
Dealt to ebe9ff0f 
Dealt to 32b2445a 
c9de55a8: folds
b58c73f7: raises $0.05 to $0.1
Hero: folds
29e98354: folds
ebe9ff0f: folds
32b2445a: calls $0.05
*** FLOP *** [8h 2s Tc]
32b2445a: checks
b58c73f7: bets $0.1
32b2445a: folds
Uncalled bet ($0.1) returned to b58c73f7
*** SHOWDOWN ***
b58c73f7 collected $0.21 from pot
*** SUMMARY ***
Total pot $0.22 | Rake $0.01 | Jackpot $0 | Bingo $0 | Fortune $0
Board [8h 2s Tc]
Seat 1: c9de55a8 folded before Flop (didn't bet)
Seat 2: b58c73f7 won ($0.21)
Seat 3: Hero folded before Flop (didn't bet)
Seat 4: 29e98354 (button) folded before Flop (didn't bet)
Seat 5: ebe9ff0f (small blind) folded before Flop
Seat 6: 32b2445a (big blind) folded on the Flop


Poker Hand #HD1183891588: Hold'em No Limit  ($0.02/$0.05) - 2023/03/31 20:09:25
Table 'NLHBlue87' 6-max Seat #3 is the button
Seat 1: c9de55a8 ($5.92 in chips)
Seat 2: b58c73f7 ($1.83 in chips)
Seat 3: Hero ($8.55 in chips)
Seat 4: 29e98354 ($5 in chips)
Seat 5: ebe9ff0f ($6.87 in chips)
Seat 6: 32b2445a ($11.5 in chips)
29e98354: posts small blind $0.02
ebe9ff0f: posts big blind $0.05
b58c73f7: posts big blind $0.05
*** HOLE CARDS ***
Dealt to c9de55a8 
Dealt to b58c73f7 
Dealt to Hero [Td Ac]
Dealt to 29e98354 
Dealt to ebe9ff0f 
Dealt to 32b2445a 
32b2445a: folds
c9de55a8: raises $0.1 to $0.15
b58c73f7: folds
Hero: calls $0.15
29e98354: folds
ebe9ff0f: calls $0.1
*** FLOP *** [6s 4c Ks]
ebe9ff0f: checks
c9de55a8: bets $0.26
Hero: folds
ebe9ff0f: folds
Uncalled bet ($0.26) returned to c9de55a8
*** SHOWDOWN ***
c9de55a8 collected $0.5 from pot
*** SUMMARY ***
Total pot $0.52 | Rake $0.02 | Jackpot $0 | Bingo $0 | Fortune $0
Board [6s 4c Ks]
Seat 1: c9de55a8 won ($0.5)
Seat 2: b58c73f7 folded before Flop
Seat 3: Hero (button) folded on the Flop
Seat 4: 29e98354 (small blind) folded before Flop
Seat 5: ebe9ff0f (big blind) folded on the Flop
Seat 6: 32b2445a folded before Flop (didn't bet)


Poker Hand #HD1183891465: Hold'em No Limit  ($0.02/$0.05) - 2023/03/31 20:08:31
Table 'NLHBlue87' 6-max Seat #1 is the button
Seat 1: c9de55a8 ($5.18 in chips)
Seat 3: Hero ($9.37 in chips)
Seat 4: 29e98354 ($5 in chips)
Seat 5: ebe9ff0f ($6.87 in chips)
Seat 6: 32b2445a ($11.5 in chips)
Hero: posts small blind $0.02
29e98354: posts big blind $0.05
*** HOLE CARDS ***
Dealt to c9de55a8 
Dealt to Hero [Tc Jc]
Dealt to 29e98354 
Dealt to ebe9ff0f 
Dealt to 32b2445a 
ebe9ff0f: folds
32b2445a: folds
c9de55a8: raises $0.05 to $0.1
Hero: raises $0.38 to $0.48
29e98354: folds
c9de55a8: calls $0.38
*** FLOP *** [4h 8h 4d]
Hero: checks
c9de55a8: bets $0.34
Hero: calls $0.34
*** TURN *** [4h 8h 4d] [2d]
Hero: checks
c9de55a8: checks
*** RIVER *** [4h 8h 4d 2d] [7s]
Hero: checks
c9de55a8: checks
Hero: shows [Tc Jc] (Pair of Fours)
c9de55a8: shows [Qd Ks] (Pair of Fours)
*** SHOWDOWN ***
c9de55a8 collected $1.56 from pot
*** SUMMARY ***
Total pot $1.69 | Rake $0.08 | Jackpot $0.05 | Bingo $0 | Fortune $0
Board [4h 8h 4d 2d 7s]
Seat 1: c9de55a8 (button) showed [Qd Ks] and won ($1.56) with Pair of Fours
Seat 3: Hero (small blind) showed [Tc Jc] and lost with Pair of Fours
Seat 4: 29e98354 (big blind) folded before Flop
Seat 5: ebe9ff0f folded before Flop (didn't bet)
Seat 6: 32b2445a folded before Flop (didn't bet)


Poker Hand #HD1183891334: Hold'em No Limit  ($0.02/$0.05) - 2023/03/31 20:07:31
Table 'NLHBlue87' 6-max Seat #6 is the button
Seat 1: c9de55a8 ($5.36 in chips)
Seat 3: Hero ($9.42 in chips)
Seat 4: 29e98354 ($5 in chips)
Seat 5: ebe9ff0f ($6.87 in chips)
Seat 6: 32b2445a ($11.69 in chips)
c9de55a8: posts small blind $0.02
Hero: posts big blind $0.05
*** HOLE CARDS ***
Dealt to c9de55a8 
Dealt to Hero [5c 7d]
Dealt to 29e98354 
Dealt to ebe9ff0f 
Dealt to 32b2445a 
29e98354: raises $0.08 to $0.13
ebe9ff0f: folds
32b2445a: raises $0.25 to $0.38
c9de55a8: calls $0.36
Hero: folds
29e98354: folds
*** FLOP *** [Ad Th Kh]
c9de55a8: bets $0.47
32b2445a: raises $10.84 to $11.31 and is all-in
c9de55a8: calls $4.51 and is all-in
Uncalled bet ($6.33) returned to 32b2445a
32b2445a: shows [As Kd] (Pair of Aces and Pair of Kings)
c9de55a8: shows [Jc Qd] (Aces-High Straight)
*** FIRST TURN *** [Ad Th Kh] [Tc]
*** FIRST RIVER *** [Ad Th Kh Tc] [Td]
*** SECOND TURN *** [Ad Th Kh] [9d]
*** SECOND RIVER *** [Ad Th Kh 9d] [7h]
*** FIRST SHOWDOWN ***
32b2445a collected $5.17 from pot
*** SECOND SHOWDOWN ***
c9de55a8 collected $5.18 from pot
*** SUMMARY ***
Total pot $10.9 | Rake $0.5 | Jackpot $0.05 | Bingo $0 | Fortune $0
Hand was run two times
FIRST Board [Ad Th Kh Tc Td]
SECOND Board [9d 7h]
Seat 1: c9de55a8 (small blind) showed [Jc Qd] and lost with Aces-High Straight, and won ($5.18)
Seat 3: Hero (big blind) folded before Flop
Seat 4: 29e98354 folded before Flop
Seat 5: ebe9ff0f folded before Flop (didn't bet)
Seat 6: 32b2445a (button) showed [As Kd] and won ($5.17) with Tens Full over Aces, and lost


Poker Hand #HD1183891317: Hold'em No Limit  ($0.02/$0.05) - 2023/03/31 20:07:23
Table 'NLHBlue87' 6-max Seat #5 is the button
Seat 1: c9de55a8 ($5.34 in chips)
Seat 3: Hero ($9.42 in chips)
Seat 4: 29e98354 ($5 in chips)
Seat 5: ebe9ff0f ($6.87 in chips)
Seat 6: 32b2445a ($11.71 in chips)
32b2445a: posts small blind $0.02
c9de55a8: posts big blind $0.05
*** HOLE CARDS ***
Dealt to c9de55a8 
Dealt to Hero [9h 5s]
Dealt to 29e98354 
Dealt to ebe9ff0f 
Dealt to 32b2445a 
Hero: folds
29e98354: folds
ebe9ff0f: folds
32b2445a: folds
Uncalled bet ($0.03) returned to c9de55a8
*** SHOWDOWN ***
c9de55a8 collected $0.04 from pot
*** SUMMARY ***
Total pot $0.04 | Rake $0 | Jackpot $0 | Bingo $0 | Fortune $0
Seat 1: c9de55a8 (big blind) collected ($0.04)
Seat 3: Hero folded before Flop (didn't bet)
Seat 4: 29e98354 folded before Flop (didn't bet)
Seat 5: ebe9ff0f (button) folded before Flop (didn't bet)
Seat 6: 32b2445a (small blind) folded before Flop


Poker Hand #HD1183891293: Hold'em No Limit  ($0.02/$0.05) - 2023/03/31 20:07:12
Table 'NLHBlue87' 6-max Seat #4 is the button
Seat 1: c9de55a8 ($5.34 in chips)
Seat 3: Hero ($9.42 in chips)
Seat 4: 29e98354 ($5 in chips)
Seat 5: ebe9ff0f ($6.89 in chips)
Seat 6: 32b2445a ($11.69 in chips)
ebe9ff0f: posts small blind $0.02
32b2445a: posts big blind $0.05
*** HOLE CARDS ***
Dealt to c9de55a8 
Dealt to Hero [Qs 6h]
Dealt to 29e98354 
Dealt to ebe9ff0f 
Dealt to 32b2445a 
c9de55a8: folds
Hero: folds
29e98354: folds
ebe9ff0f: folds
Uncalled bet ($0.03) returned to 32b2445a
*** SHOWDOWN ***
32b2445a collected $0.04 from pot
*** SUMMARY ***
Total pot $0.04 | Rake $0 | Jackpot $0 | Bingo $0 | Fortune $0
Seat 1: c9de55a8 folded before Flop (didn't bet)
Seat 3: Hero folded before Flop (didn't bet)
Seat 4: 29e98354 (button) folded before Flop (didn't bet)
Seat 5: ebe9ff0f (small blind) folded before Flop
Seat 6: 32b2445a (big blind) collected ($0.04)


Poker Hand #HD1183891267: Hold'em No Limit  ($0.02/$0.05) - 2023/03/31 20:07:01
Table 'NLHBlue87' 6-max Seat #3 is the button
Seat 1: c9de55a8 ($5.34 in chips)
Seat 3: Hero ($9.42 in chips)
Seat 4: 29e98354 ($5.02 in chips)
Seat 5: ebe9ff0f ($6.87 in chips)
Seat 6: 32b2445a ($11.69 in chips)
29e98354: posts small blind $0.02
ebe9ff0f: posts big blind $0.05
*** HOLE CARDS ***
Dealt to c9de55a8 
Dealt to Hero [8d 3s]
Dealt to 29e98354 
Dealt to ebe9ff0f 
Dealt to 32b2445a 
32b2445a: folds
c9de55a8: folds
Hero: folds
29e98354: folds
Uncalled bet ($0.03) returned to ebe9ff0f
*** SHOWDOWN ***
ebe9ff0f collected $0.04 from pot
*** SUMMARY ***
Total pot $0.04 | Rake $0 | Jackpot $0 | Bingo $0 | Fortune $0
Seat 1: c9de55a8 folded before Flop (didn't bet)
Seat 3: Hero (button) folded before Flop (didn't bet)
Seat 4: 29e98354 (small blind) folded before Flop
Seat 5: ebe9ff0f (big blind) collected ($0.04)
Seat 6: 32b2445a folded before Flop (didn't bet)


Poker Hand #HD1183891151: Hold'em No Limit  ($0.02/$0.05) - 2023/03/31 20:06:07
Table 'NLHBlue87' 6-max Seat #1 is the button
Seat 1: c9de55a8 ($4.88 in chips)
Seat 3: Hero ($9.44 in chips)
Seat 4: 29e98354 ($5.07 in chips)
Seat 5: ebe9ff0f ($7 in chips)
Seat 6: 32b2445a ($11.98 in chips)
Hero: posts small blind $0.02
29e98354: posts big blind $0.05
*** HOLE CARDS ***
Dealt to c9de55a8 
Dealt to Hero [3h 7c]
Dealt to 29e98354 
Dealt to ebe9ff0f 
Dealt to 32b2445a 
ebe9ff0f: raises $0.08 to $0.13
32b2445a: calls $0.13
c9de55a8: calls $0.13
Hero: folds
29e98354: folds
*** FLOP *** [5c 9h 7s]
ebe9ff0f: checks
32b2445a: checks
c9de55a8: bets $0.16
ebe9ff0f: folds
32b2445a: calls $0.16
*** TURN *** [5c 9h 7s] [Kd]
32b2445a: checks
c9de55a8: bets $0.39
32b2445a: folds
Uncalled bet ($0.39) returned to c9de55a8
*** SHOWDOWN ***
c9de55a8 collected $0.75 from pot
*** SUMMARY ***
Total pot $0.78 | Rake $0.03 | Jackpot $0 | Bingo $0 | Fortune $0
Board [5c 9h 7s Kd]
Seat 1: c9de55a8 (button) won ($0.75)
Seat 3: Hero (small blind) folded before Flop
Seat 4: 29e98354 (big blind) folded before Flop
Seat 5: ebe9ff0f folded on the Flop
Seat 6: 32b2445a folded on the Turn


Poker Hand #HD1183891117: Hold'em No Limit  ($0.02/$0.05) - 2023/03/31 20:05:53
Table 'NLHBlue87' 6-max Seat #6 is the button
Seat 1: c9de55a8 ($4.9 in chips)
Seat 3: Hero ($9.49 in chips)
Seat 4: 29e98354 ($5 in chips)
Seat 5: ebe9ff0f ($7 in chips)
Seat 6: 32b2445a ($11.98 in chips)
c9de55a8: posts small blind $0.02
Hero: posts big blind $0.05
*** HOLE CARDS ***
Dealt to c9de55a8 
Dealt to Hero [5d Jh]
Dealt to 29e98354 
Dealt to ebe9ff0f 
Dealt to 32b2445a 
29e98354: raises $0.08 to $0.13
ebe9ff0f: folds
32b2445a: folds
c9de55a8: folds
Hero: folds
Uncalled bet ($0.08) returned to 29e98354
*** SHOWDOWN ***
29e98354 collected $0.12 from pot
*** SUMMARY ***
Total pot $0.12 | Rake $0 | Jackpot $0 | Bingo $0 | Fortune $0
Seat 1: c9de55a8 (small blind) folded before Flop
Seat 3: Hero (big blind) folded before Flop
Seat 4: 29e98354 collected ($0.12)
Seat 5: ebe9ff0f folded before Flop (didn't bet)
Seat 6: 32b2445a (button) folded before Flop (didn't bet)


Poker Hand #HD1183891081: Hold'em No Limit  ($0.02/$0.05) - 2023/03/31 20:05:38
Table 'NLHBlue87' 6-max Seat #5 is the button
Seat 1: c9de55a8 ($4.95 in chips)
Seat 3: Hero ($9.49 in chips)
Seat 4: 29e98354 ($5 in chips)
Seat 5: ebe9ff0f ($7 in chips)
Seat 6: 32b2445a ($11.93 in chips)
32b2445a: posts small blind $0.02
c9de55a8: posts big blind $0.05
*** HOLE CARDS ***
Dealt to c9de55a8 
Dealt to Hero [Js 4h]
Dealt to 29e98354 
Dealt to ebe9ff0f 
Dealt to 32b2445a 
Hero: folds
29e98354: folds
ebe9ff0f: folds
32b2445a: raises $0.1 to $0.15
c9de55a8: folds
Uncalled bet ($0.1) returned to 32b2445a
*** SHOWDOWN ***
32b2445a collected $0.1 from pot
*** SUMMARY ***
Total pot $0.1 | Rake $0 | Jackpot $0 | Bingo $0 | Fortune $0
Seat 1: c9de55a8 (big blind) folded before Flop
Seat 3: Hero folded before Flop (didn't bet)
Seat 4: 29e98354 folded before Flop (didn't bet)
Seat 5: ebe9ff0f (button) folded before Flop (didn't bet)
Seat 6: 32b2445a (small blind) collected ($0.1)


Poker Hand #HD1183890978: Hold'em No Limit  ($0.02/$0.05) - 2023/03/31 20:04:57
Table 'NLHBlue87' 6-max Seat #4 is the button
Seat 1: c9de55a8 ($4.95 in chips)
Seat 3: Hero ($9.49 in chips)
Seat 4: 29e98354 ($5.23 in chips)
Seat 5: ebe9ff0f ($6.1 in chips)
Seat 6: 32b2445a ($11.98 in chips)
ebe9ff0f: posts small blind $0.02
32b2445a: posts big blind $0.05
*** HOLE CARDS ***
Dealt to c9de55a8 
Dealt to Hero [Tc 4c]
Dealt to 29e98354 
Dealt to ebe9ff0f 
Dealt to 32b2445a 
c9de55a8: folds
Hero: folds
29e98354: raises $0.08 to $0.13
ebe9ff0f: raises $0.45 to $0.58
32b2445a: folds
29e98354: calls $0.45
*** FLOP *** [8s Ks 9c]
ebe9ff0f: bets $0.42
29e98354: calls $0.42
*** TURN *** [8s Ks 9c] [2h]
ebe9ff0f: bets $1.18
29e98354: folds
Uncalled bet ($1.18) returned to ebe9ff0f
*** SHOWDOWN ***
ebe9ff0f collected $1.9 from pot
*** SUMMARY ***
Total pot $2.05 | Rake $0.1 | Jackpot $0.05 | Bingo $0 | Fortune $0
Board [8s Ks 9c 2h]
Seat 1: c9de55a8 folded before Flop (didn't bet)
Seat 3: Hero folded before Flop (didn't bet)
Seat 4: 29e98354 (button) folded on the Turn
Seat 5: ebe9ff0f (small blind) won ($1.9)
Seat 6: 32b2445a (big blind) folded before Flop


Poker Hand #HD1183890896: Hold'em No Limit  ($0.02/$0.05) - 2023/03/31 20:04:20
Table 'NLHBlue87' 6-max Seat #3 is the button
Seat 1: c9de55a8 ($4.95 in chips)
Seat 3: Hero ($9.61 in chips)
Seat 4: 29e98354 ($5.25 in chips)
Seat 5: ebe9ff0f ($5.97 in chips)
Seat 6: 32b2445a ($11.98 in chips)
29e98354: posts small blind $0.02
ebe9ff0f: posts big blind $0.05
*** HOLE CARDS ***
Dealt to c9de55a8 
Dealt to Hero [3s Ks]
Dealt to 29e98354 
Dealt to ebe9ff0f 
Dealt to 32b2445a 
32b2445a: folds
c9de55a8: folds
Hero: raises $0.07 to $0.12
29e98354: folds
ebe9ff0f: calls $0.07
*** FLOP *** [9h 8d Qs]
ebe9ff0f: checks
Hero: checks
*** TURN *** [9h 8d Qs] [2h]
ebe9ff0f: bets $0.2
Hero: folds
Uncalled bet ($0.2) returned to ebe9ff0f
*** SHOWDOWN ***
ebe9ff0f collected $0.25 from pot
*** SUMMARY ***
Total pot $0.26 | Rake $0.01 | Jackpot $0 | Bingo $0 | Fortune $0
Board [9h 8d Qs 2h]
Seat 1: c9de55a8 folded before Flop (didn't bet)
Seat 3: Hero (button) folded on the Turn
Seat 4: 29e98354 (small blind) folded before Flop
Seat 5: ebe9ff0f (big blind) won ($0.25)
Seat 6: 32b2445a folded before Flop (didn't bet)


Poker Hand #HD1183890722: Hold'em No Limit  ($0.02/$0.05) - 2023/03/31 20:03:01
Table 'NLHBlue87' 6-max Seat #2 is the button
Seat 1: c9de55a8 ($5 in chips)
Seat 2: 4c09a6ca ($4.96 in chips)
Seat 3: Hero ($5 in chips)
Seat 4: 29e98354 ($5.3 in chips)
Seat 5: ebe9ff0f ($5.97 in chips)
Seat 6: 32b2445a ($12.08 in chips)
Hero: posts small blind $0.02
29e98354: posts big blind $0.05
c9de55a8: posts big blind $0.05
*** HOLE CARDS ***
Dealt to c9de55a8 
Dealt to 4c09a6ca 
Dealt to Hero [9h 9d]
Dealt to 29e98354 
Dealt to ebe9ff0f 
Dealt to 32b2445a 
ebe9ff0f: folds
32b2445a: raises $0.05 to $0.1
c9de55a8: folds
4c09a6ca: calls $0.1
Hero: raises $0.34 to $0.44
29e98354: folds
32b2445a: folds
4c09a6ca: calls $0.34
*** FLOP *** [6s 8s 4h]
Hero: bets $0.54
4c09a6ca: calls $0.54
*** TURN *** [6s 8s 4h] [Jh]
Hero: bets $1.08
4c09a6ca: calls $1.08
*** RIVER *** [6s 8s 4h Jh] [9c]
Hero: bets $2.94 and is all-in
4c09a6ca: calls $2.9 and is all-in
Uncalled bet ($0.04) returned to Hero
Hero: shows [9h 9d] (Three Nines)
4c09a6ca: shows [8h 8c] (Three Eights)
*** SHOWDOWN ***
Hero collected $9.57 from pot
*** SUMMARY ***
Total pot $10.12 | Rake $0.5 | Jackpot $0.05 | Bingo $0 | Fortune $0
Board [6s 8s 4h Jh 9c]
Seat 1: c9de55a8 folded before Flop
Seat 2: 4c09a6ca (button) showed [8h 8c] and lost with Three Eights
Seat 3: Hero (small blind) showed [9h 9d] and won ($9.57) with Three Nines
Seat 4: 29e98354 (big blind) folded before Flop
Seat 5: ebe9ff0f folded before Flop (didn't bet)
Seat 6: 32b2445a folded before Flop


Poker Hand #HD1183890508: Hold'em No Limit  ($0.02/$0.05) - 2023/03/31 20:01:34
Table 'NLHBlue87' 6-max Seat #6 is the button
Seat 2: 4c09a6ca ($4.98 in chips)
Seat 3: Hero ($5.22 in chips)
Seat 4: 29e98354 ($5.3 in chips)
Seat 5: ebe9ff0f ($5.97 in chips)
Seat 6: 32b2445a ($8.97 in chips)
4c09a6ca: posts small blind $0.02
Hero: posts big blind $0.05
*** HOLE CARDS ***
Dealt to 4c09a6ca 
Dealt to Hero [Ts Tc]
Dealt to 29e98354 
Dealt to ebe9ff0f 
Dealt to 32b2445a 
29e98354: folds
ebe9ff0f: folds
32b2445a: raises $0.1 to $0.15
4c09a6ca: folds
Hero: raises $0.47 to $0.62
32b2445a: calls $0.47
*** FLOP *** [3h 2c Kc]
Hero: bets $0.42
32b2445a: calls $0.42
*** TURN *** [3h 2c Kc] [Ks]
Hero: bets $1.05
32b2445a: calls $1.05
*** RIVER *** [3h 2c Kc Ks] [8d]
Hero: bets $1.39
32b2445a: calls $1.39
Hero: shows [Ts Tc] (Pair of Kings and Pair of Tens)
32b2445a: shows [Jd Jc] (Pair of Kings and Pair of Jacks)
*** SHOWDOWN ***
32b2445a collected $6.59 from pot
*** SUMMARY ***
Total pot $6.98 | Rake $0.34 | Jackpot $0.05 | Bingo $0 | Fortune $0
Board [3h 2c Kc Ks 8d]
Seat 2: 4c09a6ca (small blind) folded before Flop
Seat 3: Hero (big blind) showed [Ts Tc] and lost with Pair of Kings and Pair of Tens
Seat 4: 29e98354 folded before Flop (didn't bet)
Seat 5: ebe9ff0f folded before Flop (didn't bet)
Seat 6: 32b2445a (button) showed [Jd Jc] and won ($6.59) with Pair of Kings and Pair of Jacks


Poker Hand #HD1183890454: Hold'em No Limit  ($0.02/$0.05) - 2023/03/31 20:01:13
Table 'NLHBlue87' 6-max Seat #5 is the button
Seat 2: 4c09a6ca ($5.03 in chips)
Seat 3: Hero ($5.22 in chips)
Seat 4: 29e98354 ($5.3 in chips)
Seat 5: ebe9ff0f ($5.9 in chips)
Seat 6: 32b2445a ($8.99 in chips)
32b2445a: posts small blind $0.02
4c09a6ca: posts big blind $0.05
*** HOLE CARDS ***
Dealt to 4c09a6ca 
Dealt to Hero [Jc 3c]
Dealt to 29e98354 
Dealt to ebe9ff0f 
Dealt to 32b2445a 
Hero: folds
29e98354: folds
ebe9ff0f: raises $0.08 to $0.13
32b2445a: folds
4c09a6ca: folds
Uncalled bet ($0.08) returned to ebe9ff0f
*** SHOWDOWN ***
ebe9ff0f collected $0.12 from pot
*** SUMMARY ***
Total pot $0.12 | Rake $0 | Jackpot $0 | Bingo $0 | Fortune $0
Seat 2: 4c09a6ca (big blind) folded before Flop
Seat 3: Hero folded before Flop (didn't bet)
Seat 4: 29e98354 folded before Flop (didn't bet)
Seat 5: ebe9ff0f (button) collected ($0.12)
Seat 6: 32b2445a (small blind) folded before Flop


Poker Hand #HD1183890430: Hold'em No Limit  ($0.02/$0.05) - 2023/03/31 20:01:00
Table 'NLHBlue87' 6-max Seat #4 is the button
Seat 2: 4c09a6ca ($5.03 in chips)
Seat 3: Hero ($5.22 in chips)
Seat 4: 29e98354 ($5.3 in chips)
Seat 5: ebe9ff0f ($5.92 in chips)
Seat 6: 32b2445a ($8.97 in chips)
ebe9ff0f: posts small blind $0.02
32b2445a: posts big blind $0.05
*** HOLE CARDS ***
Dealt to 4c09a6ca 
Dealt to Hero [2s Ad]
Dealt to 29e98354 
Dealt to ebe9ff0f 
Dealt to 32b2445a 
4c09a6ca: folds
Hero: folds
29e98354: folds
ebe9ff0f: folds
Uncalled bet ($0.03) returned to 32b2445a
*** SHOWDOWN ***
32b2445a collected $0.04 from pot
*** SUMMARY ***
Total pot $0.04 | Rake $0 | Jackpot $0 | Bingo $0 | Fortune $0
Seat 2: 4c09a6ca folded before Flop (didn't bet)
Seat 3: Hero folded before Flop (didn't bet)
Seat 4: 29e98354 (button) folded before Flop (didn't bet)
Seat 5: ebe9ff0f (small blind) folded before Flop
Seat 6: 32b2445a (big blind) collected ($0.04)


Poker Hand #HD1183890410: Hold'em No Limit  ($0.02/$0.05) - 2023/03/31 20:00:53
Table 'NLHBlue87' 6-max Seat #3 is the button
Seat 2: 4c09a6ca ($5.03 in chips)
Seat 3: Hero ($5.22 in chips)
Seat 4: 29e98354 ($5.32 in chips)
Seat 5: ebe9ff0f ($5.9 in chips)
Seat 6: 32b2445a ($8.97 in chips)
29e98354: posts small blind $0.02
ebe9ff0f: posts big blind $0.05
*** HOLE CARDS ***
Dealt to 4c09a6ca 
Dealt to Hero [Js 4h]
Dealt to 29e98354 
Dealt to ebe9ff0f 
Dealt to 32b2445a 
32b2445a: folds
4c09a6ca: folds
Hero: folds
29e98354: folds
Uncalled bet ($0.03) returned to ebe9ff0f
*** SHOWDOWN ***
ebe9ff0f collected $0.04 from pot
*** SUMMARY ***
Total pot $0.04 | Rake $0 | Jackpot $0 | Bingo $0 | Fortune $0
Seat 2: 4c09a6ca folded before Flop (didn't bet)
Seat 3: Hero (button) folded before Flop (didn't bet)
Seat 4: 29e98354 (small blind) folded before Flop
Seat 5: ebe9ff0f (big blind) collected ($0.04)
Seat 6: 32b2445a folded before Flop (didn't bet)


Poker Hand #HD1183890354: Hold'em No Limit  ($0.02/$0.05) - 2023/03/31 20:00:32
Table 'NLHBlue87' 6-max Seat #2 is the button
Seat 2: 4c09a6ca ($5.13 in chips)
Seat 3: Hero ($5.08 in chips)
Seat 4: 29e98354 ($5.37 in chips)
Seat 5: ebe9ff0f ($5.9 in chips)
Seat 6: 32b2445a ($8.97 in chips)
Hero: posts small blind $0.02
29e98354: posts big blind $0.05
*** HOLE CARDS ***
Dealt to 4c09a6ca 
Dealt to Hero [Qh As]
Dealt to 29e98354 
Dealt to ebe9ff0f 
Dealt to 32b2445a 
ebe9ff0f: folds
32b2445a: folds
4c09a6ca: raises $0.05 to $0.1
Hero: raises $0.36 to $0.46
29e98354: folds
4c09a6ca: folds
Uncalled bet ($0.36) returned to Hero
*** SHOWDOWN ***
Hero collected $0.24 from pot
*** SUMMARY ***
Total pot $0.25 | Rake $0.01 | Jackpot $0 | Bingo $0 | Fortune $0
Seat 2: 4c09a6ca (button) folded before Flop
Seat 3: Hero (small blind) collected ($0.24)
Seat 4: 29e98354 (big blind) folded before Flop
Seat 5: ebe9ff0f folded before Flop (didn't bet)
Seat 6: 32b2445a folded before Flop (didn't bet)


Poker Hand #HD1183890327: Hold'em No Limit  ($0.02/$0.05) - 2023/03/31 20:00:24
Table 'NLHBlue87' 6-max Seat #6 is the button
Seat 2: 4c09a6ca ($5.15 in chips)
Seat 3: Hero ($5.13 in chips)
Seat 4: 29e98354 ($5.3 in chips)
Seat 5: ebe9ff0f ($5.9 in chips)
Seat 6: 32b2445a ($8.97 in chips)
4c09a6ca: posts small blind $0.02
Hero: posts big blind $0.05
*** HOLE CARDS ***
Dealt to 4c09a6ca 
Dealt to Hero [7s Kd]
Dealt to 29e98354 
Dealt to ebe9ff0f 
Dealt to 32b2445a 
29e98354: raises $0.08 to $0.13
ebe9ff0f: folds
32b2445a: folds
4c09a6ca: folds
Hero: folds
Uncalled bet ($0.08) returned to 29e98354
*** SHOWDOWN ***
29e98354 collected $0.12 from pot
*** SUMMARY ***
Total pot $0.12 | Rake $0 | Jackpot $0 | Bingo $0 | Fortune $0
Seat 2: 4c09a6ca (small blind) folded before Flop
Seat 3: Hero (big blind) folded before Flop
Seat 4: 29e98354 collected ($0.12)
Seat 5: ebe9ff0f folded before Flop (didn't bet)
Seat 6: 32b2445a (button) folded before Flop (didn't bet)


Poker Hand #HD1183890293: Hold'em No Limit  ($0.02/$0.05) - 2023/03/31 20:00:10
Table 'NLHBlue87' 6-max Seat #5 is the button
Seat 1: a8398998 ($5.24 in chips)
Seat 2: 4c09a6ca ($5.15 in chips)
Seat 3: Hero ($5.13 in chips)
Seat 4: 29e98354 ($5.23 in chips)
Seat 5: ebe9ff0f ($5.9 in chips)
Seat 6: 32b2445a ($8.99 in chips)
32b2445a: posts small blind $0.02
a8398998: posts big blind $0.05
*** HOLE CARDS ***
Dealt to a8398998 
Dealt to 4c09a6ca 
Dealt to Hero [8s 5d]
Dealt to 29e98354 
Dealt to ebe9ff0f 
Dealt to 32b2445a 
4c09a6ca: folds
Hero: folds
29e98354: raises $0.08 to $0.13
ebe9ff0f: folds
32b2445a: folds
a8398998: folds
Uncalled bet ($0.08) returned to 29e98354
*** SHOWDOWN ***
29e98354 collected $0.12 from pot
*** SUMMARY ***
Total pot $0.12 | Rake $0 | Jackpot $0 | Bingo $0 | Fortune $0
Seat 1: a8398998 (big blind) folded before Flop
Seat 2: 4c09a6ca folded before Flop (didn't bet)
Seat 3: Hero folded before Flop (didn't bet)
Seat 4: 29e98354 collected ($0.12)
Seat 5: ebe9ff0f (button) folded before Flop (didn't bet)
Seat 6: 32b2445a (small blind) folded before Flop


Poker Hand #HD1183890115: Hold'em No Limit  ($0.02/$0.05) - 2023/03/31 19:59:01
Table 'NLHBlue87' 6-max Seat #4 is the button
Seat 1: a8398998 ($5.24 in chips)
Seat 2: 4c09a6ca ($5.15 in chips)
Seat 3: Hero ($5.56 in chips)
Seat 4: 29e98354 ($5.23 in chips)
Seat 5: ebe9ff0f ($5.92 in chips)
Seat 6: 32b2445a ($8.58 in chips)
ebe9ff0f: posts small blind $0.02
32b2445a: posts big blind $0.05
*** HOLE CARDS ***
Dealt to a8398998 
Dealt to 4c09a6ca 
Dealt to Hero [6s As]
Dealt to 29e98354 
Dealt to ebe9ff0f 
Dealt to 32b2445a 
a8398998: folds
4c09a6ca: folds
Hero: raises $0.07 to $0.12
29e98354: folds
ebe9ff0f: folds
32b2445a: calls $0.07
*** FLOP *** [Td 7s 7h]
32b2445a: checks
Hero: checks
*** TURN *** [Td 7s 7h] [Ad]
32b2445a: checks
Hero: bets $0.13
32b2445a: calls $0.13
*** RIVER *** [Td 7s 7h Ad] [4s]
32b2445a: checks
Hero: bets $0.18
32b2445a: raises $0.88 to $1.06
Hero: folds
Uncalled bet ($0.88) returned to 32b2445a
*** SHOWDOWN ***
32b2445a collected $0.84 from pot
*** SUMMARY ***
Total pot $0.88 | Rake $0.04 | Jackpot $0 | Bingo $0 | Fortune $0
Board [Td 7s 7h Ad 4s]
Seat 1: a8398998 folded before Flop (didn't bet)
Seat 2: 4c09a6ca folded before Flop (didn't bet)
Seat 3: Hero folded on the River
Seat 4: 29e98354 (button) folded before Flop (didn't bet)
Seat 5: ebe9ff0f (small blind) folded before Flop
Seat 6: 32b2445a (big blind) won ($0.84)


Poker Hand #HD1183889983: Hold'em No Limit  ($0.02/$0.05) - 2023/03/31 19:57:57
Table 'NLHBlue87' 6-max Seat #3 is the button
Seat 1: a8398998 ($5.24 in chips)
Seat 2: 4c09a6ca ($5.15 in chips)
Seat 3: Hero ($5.99 in chips)
Seat 4: 29e98354 ($5.25 in chips)
Seat 5: ebe9ff0f ($5.51 in chips)
Seat 6: 32b2445a ($8.58 in chips)
29e98354: posts small blind $0.02
ebe9ff0f: posts big blind $0.05
*** HOLE CARDS ***
Dealt to a8398998 
Dealt to 4c09a6ca 
Dealt to Hero [7s Ah]
Dealt to 29e98354 
Dealt to ebe9ff0f 
Dealt to 32b2445a 
32b2445a: folds
a8398998: folds
4c09a6ca: folds
Hero: raises $0.07 to $0.12
29e98354: folds
ebe9ff0f: calls $0.07
*** FLOP *** [Jc 6c Js]
ebe9ff0f: checks
Hero: bets $0.09
ebe9ff0f: calls $0.09
*** TURN *** [Jc 6c Js] [8c]
ebe9ff0f: checks
Hero: bets $0.22
ebe9ff0f: calls $0.22
*** RIVER *** [Jc 6c Js 8c] [4c]
ebe9ff0f: checks
Hero: checks
ebe9ff0f: shows [Qh Kc] (King High Flush)
Hero: shows [7s Ah] (Pair of Jacks)
*** SHOWDOWN ***
ebe9ff0f collected $0.84 from pot
*** SUMMARY ***
Total pot $0.88 | Rake $0.04 | Jackpot $0 | Bingo $0 | Fortune $0
Board [Jc 6c Js 8c 4c]
Seat 1: a8398998 folded before Flop (didn't bet)
Seat 2: 4c09a6ca folded before Flop (didn't bet)
Seat 3: Hero (button) showed [7s Ah] and lost with Pair of Jacks
Seat 4: 29e98354 (small blind) folded before Flop
Seat 5: ebe9ff0f (big blind) showed [Qh Kc] and won ($0.84) with King High Flush
Seat 6: 32b2445a folded before Flop (didn't bet)


Poker Hand #HD1183889946: Hold'em No Limit  ($0.02/$0.05) - 2023/03/31 19:57:42
Table 'NLHBlue87' 6-max Seat #2 is the button
Seat 1: a8398998 ($5.24 in chips)
Seat 2: 4c09a6ca ($5.15 in chips)
Seat 3: Hero ($5.94 in chips)
Seat 4: 29e98354 ($5.3 in chips)
Seat 5: ebe9ff0f ($5.51 in chips)
Seat 6: 32b2445a ($8.58 in chips)
Hero: posts small blind $0.02
29e98354: posts big blind $0.05
*** HOLE CARDS ***
Dealt to a8398998 
Dealt to 4c09a6ca 
Dealt to Hero [Kd Ts]
Dealt to 29e98354 
Dealt to ebe9ff0f 
Dealt to 32b2445a 
ebe9ff0f: folds
32b2445a: folds
a8398998: folds
4c09a6ca: folds
Hero: raises $0.09 to $0.14
29e98354: folds
Uncalled bet ($0.09) returned to Hero
*** SHOWDOWN ***
Hero collected $0.1 from pot
*** SUMMARY ***
Total pot $0.1 | Rake $0 | Jackpot $0 | Bingo $0 | Fortune $0
Seat 1: a8398998 folded before Flop (didn't bet)
Seat 2: 4c09a6ca (button) folded before Flop (didn't bet)
Seat 3: Hero (small blind) collected ($0.1)
Seat 4: 29e98354 (big blind) folded before Flop
Seat 5: ebe9ff0f folded before Flop (didn't bet)
Seat 6: 32b2445a folded before Flop (didn't bet)


Poker Hand #HD1183889867: Hold'em No Limit  ($0.02/$0.05) - 2023/03/31 19:57:08
Table 'NLHBlue87' 6-max Seat #1 is the button
Seat 1: a8398998 ($5.24 in chips)
Seat 2: 4c09a6ca ($5.2 in chips)
Seat 3: Hero ($5.89 in chips)
Seat 4: 29e98354 ($5.3 in chips)
Seat 5: ebe9ff0f ($5.51 in chips)
Seat 6: 32b2445a ($8.58 in chips)
4c09a6ca: posts small blind $0.02
Hero: posts big blind $0.05
*** HOLE CARDS ***
Dealt to a8398998 
Dealt to 4c09a6ca 
Dealt to Hero [8h 9s]
Dealt to 29e98354 
Dealt to ebe9ff0f 
Dealt to 32b2445a 
29e98354: folds
ebe9ff0f: folds
32b2445a: folds
a8398998: folds
4c09a6ca: calls $0.03
Hero: checks
*** FLOP *** [2d Ks 7s]
4c09a6ca: checks
Hero: checks
*** TURN *** [2d Ks 7s] [6h]
4c09a6ca: checks
Hero: bets $0.05
4c09a6ca: folds
Uncalled bet ($0.05) returned to Hero
*** SHOWDOWN ***
Hero collected $0.1 from pot
*** SUMMARY ***
Total pot $0.1 | Rake $0 | Jackpot $0 | Bingo $0 | Fortune $0
Board [2d Ks 7s 6h]
Seat 1: a8398998 (button) folded before Flop (didn't bet)
Seat 2: 4c09a6ca (small blind) folded on the Turn
Seat 3: Hero (big blind) won ($0.1)
Seat 4: 29e98354 folded before Flop (didn't bet)
Seat 5: ebe9ff0f folded before Flop (didn't bet)
Seat 6: 32b2445a folded before Flop (didn't bet)


Poker Hand #HD1183889734: Hold'em No Limit  ($0.02/$0.05) - 2023/03/31 19:56:03
Table 'NLHBlue87' 6-max Seat #6 is the button
Seat 1: a8398998 ($5.26 in chips)
Seat 2: 4c09a6ca ($5.32 in chips)
Seat 3: Hero ($5.47 in chips)
Seat 4: 29e98354 ($5.3 in chips)
Seat 5: ebe9ff0f ($5.51 in chips)
Seat 6: 32b2445a ($8.89 in chips)
a8398998: posts small blind $0.02
4c09a6ca: posts big blind $0.05
*** HOLE CARDS ***
Dealt to a8398998 
Dealt to 4c09a6ca 
Dealt to Hero [As Jc]
Dealt to 29e98354 
Dealt to ebe9ff0f 
Dealt to 32b2445a 
Hero: raises $0.07 to $0.12
29e98354: folds
ebe9ff0f: folds
32b2445a: calls $0.12
a8398998: folds
4c09a6ca: calls $0.07
*** FLOP *** [6h 4d 8c]
4c09a6ca: checks
Hero: checks
32b2445a: checks
*** TURN *** [6h 4d 8c] [Th]
4c09a6ca: checks
Hero: bets $0.19
32b2445a: calls $0.19
4c09a6ca: folds
*** RIVER *** [6h 4d 8c Th] [Kc]
Hero: checks
32b2445a: checks
Hero: shows [As Jc] (Ace-High)
32b2445a: shows [9d Jh] (King-High)
*** SHOWDOWN ***
Hero collected $0.73 from pot
*** SUMMARY ***
Total pot $0.76 | Rake $0.03 | Jackpot $0 | Bingo $0 | Fortune $0
Board [6h 4d 8c Th Kc]
Seat 1: a8398998 (small blind) folded before Flop
Seat 2: 4c09a6ca (big blind) folded on the Turn
Seat 3: Hero showed [As Jc] and won ($0.73) with Ace-High
Seat 4: 29e98354 folded before Flop (didn't bet)
Seat 5: ebe9ff0f folded before Flop (didn't bet)
Seat 6: 32b2445a (button) showed [9d Jh] and lost with King-High


Poker Hand #HD1183889693: Hold'em No Limit  ($0.02/$0.05) - 2023/03/31 19:55:49
Table 'NLHBlue87' 6-max Seat #5 is the button
Seat 1: a8398998 ($5.31 in chips)
Seat 2: 4c09a6ca ($5.25 in chips)
Seat 3: Hero ($5.47 in chips)
Seat 4: 29e98354 ($5.3 in chips)
Seat 5: ebe9ff0f ($5.51 in chips)
Seat 6: 32b2445a ($8.91 in chips)
32b2445a: posts small blind $0.02
a8398998: posts big blind $0.05
*** HOLE CARDS ***
Dealt to a8398998 
Dealt to 4c09a6ca 
Dealt to Hero [5d Tc]
Dealt to 29e98354 
Dealt to ebe9ff0f 
Dealt to 32b2445a 
4c09a6ca: raises $0.1 to $0.15
Hero: folds
29e98354: folds
ebe9ff0f: folds
32b2445a: folds
a8398998: folds
Uncalled bet ($0.1) returned to 4c09a6ca
*** SHOWDOWN ***
4c09a6ca collected $0.12 from pot
*** SUMMARY ***
Total pot $0.12 | Rake $0 | Jackpot $0 | Bingo $0 | Fortune $0
Seat 1: a8398998 (big blind) folded before Flop
Seat 2: 4c09a6ca collected ($0.12)
Seat 3: Hero folded before Flop (didn't bet)
Seat 4: 29e98354 folded before Flop (didn't bet)
Seat 5: ebe9ff0f (button) folded before Flop (didn't bet)
Seat 6: 32b2445a (small blind) folded before Flop


Poker Hand #HD1183889593: Hold'em No Limit  ($0.02/$0.05) - 2023/03/31 19:55:03
Table 'NLHBlue87' 6-max Seat #4 is the button
Seat 1: a8398998 ($5.31 in chips)
Seat 2: 4c09a6ca ($5.25 in chips)
Seat 3: Hero ($5.47 in chips)
Seat 4: 29e98354 ($5.3 in chips)
Seat 5: ebe9ff0f ($5.13 in chips)
Seat 6: 32b2445a ($9.33 in chips)
ebe9ff0f: posts small blind $0.02
32b2445a: posts big blind $0.05
*** HOLE CARDS ***
Dealt to a8398998 
Dealt to 4c09a6ca 
Dealt to Hero [2s 6d]
Dealt to 29e98354 
Dealt to ebe9ff0f 
Dealt to 32b2445a 
a8398998: folds
4c09a6ca: folds
Hero: folds
29e98354: folds
ebe9ff0f: raises $0.1 to $0.15
32b2445a: calls $0.1
*** FLOP *** [Jc 8s 4s]
ebe9ff0f: bets $0.1
32b2445a: raises $0.17 to $0.27
ebe9ff0f: calls $0.17
*** TURN *** [Jc 8s 4s] [Qd]
ebe9ff0f: checks
32b2445a: checks
*** RIVER *** [Jc 8s 4s Qd] [6c]
ebe9ff0f: checks
32b2445a: checks
ebe9ff0f: shows [9s Qh] (Pair of Queens)
32b2445a: shows [3h Jh] (Pair of Jacks)
*** SHOWDOWN ***
ebe9ff0f collected $0.8 from pot
*** SUMMARY ***
Total pot $0.84 | Rake $0.04 | Jackpot $0 | Bingo $0 | Fortune $0
Board [Jc 8s 4s Qd 6c]
Seat 1: a8398998 folded before Flop (didn't bet)
Seat 2: 4c09a6ca folded before Flop (didn't bet)
Seat 3: Hero folded before Flop (didn't bet)
Seat 4: 29e98354 (button) folded before Flop (didn't bet)
Seat 5: ebe9ff0f (small blind) showed [9s Qh] and won ($0.8) with Pair of Queens
Seat 6: 32b2445a (big blind) showed [3h Jh] and lost with Pair of Jacks


Poker Hand #HD1183889530: Hold'em No Limit  ($0.02/$0.05) - 2023/03/31 19:54:37
Table 'NLHBlue87' 6-max Seat #3 is the button
Seat 1: a8398998 ($5.31 in chips)
Seat 2: 4c09a6ca ($5.25 in chips)
Seat 3: Hero ($5.59 in chips)
Seat 4: 29e98354 ($5.32 in chips)
Seat 5: ebe9ff0f ($5 in chips)
Seat 6: 32b2445a ($9.33 in chips)
29e98354: posts small blind $0.02
ebe9ff0f: posts big blind $0.05
*** HOLE CARDS ***
Dealt to a8398998 
Dealt to 4c09a6ca 
Dealt to Hero [7c Jc]
Dealt to 29e98354 
Dealt to ebe9ff0f 
Dealt to 32b2445a 
32b2445a: folds
a8398998: folds
4c09a6ca: folds
Hero: raises $0.07 to $0.12
29e98354: folds
ebe9ff0f: calls $0.07
*** FLOP *** [8h 3h 5h]
ebe9ff0f: checks
Hero: checks
*** TURN *** [8h 3h 5h] [Qs]
ebe9ff0f: bets $0.32
Hero: folds
Uncalled bet ($0.32) returned to ebe9ff0f
*** SHOWDOWN ***
ebe9ff0f collected $0.25 from pot
*** SUMMARY ***
Total pot $0.26 | Rake $0.01 | Jackpot $0 | Bingo $0 | Fortune $0
Board [8h 3h 5h Qs]
Seat 1: a8398998 folded before Flop (didn't bet)
Seat 2: 4c09a6ca folded before Flop (didn't bet)
Seat 3: Hero (button) folded on the Turn
Seat 4: 29e98354 (small blind) folded before Flop
Seat 5: ebe9ff0f (big blind) won ($0.25)
Seat 6: 32b2445a folded before Flop (didn't bet)


Poker Hand #HD1183889505: Hold'em No Limit  ($0.02/$0.05) - 2023/03/31 19:54:26
Table 'NLHBlue87' 6-max Seat #2 is the button
Seat 1: a8398998 ($5.31 in chips)
Seat 2: 4c09a6ca ($5.25 in chips)
Seat 3: Hero ($5.61 in chips)
Seat 4: 29e98354 ($5.3 in chips)
Seat 5: ebe9ff0f ($5 in chips)
Seat 6: 32b2445a ($9.33 in chips)
Hero: posts small blind $0.02
29e98354: posts big blind $0.05
*** HOLE CARDS ***
Dealt to a8398998 
Dealt to 4c09a6ca 
Dealt to Hero [2c 4h]
Dealt to 29e98354 
Dealt to ebe9ff0f 
Dealt to 32b2445a 
ebe9ff0f: folds
32b2445a: folds
a8398998: folds
4c09a6ca: folds
Hero: folds
Uncalled bet ($0.03) returned to 29e98354
*** SHOWDOWN ***
29e98354 collected $0.04 from pot
*** SUMMARY ***
Total pot $0.04 | Rake $0 | Jackpot $0 | Bingo $0 | Fortune $0
Seat 1: a8398998 folded before Flop (didn't bet)
Seat 2: 4c09a6ca (button) folded before Flop (didn't bet)
Seat 3: Hero (small blind) folded before Flop
Seat 4: 29e98354 (big blind) collected ($0.04)
Seat 5: ebe9ff0f folded before Flop (didn't bet)
Seat 6: 32b2445a folded before Flop (didn't bet)


Poker Hand #HD1183889473: Hold'em No Limit  ($0.02/$0.05) - 2023/03/31 19:54:08
Table 'NLHBlue87' 6-max Seat #1 is the button
Seat 1: a8398998 ($5.31 in chips)
Seat 2: 4c09a6ca ($5.27 in chips)
Seat 3: Hero ($5.66 in chips)
Seat 4: 29e98354 ($5.23 in chips)
Seat 5: ebe9ff0f ($5 in chips)
Seat 6: 32b2445a ($9.33 in chips)
4c09a6ca: posts small blind $0.02
Hero: posts big blind $0.05
*** HOLE CARDS ***
Dealt to a8398998 
Dealt to 4c09a6ca 
Dealt to Hero [6c 7h]
Dealt to 29e98354 
Dealt to ebe9ff0f 
Dealt to 32b2445a 
29e98354: raises $0.08 to $0.13
ebe9ff0f: folds
32b2445a: folds
a8398998: folds
4c09a6ca: folds
Hero: folds
Uncalled bet ($0.08) returned to 29e98354
*** SHOWDOWN ***
29e98354 collected $0.12 from pot
*** SUMMARY ***
Total pot $0.12 | Rake $0 | Jackpot $0 | Bingo $0 | Fortune $0
Seat 1: a8398998 (button) folded before Flop (didn't bet)
Seat 2: 4c09a6ca (small blind) folded before Flop
Seat 3: Hero (big blind) folded before Flop
Seat 4: 29e98354 collected ($0.12)
Seat 5: ebe9ff0f folded before Flop (didn't bet)
Seat 6: 32b2445a folded before Flop (didn't bet)


Poker Hand #HD1183889363: Hold'em No Limit  ($0.02/$0.05) - 2023/03/31 19:53:22
Table 'NLHBlue87' 6-max Seat #6 is the button
Seat 1: a8398998 ($5.33 in chips)
Seat 2: 4c09a6ca ($5 in chips)
Seat 3: Hero ($5.66 in chips)
Seat 4: 29e98354 ($5.23 in chips)
Seat 5: ebe9ff0f ($5 in chips)
Seat 6: 32b2445a ($9.6 in chips)
a8398998: posts small blind $0.02
4c09a6ca: posts big blind $0.05
*** HOLE CARDS ***
Dealt to a8398998 
Dealt to 4c09a6ca 
Dealt to Hero [8d 3d]
Dealt to 29e98354 
Dealt to ebe9ff0f 
Dealt to 32b2445a 
Hero: folds
29e98354: folds
ebe9ff0f: folds
32b2445a: raises $0.05 to $0.1
a8398998: folds
4c09a6ca: calls $0.05
*** FLOP *** [Jd 5h Jh]
4c09a6ca: checks
32b2445a: checks
*** TURN *** [Jd 5h Jh] [9s]
4c09a6ca: bets $0.17
32b2445a: calls $0.17
*** RIVER *** [Jd 5h Jh 9s] [3c]
4c09a6ca: bets $0.81
32b2445a: folds
Uncalled bet ($0.81) returned to 4c09a6ca
*** SHOWDOWN ***
4c09a6ca collected $0.54 from pot
*** SUMMARY ***
Total pot $0.56 | Rake $0.02 | Jackpot $0 | Bingo $0 | Fortune $0
Board [Jd 5h Jh 9s 3c]
Seat 1: a8398998 (small blind) folded before Flop
Seat 2: 4c09a6ca (big blind) won ($0.54)
Seat 3: Hero folded before Flop (didn't bet)
Seat 4: 29e98354 folded before Flop (didn't bet)
Seat 5: ebe9ff0f folded before Flop (didn't bet)
Seat 6: 32b2445a (button) folded on the River


Poker Hand #HD1183889330: Hold'em No Limit  ($0.02/$0.05) - 2023/03/31 19:53:08
Table 'NLHBlue87' 6-max Seat #5 is the button
Seat 1: a8398998 ($5.38 in chips)
Seat 3: Hero ($5.66 in chips)
Seat 4: 29e98354 ($5.23 in chips)
Seat 5: ebe9ff0f ($5 in chips)
Seat 6: 32b2445a ($9.55 in chips)
32b2445a: posts small blind $0.02
a8398998: posts big blind $0.05
*** HOLE CARDS ***
Dealt to a8398998 
Dealt to Hero [Jd 9h]
Dealt to 29e98354 
Dealt to ebe9ff0f 
Dealt to 32b2445a 
Hero: folds
29e98354: folds
ebe9ff0f: folds
32b2445a: raises $0.1 to $0.15
a8398998: folds
Uncalled bet ($0.1) returned to 32b2445a
*** SHOWDOWN ***
32b2445a collected $0.1 from pot
*** SUMMARY ***
Total pot $0.1 | Rake $0 | Jackpot $0 | Bingo $0 | Fortune $0
Seat 1: a8398998 (big blind) folded before Flop
Seat 3: Hero folded before Flop (didn't bet)
Seat 4: 29e98354 folded before Flop (didn't bet)
Seat 5: ebe9ff0f (button) folded before Flop (didn't bet)
Seat 6: 32b2445a (small blind) collected ($0.1)


Poker Hand #HD1183889189: Hold'em No Limit  ($0.02/$0.05) - 2023/03/31 19:52:13
Table 'NLHBlue87' 6-max Seat #4 is the button
Seat 1: a8398998 ($5.2 in chips)
Seat 3: Hero ($5.66 in chips)
Seat 4: 29e98354 ($5.23 in chips)
Seat 5: ebe9ff0f ($5.02 in chips)
Seat 6: 32b2445a ($9.72 in chips)
ebe9ff0f: posts small blind $0.02
32b2445a: posts big blind $0.05
*** HOLE CARDS ***
Dealt to a8398998 
Dealt to Hero [8h Ac]
Dealt to 29e98354 
Dealt to ebe9ff0f 
Dealt to 32b2445a 
a8398998: raises $0.12 to $0.17
Hero: folds
29e98354: folds
ebe9ff0f: folds
32b2445a: calls $0.12
*** FLOP *** [Ad As 4s]
32b2445a: checks
a8398998: bets $0.18
32b2445a: folds
Uncalled bet ($0.18) returned to a8398998
*** SHOWDOWN ***
a8398998 collected $0.35 from pot
*** SUMMARY ***
Total pot $0.36 | Rake $0.01 | Jackpot $0 | Bingo $0 | Fortune $0
Board [Ad As 4s]
Seat 1: a8398998 won ($0.35)
Seat 3: Hero folded before Flop (didn't bet)
Seat 4: 29e98354 (button) folded before Flop (didn't bet)
Seat 5: ebe9ff0f (small blind) folded before Flop
Seat 6: 32b2445a (big blind) folded on the Flop


Poker Hand #HD1183889177: Hold'em No Limit  ($0.02/$0.05) - 2023/03/31 19:52:04
Table 'NLHBlue87' 6-max Seat #3 is the button
Seat 1: a8398998 ($5.2 in chips)
Seat 3: Hero ($5.66 in chips)
Seat 4: 29e98354 ($5.25 in chips)
Seat 5: ebe9ff0f ($5 in chips)
Seat 6: 32b2445a ($9.72 in chips)
29e98354: posts small blind $0.02
ebe9ff0f: posts big blind $0.05
*** HOLE CARDS ***
Dealt to a8398998 
Dealt to Hero [7h 3d]
Dealt to 29e98354 
Dealt to ebe9ff0f 
Dealt to 32b2445a 
32b2445a: folds
a8398998: folds
Hero: folds
29e98354: folds
Uncalled bet ($0.03) returned to ebe9ff0f
*** SHOWDOWN ***
ebe9ff0f collected $0.04 from pot
*** SUMMARY ***
Total pot $0.04 | Rake $0 | Jackpot $0 | Bingo $0 | Fortune $0
Seat 1: a8398998 folded before Flop (didn't bet)
Seat 3: Hero (button) folded before Flop (didn't bet)
Seat 4: 29e98354 (small blind) folded before Flop
Seat 5: ebe9ff0f (big blind) collected ($0.04)
Seat 6: 32b2445a folded before Flop (didn't bet)


Poker Hand #HD1183889117: Hold'em No Limit  ($0.02/$0.05) - 2023/03/31 19:51:40
Table 'NLHBlue87' 6-max Seat #1 is the button
Seat 1: a8398998 ($5.2 in chips)
Seat 3: Hero ($5.68 in chips)
Seat 4: 29e98354 ($5.3 in chips)
Seat 5: ebe9ff0f ($5 in chips)
Seat 6: 32b2445a ($9.65 in chips)
Hero: posts small blind $0.02
29e98354: posts big blind $0.05
*** HOLE CARDS ***
Dealt to a8398998 
Dealt to Hero [9c Kd]
Dealt to 29e98354 
Dealt to ebe9ff0f 
Dealt to 32b2445a 
ebe9ff0f: folds
32b2445a: raises $0.1 to $0.15
a8398998: folds
Hero: folds
29e98354: folds
Uncalled bet ($0.1) returned to 32b2445a
*** SHOWDOWN ***
32b2445a collected $0.12 from pot
*** SUMMARY ***
Total pot $0.12 | Rake $0 | Jackpot $0 | Bingo $0 | Fortune $0
Seat 1: a8398998 (button) folded before Flop (didn't bet)
Seat 3: Hero (small blind) folded before Flop
Seat 4: 29e98354 (big blind) folded before Flop
Seat 5: ebe9ff0f folded before Flop (didn't bet)
Seat 6: 32b2445a collected ($0.12)


Poker Hand #HD1183889034: Hold'em No Limit  ($0.02/$0.05) - 2023/03/31 19:51:07
Table 'NLHBlue87' 6-max Seat #6 is the button
Seat 1: a8398998 ($5.22 in chips)
Seat 3: Hero ($5.5 in chips)
Seat 4: 29e98354 ($5.47 in chips)
Seat 5: ebe9ff0f ($5 in chips)
Seat 6: 32b2445a ($9.65 in chips)
a8398998: posts small blind $0.02
Hero: posts big blind $0.05
*** HOLE CARDS ***
Dealt to a8398998 
Dealt to Hero [7h 8h]
Dealt to 29e98354 
Dealt to ebe9ff0f 
Dealt to 32b2445a 
29e98354: raises $0.12 to $0.17
ebe9ff0f: folds
32b2445a: folds
a8398998: folds
Hero: calls $0.12
*** FLOP *** [5s 2s Qd]
Hero: checks
29e98354: checks
*** TURN *** [5s 2s Qd] [7d]
Hero: checks
29e98354: checks
*** RIVER *** [5s 2s Qd 7d] [3s]
Hero: checks
29e98354: checks
Hero: shows [7h 8h] (Pair of Sevens)
29e98354: shows [Ac Kd] (Ace-High)
*** SHOWDOWN ***
Hero collected $0.35 from pot
*** SUMMARY ***
Total pot $0.36 | Rake $0.01 | Jackpot $0 | Bingo $0 | Fortune $0
Board [5s 2s Qd 7d 3s]
Seat 1: a8398998 (small blind) folded before Flop
Seat 3: Hero (big blind) showed [7h 8h] and won ($0.35) with Pair of Sevens
Seat 4: 29e98354 showed [Ac Kd] and lost with Ace-High
Seat 5: ebe9ff0f folded before Flop (didn't bet)
Seat 6: 32b2445a (button) folded before Flop (didn't bet)


Poker Hand #HD1183888895: Hold'em No Limit  ($0.02/$0.05) - 2023/03/31 19:50:09
Table 'NLHBlue87' 6-max Seat #5 is the button
Seat 1: a8398998 ($5.27 in chips)
Seat 2: 245db11e ($4.95 in chips)
Seat 3: Hero ($5.5 in chips)
Seat 4: 29e98354 ($5.47 in chips)
Seat 5: ebe9ff0f ($5 in chips)
Seat 6: 32b2445a ($5.19 in chips)
32b2445a: posts small blind $0.02
a8398998: posts big blind $0.05
*** HOLE CARDS ***
Dealt to a8398998 
Dealt to 245db11e 
Dealt to Hero [5d Jc]
Dealt to 29e98354 
Dealt to ebe9ff0f 
Dealt to 32b2445a 
245db11e: calls $0.05
Hero: folds
29e98354: folds
ebe9ff0f: folds
32b2445a: raises $0.15 to $0.2
a8398998: folds
245db11e: calls $0.15
*** FLOP *** [3d 5h Ts]
32b2445a: bets $0.34
245db11e: calls $0.34
*** TURN *** [3d 5h Ts] [Qs]
32b2445a: checks
245db11e: checks
*** RIVER *** [3d 5h Ts Qs] [6s]
32b2445a: checks
245db11e: bets $4.41 and is all-in
32b2445a: calls $4.41
245db11e: shows [6c 4c] (Pair of Sixes)
32b2445a: shows [Qd Ah] (Pair of Queens)
*** SHOWDOWN ***
32b2445a collected $9.41 from pot
*** SUMMARY ***
Total pot $9.95 | Rake $0.49 | Jackpot $0.05 | Bingo $0 | Fortune $0
Board [3d 5h Ts Qs 6s]
Seat 1: a8398998 (big blind) folded before Flop
Seat 2: 245db11e showed [6c 4c] and lost with Pair of Sixes
Seat 3: Hero folded before Flop (didn't bet)
Seat 4: 29e98354 folded before Flop (didn't bet)
Seat 5: ebe9ff0f (button) folded before Flop (didn't bet)
Seat 6: 32b2445a (small blind) showed [Qd Ah] and won ($9.41) with Pair of Queens


Poker Hand #HD1183888812: Hold'em No Limit  ($0.02/$0.05) - 2023/03/31 19:49:34
Table 'NLHBlue87' 6-max Seat #4 is the button
Seat 1: a8398998 ($5.27 in chips)
Seat 2: 245db11e ($5 in chips)
Seat 3: Hero ($5.5 in chips)
Seat 4: 29e98354 ($5.47 in chips)
Seat 5: ebe9ff0f ($5 in chips)
Seat 6: 32b2445a ($5.09 in chips)
ebe9ff0f: posts small blind $0.02
32b2445a: posts big blind $0.05
245db11e: posts big blind $0.05
*** HOLE CARDS ***
Dealt to a8398998 
Dealt to 245db11e 
Dealt to Hero [3c 4s]
Dealt to 29e98354 
Dealt to ebe9ff0f 
Dealt to 32b2445a 
a8398998: folds
245db11e: checks
Hero: folds
29e98354: folds
ebe9ff0f: calls $0.03
32b2445a: checks
*** FLOP *** [Kc Ac 4h]
ebe9ff0f: checks
32b2445a: bets $0.08
245db11e: folds
ebe9ff0f: folds
Uncalled bet ($0.08) returned to 32b2445a
*** SHOWDOWN ***
32b2445a collected $0.15 from pot
*** SUMMARY ***
Total pot $0.15 | Rake $0 | Jackpot $0 | Bingo $0 | Fortune $0
Board [Kc Ac 4h]
Seat 1: a8398998 folded before Flop (didn't bet)
Seat 2: 245db11e folded on the Flop
Seat 3: Hero folded before Flop (didn't bet)
Seat 4: 29e98354 (button) folded before Flop (didn't bet)
Seat 5: ebe9ff0f (small blind) folded on the Flop
Seat 6: 32b2445a (big blind) won ($0.15)


Poker Hand #HD1183888697: Hold'em No Limit  ($0.02/$0.05) - 2023/03/31 19:48:38
Table 'NLHBlue87' 6-max Seat #3 is the button
Seat 1: a8398998 ($5.27 in chips)
Seat 3: Hero ($5 in chips)
Seat 4: 29e98354 ($5.49 in chips)
Seat 5: ebe9ff0f ($5 in chips)
Seat 6: 32b2445a ($5.09 in chips)
29e98354: posts small blind $0.02
ebe9ff0f: posts big blind $0.05
*** HOLE CARDS ***
Dealt to a8398998 
Dealt to Hero [Qc Qd]
Dealt to 29e98354 
Dealt to ebe9ff0f 
Dealt to 32b2445a 
32b2445a: folds
a8398998: folds
Hero: raises $0.07 to $0.12
29e98354: folds
ebe9ff0f: calls $0.07
*** FLOP *** [5s Jd 9s]
ebe9ff0f: checks
Hero: bets $0.14
ebe9ff0f: raises $0.27 to $0.41
Hero: calls $0.27
*** TURN *** [5s Jd 9s] [9h]
ebe9ff0f: checks
Hero: checks
*** RIVER *** [5s Jd 9s 9h] [2d]
ebe9ff0f: checks
Hero: bets $0.36
ebe9ff0f: folds
Uncalled bet ($0.36) returned to Hero
*** SHOWDOWN ***
Hero collected $1.03 from pot
*** SUMMARY ***
Total pot $1.08 | Rake $0.05 | Jackpot $0 | Bingo $0 | Fortune $0
Board [5s Jd 9s 9h 2d]
Seat 1: a8398998 folded before Flop (didn't bet)
Seat 3: Hero (button) won ($1.03)
Seat 4: 29e98354 (small blind) folded before Flop
Seat 5: ebe9ff0f (big blind) folded on the River
Seat 6: 32b2445a folded before Flop (didn't bet)


Poker Hand #HD1183888643: Hold'em No Limit  ($0.02/$0.05) - 2023/03/31 19:48:20
Table 'NLHBlue87' 6-max Seat #2 is the button
Seat 1: a8398998 ($5.27 in chips)
Seat 2: 9b868c4f ($5.63 in chips)
Seat 3: Hero ($5 in chips)
Seat 4: 29e98354 ($5.47 in chips)
Seat 6: 32b2445a ($5.09 in chips)
Hero: posts small blind $0.02
29e98354: posts big blind $0.05
*** HOLE CARDS ***
Dealt to a8398998 
Dealt to 9b868c4f 
Dealt to Hero [6d Js]
Dealt to 29e98354 
Dealt to 32b2445a 
32b2445a: folds
a8398998: folds
9b868c4f: folds
Hero: folds
Uncalled bet ($0.03) returned to 29e98354
*** SHOWDOWN ***
29e98354 collected $0.04 from pot
*** SUMMARY ***
Total pot $0.04 | Rake $0 | Jackpot $0 | Bingo $0 | Fortune $0
Seat 1: a8398998 folded before Flop (didn't bet)
Seat 2: 9b868c4f (button) folded before Flop (didn't bet)
Seat 3: Hero (small blind) folded before Flop
Seat 4: 29e98354 (big blind) collected ($0.04)
Seat 6: 32b2445a folded before Flop (didn't bet)


Poker Hand #HD1183888623: Hold'em No Limit  ($0.02/$0.05) - 2023/03/31 19:48:11
Table 'NLHBlue87' 6-max Seat #1 is the button
Seat 1: a8398998 ($5.2 in chips)
Seat 2: 9b868c4f ($5.65 in chips)
Seat 3: Hero ($5 in chips)
Seat 4: 29e98354 ($5.47 in chips)
Seat 6: 32b2445a ($5.09 in chips)
9b868c4f: posts small blind $0.02
Hero: posts big blind $0.05
*** HOLE CARDS ***
Dealt to a8398998 
Dealt to 9b868c4f 
Dealt to Hero [7h 5c]
Dealt to 29e98354 
Dealt to 32b2445a 
29e98354: folds
32b2445a: folds
a8398998: raises $0.12 to $0.17
9b868c4f: folds
Hero: folds
Uncalled bet ($0.12) returned to a8398998
*** SHOWDOWN ***
a8398998 collected $0.12 from pot
*** SUMMARY ***
Total pot $0.12 | Rake $0 | Jackpot $0 | Bingo $0 | Fortune $0
Seat 1: a8398998 (button) collected ($0.12)
Seat 2: 9b868c4f (small blind) folded before Flop
Seat 3: Hero (big blind) folded before Flop
Seat 4: 29e98354 folded before Flop (didn't bet)
Seat 6: 32b2445a folded before Flop (didn't bet)


Poker Hand #HD1183888592: Hold'em No Limit  ($0.02/$0.05) - 2023/03/31 19:47:58
Table 'NLHBlue87' 6-max Seat #6 is the button
Seat 1: a8398998 ($5.22 in chips)
Seat 2: 9b868c4f ($5.7 in chips)
Seat 3: Hero ($5 in chips)
Seat 4: 29e98354 ($5.47 in chips)
Seat 6: 32b2445a ($5.02 in chips)
a8398998: posts small blind $0.02
9b868c4f: posts big blind $0.05
*** HOLE CARDS ***
Dealt to a8398998 
Dealt to 9b868c4f 
Dealt to Hero [6h Kd]
Dealt to 29e98354 
Dealt to 32b2445a 
Hero: folds
29e98354: folds
32b2445a: raises $0.1 to $0.15
a8398998: folds
9b868c4f: folds
Uncalled bet ($0.1) returned to 32b2445a
*** SHOWDOWN ***
32b2445a collected $0.12 from pot
*** SUMMARY ***
Total pot $0.12 | Rake $0 | Jackpot $0 | Bingo $0 | Fortune $0
Seat 1: a8398998 (small blind) folded before Flop
Seat 2: 9b868c4f (big blind) folded before Flop
Seat 3: Hero folded before Flop (didn't bet)
Seat 4: 29e98354 folded before Flop (didn't bet)
Seat 6: 32b2445a (button) collected ($0.12)


Poker Hand #HD1183888452: Hold'em No Limit  ($0.02/$0.05) - 2023/03/31 19:46:58
Table 'NLHBlue87' 6-max Seat #4 is the button
Seat 1: a8398998 ($5.27 in chips)
Seat 2: 9b868c4f ($5.38 in chips)
Seat 3: Hero ($5 in chips)
Seat 4: 29e98354 ($5.47 in chips)
Seat 6: 32b2445a ($5.32 in chips)
32b2445a: posts small blind $0.02
a8398998: posts big blind $0.05
*** HOLE CARDS ***
Dealt to a8398998 
Dealt to 9b868c4f 
Dealt to Hero [Jc 7s]
Dealt to 29e98354 
Dealt to 32b2445a 
9b868c4f: calls $0.05
Hero: folds
29e98354: folds
32b2445a: raises $0.05 to $0.1
a8398998: folds
9b868c4f: raises $0.2 to $0.3
32b2445a: calls $0.2
*** FLOP *** [Th Qd 9c]
32b2445a: checks
9b868c4f: bets $0.75
32b2445a: folds
Uncalled bet ($0.75) returned to 9b868c4f
*** SHOWDOWN ***
9b868c4f collected $0.62 from pot
*** SUMMARY ***
Total pot $0.65 | Rake $0.03 | Jackpot $0 | Bingo $0 | Fortune $0
Board [Th Qd 9c]
Seat 1: a8398998 (big blind) folded before Flop
Seat 2: 9b868c4f won ($0.62)
Seat 3: Hero folded before Flop (didn't bet)
Seat 4: 29e98354 (button) folded before Flop (didn't bet)
Seat 6: 32b2445a (small blind) folded on the Flop


Poker Hand #HD1183888282: Hold'em No Limit  ($0.02/$0.05) - 2023/03/31 19:45:42
Table 'NLHBlue87' 6-max Seat #3 is the button
Seat 1: a8398998 ($5.27 in chips)
Seat 2: 9b868c4f ($5.14 in chips)
Seat 3: Hero ($5 in chips)
Seat 4: 29e98354 ($5.49 in chips)
Seat 5: b122b8d9 ($5.44 in chips)
Seat 6: 32b2445a ($5.51 in chips)
29e98354: posts small blind $0.02
b122b8d9: posts big blind $0.05
*** HOLE CARDS ***
Dealt to a8398998 
Dealt to 9b868c4f 
Dealt to Hero [Qh Qd]
Dealt to 29e98354 
Dealt to b122b8d9 
Dealt to 32b2445a 
32b2445a: raises $0.05 to $0.1
a8398998: folds
9b868c4f: calls $0.1
Hero: folds
29e98354: folds
b122b8d9: folds
*** FLOP *** [9c Ts Ac]
32b2445a: bets $0.09
9b868c4f: calls $0.09
*** TURN *** [9c Ts Ac] [Th]
32b2445a: checks
9b868c4f: checks
*** RIVER *** [9c Ts Ac Th] [Qc]
32b2445a: checks
9b868c4f: bets $0.54
32b2445a: folds
Uncalled bet ($0.54) returned to 9b868c4f
*** SHOWDOWN ***
9b868c4f collected $0.43 from pot
*** SUMMARY ***
Total pot $0.45 | Rake $0.02 | Jackpot $0 | Bingo $0 | Fortune $0
Board [9c Ts Ac Th Qc]
Seat 1: a8398998 folded before Flop (didn't bet)
Seat 2: 9b868c4f won ($0.43)
Seat 3: Hero (button) folded before Flop (didn't bet)
Seat 4: 29e98354 (small blind) folded before Flop
Seat 5: b122b8d9 (big blind) folded before Flop
Seat 6: 32b2445a folded on the River


Poker Hand #HD1183888246: Hold'em No Limit  ($0.02/$0.05) - 2023/03/31 19:45:28
Table 'NLHBlue87' 6-max Seat #2 is the button
Seat 1: a8398998 ($5.27 in chips)
Seat 2: 9b868c4f ($5.14 in chips)
Seat 3: Hero ($5 in chips)
Seat 4: 29e98354 ($5.54 in chips)
Seat 6: 32b2445a ($5.44 in chips)
Hero: posts small blind $0.02
29e98354: posts big blind $0.05
*** HOLE CARDS ***
Dealt to a8398998 
Dealt to 9b868c4f 
Dealt to Hero [3c 5d]
Dealt to 29e98354 
Dealt to 32b2445a 
32b2445a: raises $0.1 to $0.15
a8398998: folds
9b868c4f: folds
Hero: folds
29e98354: folds
Uncalled bet ($0.1) returned to 32b2445a
*** SHOWDOWN ***
32b2445a collected $0.12 from pot
*** SUMMARY ***
Total pot $0.12 | Rake $0 | Jackpot $0 | Bingo $0 | Fortune $0
Seat 1: a8398998 folded before Flop (didn't bet)
Seat 2: 9b868c4f (button) folded before Flop (didn't bet)
Seat 3: Hero (small blind) folded before Flop
Seat 4: 29e98354 (big blind) folded before Flop
Seat 6: 32b2445a collected ($0.12)


Poker Hand #HD1183888138: Hold'em No Limit  ($0.02/$0.05) - 2023/03/31 19:44:42
Table 'NLHBlue87' 6-max Seat #1 is the button
Seat 1: a8398998 ($5.27 in chips)
Seat 2: 9b868c4f ($5 in chips)
Seat 3: Hero ($5.07 in chips)
Seat 4: 29e98354 ($5.54 in chips)
Seat 6: 32b2445a ($5.44 in chips)
9b868c4f: posts small blind $0.02
Hero: posts big blind $0.05
*** HOLE CARDS ***
Dealt to a8398998 
Dealt to 9b868c4f 
Dealt to Hero [5c 7c]
Dealt to 29e98354 
Dealt to 32b2445a 
29e98354: folds
32b2445a: folds
a8398998: folds
9b868c4f: raises $0.1 to $0.15
Hero: calls $0.1
*** FLOP *** [7h Ah Jh]
9b868c4f: checks
Hero: checks
*** TURN *** [7h Ah Jh] [Jd]
9b868c4f: checks
Hero: checks
*** RIVER *** [7h Ah Jh Jd] [Jc]
9b868c4f: bets $0.2
Hero: folds
Uncalled bet ($0.2) returned to 9b868c4f
*** SHOWDOWN ***
9b868c4f collected $0.29 from pot
*** SUMMARY ***
Total pot $0.3 | Rake $0.01 | Jackpot $0 | Bingo $0 | Fortune $0
Board [7h Ah Jh Jd Jc]
Seat 1: a8398998 (button) folded before Flop (didn't bet)
Seat 2: 9b868c4f (small blind) won ($0.29)
Seat 3: Hero (big blind) folded on the River
Seat 4: 29e98354 folded before Flop (didn't bet)
Seat 6: 32b2445a folded before Flop (didn't bet)


Poker Hand #HD1183888113: Hold'em No Limit  ($0.02/$0.05) - 2023/03/31 19:44:31
Table 'NLHBlue87' 6-max Seat #6 is the button
Seat 1: a8398998 ($5.29 in chips)
Seat 2: 9b868c4f ($5 in chips)
Seat 3: Hero ($5 in chips)
Seat 4: 29e98354 ($5.54 in chips)
Seat 6: 32b2445a ($5.44 in chips)
a8398998: posts small blind $0.02
9b868c4f: posts big blind $0.05
*** HOLE CARDS ***
Dealt to a8398998 
Dealt to 9b868c4f 
Dealt to Hero [Kd Ks]
Dealt to 29e98354 
Dealt to 32b2445a 
Hero: raises $0.07 to $0.12
29e98354: folds
32b2445a: folds
a8398998: folds
9b868c4f: folds
Uncalled bet ($0.07) returned to Hero
*** SHOWDOWN ***
Hero collected $0.12 from pot
*** SUMMARY ***
Total pot $0.12 | Rake $0 | Jackpot $0 | Bingo $0 | Fortune $0
Seat 1: a8398998 (small blind) folded before Flop
Seat 2: 9b868c4f (big blind) folded before Flop
Seat 3: Hero collected ($0.12)
Seat 4: 29e98354 folded before Flop (didn't bet)
Seat 6: 32b2445a (button) folded before Flop (didn't bet)


Poker Hand #HD1183888086: Hold'em No Limit  ($0.02/$0.05) - 2023/03/31 19:44:20
Table 'NLHBlue87' 6-max Seat #4 is the button
Seat 1: a8398998 ($5.34 in chips)
Seat 2: 9b868c4f ($5 in chips)
Seat 3: Hero ($5 in chips)
Seat 4: 29e98354 ($5.54 in chips)
Seat 6: 32b2445a ($5.39 in chips)
32b2445a: posts small blind $0.02
a8398998: posts big blind $0.05
*** HOLE CARDS ***
Dealt to a8398998 
Dealt to 9b868c4f 
Dealt to Hero [5s 6c]
Dealt to 29e98354 
Dealt to 32b2445a 
9b868c4f: folds
Hero: folds
29e98354: folds
32b2445a: raises $0.1 to $0.15
a8398998: folds
Uncalled bet ($0.1) returned to 32b2445a
*** SHOWDOWN ***
32b2445a collected $0.1 from pot
*** SUMMARY ***
Total pot $0.1 | Rake $0 | Jackpot $0 | Bingo $0 | Fortune $0
Seat 1: a8398998 (big blind) folded before Flop
Seat 2: 9b868c4f folded before Flop (didn't bet)
Seat 3: Hero folded before Flop (didn't bet)
Seat 4: 29e98354 (button) folded before Flop (didn't bet)
Seat 6: 32b2445a (small blind) collected ($0.1)


Poker Hand #HD1183887989: Hold'em No Limit  ($0.02/$0.05) - 2023/03/31 19:43:43
Table 'NLHBlue87' 6-max Seat #3 is the button
Seat 1: a8398998 ($5.34 in chips)
Seat 2: 9b868c4f ($5 in chips)
Seat 3: Hero ($5 in chips)
Seat 4: 29e98354 ($5.67 in chips)
Seat 6: 32b2445a ($5.27 in chips)
29e98354: posts small blind $0.02
32b2445a: posts big blind $0.05
*** HOLE CARDS ***
Dealt to a8398998 
Dealt to 9b868c4f 
Dealt to Hero [Tc 3c]
Dealt to 29e98354 
Dealt to 32b2445a 
a8398998: folds
9b868c4f: folds
Hero: folds
29e98354: raises $0.08 to $0.13
32b2445a: calls $0.08
*** FLOP *** [Qs Qd Th]
29e98354: checks
32b2445a: checks
*** TURN *** [Qs Qd Th] [6h]
29e98354: checks
32b2445a: bets $0.09
29e98354: folds
Uncalled bet ($0.09) returned to 32b2445a
*** SHOWDOWN ***
32b2445a collected $0.25 from pot
*** SUMMARY ***
Total pot $0.26 | Rake $0.01 | Jackpot $0 | Bingo $0 | Fortune $0
Board [Qs Qd Th 6h]
Seat 1: a8398998 folded before Flop (didn't bet)
Seat 2: 9b868c4f folded before Flop (didn't bet)
Seat 3: Hero (button) folded before Flop (didn't bet)
Seat 4: 29e98354 (small blind) folded on the Turn
Seat 6: 32b2445a (big blind) won ($0.25)


Poker Hand #HD1183887947: Hold'em No Limit  ($0.02/$0.05) - 2023/03/31 19:43:25
Table 'NLHBlue87' 6-max Seat #2 is the button
Seat 1: a8398998 ($5.34 in chips)
Seat 2: 9b868c4f ($5 in chips)
Seat 3: Hero ($5 in chips)
Seat 4: 29e98354 ($5.56 in chips)
Seat 6: 32b2445a ($5.27 in chips)
Hero: posts small blind $0.02
29e98354: posts big blind $0.05
*** HOLE CARDS ***
Dealt to a8398998 
Dealt to 9b868c4f 
Dealt to Hero [3c 2h]
Dealt to 29e98354 
Dealt to 32b2445a 
32b2445a: folds
a8398998: folds
9b868c4f: raises $0.05 to $0.1
Hero: folds
29e98354: raises $0.28 to $0.38
9b868c4f: folds
Uncalled bet ($0.28) returned to 29e98354
*** SHOWDOWN ***
29e98354 collected $0.21 from pot
*** SUMMARY ***
Total pot $0.22 | Rake $0.01 | Jackpot $0 | Bingo $0 | Fortune $0
Seat 1: a8398998 folded before Flop (didn't bet)
Seat 2: 9b868c4f (button) folded before Flop
Seat 3: Hero (small blind) folded before Flop
Seat 4: 29e98354 (big blind) collected ($0.21)
Seat 6: 32b2445a folded before Flop (didn't bet)


Poker Hand #HD1183887887: Hold'em No Limit  ($0.02/$0.05) - 2023/03/31 19:43:01
Table 'NLHBlue87' 6-max Seat #1 is the button
Seat 1: a8398998 ($5.27 in chips)
Seat 2: 9b868c4f ($5.02 in chips)
Seat 3: Hero ($5 in chips)
Seat 4: 29e98354 ($5.56 in chips)
Seat 5: b122b8d9 ($5.44 in chips)
Seat 6: 32b2445a ($5.27 in chips)
9b868c4f: posts small blind $0.02
Hero: posts big blind $0.05
*** HOLE CARDS ***
Dealt to a8398998 
Dealt to 9b868c4f 
Dealt to Hero [Kd 7h]
Dealt to 29e98354 
Dealt to b122b8d9 
Dealt to 32b2445a 
29e98354: folds
b122b8d9: folds
32b2445a: folds
a8398998: raises $0.12 to $0.17
9b868c4f: folds
Hero: folds
Uncalled bet ($0.12) returned to a8398998
*** SHOWDOWN ***
a8398998 collected $0.12 from pot
*** SUMMARY ***
Total pot $0.12 | Rake $0 | Jackpot $0 | Bingo $0 | Fortune $0
Seat 1: a8398998 (button) collected ($0.12)
Seat 2: 9b868c4f (small blind) folded before Flop
Seat 3: Hero (big blind) folded before Flop
Seat 4: 29e98354 folded before Flop (didn't bet)
Seat 5: b122b8d9 folded before Flop (didn't bet)
Seat 6: 32b2445a folded before Flop (didn't bet)


