Poker Hand #HD1184176336: Hold'em No Limit  ($0.02/$0.05) - 2023/03/31 23:07:43
Table 'NLHBlue109' 6-max Seat #5 is the button
Seat 1: d3c887a5 ($9.13 in chips)
Seat 2: Hero ($7.04 in chips)
Seat 3: e4fafec0 ($8.87 in chips)
Seat 4: 39b943a9 ($5.68 in chips)
Seat 5: eeac0a40 ($6.03 in chips)
Seat 6: 69abf22c ($3.59 in chips)
69abf22c: posts small blind $0.02
d3c887a5: posts big blind $0.05
*** HOLE CARDS ***
Dealt to d3c887a5 
Dealt to Hero [5c 7h]
Dealt to e4fafec0 
Dealt to 39b943a9 
Dealt to eeac0a40 
Dealt to 69abf22c 
Hero: folds
e4fafec0: folds
39b943a9: folds
eeac0a40: raises $0.08 to $0.13
69abf22c: folds
d3c887a5: calls $0.08
*** FLOP *** [6s 8c Ac]
d3c887a5: checks
eeac0a40: bets $0.13
d3c887a5: folds
Uncalled bet ($0.13) returned to eeac0a40
*** SHOWDOWN ***
eeac0a40 collected $0.27 from pot
*** SUMMARY ***
Total pot $0.28 | Rake $0.01 | Jackpot $0 | Bingo $0 | Fortune $0
Board [6s 8c Ac]
Seat 1: d3c887a5 (big blind) folded on the Flop
Seat 2: Hero folded before Flop (didn't bet)
Seat 3: e4fafec0 folded before Flop (didn't bet)
Seat 4: 39b943a9 folded before Flop (didn't bet)
Seat 5: eeac0a40 (button) won ($0.27)
Seat 6: 69abf22c (small blind) folded before Flop


Poker Hand #HD1184176292: Hold'em No Limit  ($0.02/$0.05) - 2023/03/31 23:07:08
Table 'NLHBlue109' 6-max Seat #4 is the button
Seat 1: d3c887a5 ($8.7 in chips)
Seat 2: Hero ($7.04 in chips)
Seat 3: e4fafec0 ($9.07 in chips)
Seat 4: 39b943a9 ($5.88 in chips)
Seat 5: eeac0a40 ($6.05 in chips)
Seat 6: 69abf22c ($3.64 in chips)
eeac0a40: posts small blind $0.02
69abf22c: posts big blind $0.05
*** HOLE CARDS ***
Dealt to d3c887a5 
Dealt to Hero [Ks 7d]
Dealt to e4fafec0 
Dealt to 39b943a9 
Dealt to eeac0a40 
Dealt to 69abf22c 
d3c887a5: calls $0.05
Hero: folds
e4fafec0: calls $0.05
39b943a9: raises $0.15 to $0.2
eeac0a40: folds
69abf22c: folds
d3c887a5: calls $0.15
e4fafec0: calls $0.15
*** FLOP *** [6c Ad 4s]
d3c887a5: bets $0.23
e4fafec0: folds
39b943a9: folds
Uncalled bet ($0.23) returned to d3c887a5
*** SHOWDOWN ***
d3c887a5 collected $0.63 from pot
*** SUMMARY ***
Total pot $0.67 | Rake $0.04 | Jackpot $0 | Bingo $0 | Fortune $0
Board [6c Ad 4s]
Seat 1: d3c887a5 won ($0.63)
Seat 2: Hero folded before Flop (didn't bet)
Seat 3: e4fafec0 folded on the Flop
Seat 4: 39b943a9 (button) folded on the Flop
Seat 5: eeac0a40 (small blind) folded before Flop
Seat 6: 69abf22c (big blind) folded before Flop


Poker Hand #HD1184176234: Hold'em No Limit  ($0.02/$0.05) - 2023/03/31 23:06:34
Table 'NLHBlue109' 6-max Seat #3 is the button
Seat 1: d3c887a5 ($8.9 in chips)
Seat 2: Hero ($7.04 in chips)
Seat 3: e4fafec0 ($8.82 in chips)
Seat 4: 39b943a9 ($5.9 in chips)
Seat 5: eeac0a40 ($6.1 in chips)
Seat 6: 69abf22c ($3.64 in chips)
39b943a9: posts small blind $0.02
eeac0a40: posts big blind $0.05
*** HOLE CARDS ***
Dealt to d3c887a5 
Dealt to Hero [7c 9h]
Dealt to e4fafec0 
Dealt to 39b943a9 
Dealt to eeac0a40 
Dealt to 69abf22c 
69abf22c: folds
d3c887a5: calls $0.05
Hero: folds
e4fafec0: raises $0.15 to $0.2
39b943a9: folds
eeac0a40: folds
d3c887a5: calls $0.15
*** FLOP *** [2d 4s 7h]
d3c887a5: checks
e4fafec0: checks
*** TURN *** [2d 4s 7h] [2c]
d3c887a5: checks
e4fafec0: checks
*** RIVER *** [2d 4s 7h 2c] [Th]
d3c887a5: checks
e4fafec0: bets $0.36
d3c887a5: folds
Uncalled bet ($0.36) returned to e4fafec0
*** SHOWDOWN ***
e4fafec0 collected $0.45 from pot
*** SUMMARY ***
Total pot $0.47 | Rake $0.02 | Jackpot $0 | Bingo $0 | Fortune $0
Board [2d 4s 7h 2c Th]
Seat 1: d3c887a5 folded on the River
Seat 2: Hero folded before Flop (didn't bet)
Seat 3: e4fafec0 (button) won ($0.45)
Seat 4: 39b943a9 (small blind) folded before Flop
Seat 5: eeac0a40 (big blind) folded before Flop
Seat 6: 69abf22c folded before Flop (didn't bet)


Poker Hand #HD1184176192: Hold'em No Limit  ($0.02/$0.05) - 2023/03/31 23:06:03
Table 'NLHBlue109' 6-max Seat #2 is the button
Seat 1: d3c887a5 ($9.09 in chips)
Seat 2: Hero ($7.23 in chips)
Seat 3: e4fafec0 ($8.32 in chips)
Seat 4: 39b943a9 ($5.95 in chips)
Seat 5: eeac0a40 ($6.1 in chips)
Seat 6: 69abf22c ($3.74 in chips)
e4fafec0: posts small blind $0.02
39b943a9: posts big blind $0.05
*** HOLE CARDS ***
Dealt to d3c887a5 
Dealt to Hero [5s 6s]
Dealt to e4fafec0 
Dealt to 39b943a9 
Dealt to eeac0a40 
Dealt to 69abf22c 
eeac0a40: folds
69abf22c: raises $0.05 to $0.1
d3c887a5: raises $0.09 to $0.19
Hero: calls $0.19
e4fafec0: raises $8.13 to $8.32 and is all-in
39b943a9: folds
69abf22c: folds
d3c887a5: folds
Hero: folds
Uncalled bet ($8.13) returned to e4fafec0
*** SHOWDOWN ***
e4fafec0 collected $0.69 from pot
*** SUMMARY ***
Total pot $0.72 | Rake $0.03 | Jackpot $0 | Bingo $0 | Fortune $0
Seat 1: d3c887a5 folded before Flop
Seat 2: Hero (button) folded before Flop
Seat 3: e4fafec0 (small blind) collected ($0.69)
Seat 4: 39b943a9 (big blind) folded before Flop
Seat 5: eeac0a40 folded before Flop (didn't bet)
Seat 6: 69abf22c folded before Flop


Poker Hand #HD1184176123: Hold'em No Limit  ($0.02/$0.05) - 2023/03/31 23:05:21
Table 'NLHBlue109' 6-max Seat #1 is the button
Seat 1: d3c887a5 ($9.47 in chips)
Seat 2: Hero ($7.25 in chips)
Seat 3: e4fafec0 ($8.37 in chips)
Seat 4: 39b943a9 ($5.54 in chips)
Seat 5: eeac0a40 ($6.1 in chips)
Seat 6: 69abf22c ($3.74 in chips)
Hero: posts small blind $0.02
e4fafec0: posts big blind $0.05
*** HOLE CARDS ***
Dealt to d3c887a5 
Dealt to Hero [8d Th]
Dealt to e4fafec0 
Dealt to 39b943a9 
Dealt to eeac0a40 
Dealt to 69abf22c 
39b943a9: raises $0.12 to $0.17
eeac0a40: folds
69abf22c: folds
d3c887a5: raises $0.21 to $0.38
Hero: folds
e4fafec0: folds
39b943a9: calls $0.21
*** FLOP *** [3d Kd Ad]
39b943a9: checks
d3c887a5: checks
*** TURN *** [3d Kd Ad] [7s]
39b943a9: bets $0.42
d3c887a5: folds
Uncalled bet ($0.42) returned to 39b943a9
*** SHOWDOWN ***
39b943a9 collected $0.79 from pot
*** SUMMARY ***
Total pot $0.83 | Rake $0.04 | Jackpot $0 | Bingo $0 | Fortune $0
Board [3d Kd Ad 7s]
Seat 1: d3c887a5 (button) folded on the Turn
Seat 2: Hero (small blind) folded before Flop
Seat 3: e4fafec0 (big blind) folded before Flop
Seat 4: 39b943a9 won ($0.79)
Seat 5: eeac0a40 folded before Flop (didn't bet)
Seat 6: 69abf22c folded before Flop (didn't bet)


Poker Hand #HD1184176027: Hold'em No Limit  ($0.02/$0.05) - 2023/03/31 23:04:07
Table 'NLHBlue109' 6-max Seat #6 is the button
Seat 1: d3c887a5 ($11.91 in chips)
Seat 2: Hero ($5 in chips)
Seat 3: e4fafec0 ($8.37 in chips)
Seat 4: 39b943a9 ($5.54 in chips)
Seat 5: eeac0a40 ($6.1 in chips)
Seat 6: 69abf22c ($3.84 in chips)
d3c887a5: posts small blind $0.02
Hero: posts big blind $0.05
*** HOLE CARDS ***
Dealt to d3c887a5 
Dealt to Hero [9d 9s]
Dealt to e4fafec0 
Dealt to 39b943a9 
Dealt to eeac0a40 
Dealt to 69abf22c 
e4fafec0: folds
39b943a9: folds
eeac0a40: folds
69abf22c: raises $0.05 to $0.1
d3c887a5: calls $0.08
Hero: raises $0.45 to $0.55
69abf22c: folds
d3c887a5: calls $0.45
*** FLOP *** [2s 2h 3s]
d3c887a5: bets $0.9
Hero: calls $0.9
*** TURN *** [2s 2h 3s] [5d]
d3c887a5: bets $0.99
Hero: raises $2.56 to $3.55 and is all-in
d3c887a5: folds
Uncalled bet ($2.56) returned to Hero
*** SHOWDOWN ***
Hero collected $4.69 from pot
*** SUMMARY ***
Total pot $4.98 | Rake $0.24 | Jackpot $0.05 | Bingo $0 | Fortune $0
Board [2s 2h 3s 5d]
Seat 1: d3c887a5 (small blind) folded on the Turn
Seat 2: Hero (big blind) won ($4.69)
Seat 3: e4fafec0 folded before Flop (didn't bet)
Seat 4: 39b943a9 folded before Flop (didn't bet)
Seat 5: eeac0a40 folded before Flop (didn't bet)
Seat 6: 69abf22c (button) folded before Flop


Poker Hand #HD1184175979: Hold'em No Limit  ($0.02/$0.05) - 2023/03/31 23:03:31
Table 'NLHBlue109' 6-max Seat #5 is the button
Seat 1: d3c887a5 ($11.61 in chips)
Seat 2: Hero ($5 in chips)
Seat 3: e4fafec0 ($8.37 in chips)
Seat 4: 39b943a9 ($5.54 in chips)
Seat 5: eeac0a40 ($6.1 in chips)
Seat 6: 69abf22c ($3.86 in chips)
69abf22c: posts small blind $0.02
d3c887a5: posts big blind $0.05
*** HOLE CARDS ***
Dealt to d3c887a5 
Dealt to Hero [Td Ah]
Dealt to e4fafec0 
Dealt to 39b943a9 
Dealt to eeac0a40 
Dealt to 69abf22c 
Hero: raises $0.07 to $0.12
e4fafec0: folds
39b943a9: folds
eeac0a40: folds
69abf22c: folds
d3c887a5: raises $0.2 to $0.32
Hero: calls $0.2
*** FLOP *** [5s Js 9s]
d3c887a5: bets $0.33
Hero: folds
Uncalled bet ($0.33) returned to d3c887a5
*** SHOWDOWN ***
d3c887a5 collected $0.62 from pot
*** SUMMARY ***
Total pot $0.66 | Rake $0.04 | Jackpot $0 | Bingo $0 | Fortune $0
Board [5s Js 9s]
Seat 1: d3c887a5 (big blind) won ($0.62)
Seat 2: Hero folded on the Flop
Seat 3: e4fafec0 folded before Flop (didn't bet)
Seat 4: 39b943a9 folded before Flop (didn't bet)
Seat 5: eeac0a40 (button) folded before Flop (didn't bet)
Seat 6: 69abf22c (small blind) folded before Flop


Poker Hand #HD1184175931: Hold'em No Limit  ($0.02/$0.05) - 2023/03/31 23:02:55
Table 'NLHBlue109' 6-max Seat #4 is the button
Seat 1: d3c887a5 ($11.71 in chips)
Seat 2: Hero ($5 in chips)
Seat 3: e4fafec0 ($8.37 in chips)
Seat 4: 39b943a9 ($5.54 in chips)
Seat 5: eeac0a40 ($6.12 in chips)
Seat 6: 69abf22c ($3.75 in chips)
eeac0a40: posts small blind $0.02
69abf22c: posts big blind $0.05
*** HOLE CARDS ***
Dealt to d3c887a5 
Dealt to Hero [4h 6s]
Dealt to e4fafec0 
Dealt to 39b943a9 
Dealt to eeac0a40 
Dealt to 69abf22c 
d3c887a5: calls $0.05
Hero: folds
e4fafec0: folds
39b943a9: folds
eeac0a40: folds
69abf22c: checks
*** FLOP *** [Th Qd 7d]
69abf22c: checks
d3c887a5: checks
*** TURN *** [Th Qd 7d] [Qs]
69abf22c: bets $0.05
d3c887a5: calls $0.05
*** RIVER *** [Th Qd 7d Qs] [9h]
69abf22c: checks
d3c887a5: checks
69abf22c: shows [2d 7h] (Pair of Queens and Pair of Sevens)
d3c887a5: shows [5s 8s] (Pair of Queens)
*** SHOWDOWN ***
69abf22c collected $0.21 from pot
*** SUMMARY ***
Total pot $0.22 | Rake $0.01 | Jackpot $0 | Bingo $0 | Fortune $0
Board [Th Qd 7d Qs 9h]
Seat 1: d3c887a5 showed [5s 8s] and lost with Pair of Queens
Seat 2: Hero folded before Flop (didn't bet)
Seat 3: e4fafec0 folded before Flop (didn't bet)
Seat 4: 39b943a9 (button) folded before Flop (didn't bet)
Seat 5: eeac0a40 (small blind) folded before Flop
Seat 6: 69abf22c (big blind) showed [2d 7h] and won ($0.21) with Pair of Queens and Pair of Sevens


Poker Hand #HD1184175824: Hold'em No Limit  ($0.02/$0.05) - 2023/03/31 23:01:39
Table 'NLHBlue109' 6-max Seat #3 is the button
Seat 1: d3c887a5 ($11.91 in chips)
Seat 2: Hero ($5 in chips)
Seat 3: e4fafec0 ($9.03 in chips)
Seat 4: 39b943a9 ($5.74 in chips)
Seat 5: eeac0a40 ($5.19 in chips)
Seat 6: 69abf22c ($3.75 in chips)
39b943a9: posts small blind $0.02
eeac0a40: posts big blind $0.05
*** HOLE CARDS ***
Dealt to d3c887a5 
Dealt to Hero [Kc 2d]
Dealt to e4fafec0 
Dealt to 39b943a9 
Dealt to eeac0a40 
Dealt to 69abf22c 
69abf22c: folds
d3c887a5: calls $0.05
Hero: folds
e4fafec0: raises $0.15 to $0.2
39b943a9: calls $0.18
eeac0a40: calls $0.15
d3c887a5: calls $0.15
*** FLOP *** [Ts 8c Qc]
39b943a9: checks
eeac0a40: checks
d3c887a5: checks
e4fafec0: checks
*** TURN *** [Ts 8c Qc] [5s]
39b943a9: checks
eeac0a40: bets $0.46
d3c887a5: folds
e4fafec0: calls $0.46
39b943a9: folds
*** RIVER *** [Ts 8c Qc 5s] [Tc]
eeac0a40: bets $1.26
e4fafec0: folds
Uncalled bet ($1.26) returned to eeac0a40
*** SHOWDOWN ***
eeac0a40 collected $1.59 from pot
*** SUMMARY ***
Total pot $1.72 | Rake $0.08 | Jackpot $0.05 | Bingo $0 | Fortune $0
Board [Ts 8c Qc 5s Tc]
Seat 1: d3c887a5 folded on the Turn
Seat 2: Hero folded before Flop (didn't bet)
Seat 3: e4fafec0 (button) folded on the River
Seat 4: 39b943a9 (small blind) folded on the Turn
Seat 5: eeac0a40 (big blind) won ($1.59)
Seat 6: 69abf22c folded before Flop (didn't bet)


Poker Hand #HD1184175796: Hold'em No Limit  ($0.02/$0.05) - 2023/03/31 23:01:19
Table 'NLHBlue109' 6-max Seat #2 is the button
Seat 1: d3c887a5 ($11.84 in chips)
Seat 2: Hero ($5 in chips)
Seat 3: e4fafec0 ($9.05 in chips)
Seat 4: 39b943a9 ($5.79 in chips)
Seat 5: eeac0a40 ($5.19 in chips)
Seat 6: 69abf22c ($3.75 in chips)
e4fafec0: posts small blind $0.02
39b943a9: posts big blind $0.05
*** HOLE CARDS ***
Dealt to d3c887a5 
Dealt to Hero [5s Jh]
Dealt to e4fafec0 
Dealt to 39b943a9 
Dealt to eeac0a40 
Dealt to 69abf22c 
eeac0a40: folds
69abf22c: folds
d3c887a5: raises $0.05 to $0.1
Hero: folds
e4fafec0: folds
39b943a9: folds
Uncalled bet ($0.05) returned to d3c887a5
*** SHOWDOWN ***
d3c887a5 collected $0.12 from pot
*** SUMMARY ***
Total pot $0.12 | Rake $0 | Jackpot $0 | Bingo $0 | Fortune $0
Seat 1: d3c887a5 collected ($0.12)
Seat 2: Hero (button) folded before Flop (didn't bet)
Seat 3: e4fafec0 (small blind) folded before Flop
Seat 4: 39b943a9 (big blind) folded before Flop
Seat 5: eeac0a40 folded before Flop (didn't bet)
Seat 6: 69abf22c folded before Flop (didn't bet)


Poker Hand #HD1184175763: Hold'em No Limit  ($0.02/$0.05) - 2023/03/31 23:00:57
Table 'NLHBlue109' 6-max Seat #1 is the button
Seat 1: d3c887a5 ($11.89 in chips)
Seat 2: Hero ($5 in chips)
Seat 3: e4fafec0 ($8.98 in chips)
Seat 4: 39b943a9 ($5.79 in chips)
Seat 5: eeac0a40 ($5.19 in chips)
Seat 6: 69abf22c ($3.75 in chips)
Hero: posts small blind $0.02
e4fafec0: posts big blind $0.05
*** HOLE CARDS ***
Dealt to d3c887a5 
Dealt to Hero [9s Kh]
Dealt to e4fafec0 
Dealt to 39b943a9 
Dealt to eeac0a40 
Dealt to 69abf22c 
39b943a9: folds
eeac0a40: folds
69abf22c: folds
d3c887a5: calls $0.05
Hero: folds
e4fafec0: checks
*** FLOP *** [4d Jh Qh]
e4fafec0: checks
d3c887a5: checks
*** TURN *** [4d Jh Qh] [Ks]
e4fafec0: bets $0.09
d3c887a5: folds
Uncalled bet ($0.09) returned to e4fafec0
*** SHOWDOWN ***
e4fafec0 collected $0.12 from pot
*** SUMMARY ***
Total pot $0.12 | Rake $0 | Jackpot $0 | Bingo $0 | Fortune $0
Board [4d Jh Qh Ks]
Seat 1: d3c887a5 (button) folded on the Turn
Seat 2: Hero (small blind) folded before Flop
Seat 3: e4fafec0 (big blind) won ($0.12)
Seat 4: 39b943a9 folded before Flop (didn't bet)
Seat 5: eeac0a40 folded before Flop (didn't bet)
Seat 6: 69abf22c folded before Flop (didn't bet)


Poker Hand #HD1184175706: Hold'em No Limit  ($0.02/$0.05) - 2023/03/31 23:00:24
Table 'NLHBlue109' 6-max Seat #6 is the button
Seat 1: d3c887a5 ($12.02 in chips)
Seat 2: Hero ($5 in chips)
Seat 3: e4fafec0 ($8.81 in chips)
Seat 4: 39b943a9 ($5.79 in chips)
Seat 5: eeac0a40 ($5.19 in chips)
Seat 6: 69abf22c ($3.75 in chips)
d3c887a5: posts small blind $0.02
Hero: posts big blind $0.05
*** HOLE CARDS ***
Dealt to d3c887a5 
Dealt to Hero [3d Ts]
Dealt to e4fafec0 
Dealt to 39b943a9 
Dealt to eeac0a40 
Dealt to 69abf22c 
e4fafec0: raises $0.08 to $0.13
39b943a9: folds
eeac0a40: folds
69abf22c: folds
d3c887a5: calls $0.11
Hero: folds
*** FLOP *** [5d 6d Kh]
d3c887a5: checks
e4fafec0: bets $0.24
d3c887a5: folds
Uncalled bet ($0.24) returned to e4fafec0
*** SHOWDOWN ***
e4fafec0 collected $0.3 from pot
*** SUMMARY ***
Total pot $0.31 | Rake $0.01 | Jackpot $0 | Bingo $0 | Fortune $0
Board [5d 6d Kh]
Seat 1: d3c887a5 (small blind) folded on the Flop
Seat 2: Hero (big blind) folded before Flop
Seat 3: e4fafec0 won ($0.3)
Seat 4: 39b943a9 folded before Flop (didn't bet)
Seat 5: eeac0a40 folded before Flop (didn't bet)
Seat 6: 69abf22c (button) folded before Flop (didn't bet)


Poker Hand #HD1184085639: Hold'em No Limit  ($0.02/$0.05) - 2023/03/31 22:59:36
Table 'NLHBlue109' 6-max Seat #5 is the button
Seat 1: d3c887a5 ($12.43 in chips)
Seat 2: Hero ($5 in chips)
Seat 3: e4fafec0 ($8.42 in chips)
Seat 4: 39b943a9 ($5.79 in chips)
Seat 5: eeac0a40 ($5.19 in chips)
Seat 6: 69abf22c ($3.77 in chips)
69abf22c: posts small blind $0.02
d3c887a5: posts big blind $0.05
*** HOLE CARDS ***
Dealt to d3c887a5 
Dealt to Hero [Kc 8d]
Dealt to e4fafec0 
Dealt to 39b943a9 
Dealt to eeac0a40 
Dealt to 69abf22c 
Hero: folds
e4fafec0: raises $0.08 to $0.13
39b943a9: folds
eeac0a40: folds
69abf22c: folds
d3c887a5: calls $0.08
*** FLOP *** [4h 2h 5h]
d3c887a5: checks
e4fafec0: bets $0.28
d3c887a5: calls $0.28
*** TURN *** [4h 2h 5h] [8c]
d3c887a5: checks
e4fafec0: bets $0.84
d3c887a5: folds
Uncalled bet ($0.84) returned to e4fafec0
*** SHOWDOWN ***
e4fafec0 collected $0.8 from pot
*** SUMMARY ***
Total pot $0.84 | Rake $0.04 | Jackpot $0 | Bingo $0 | Fortune $0
Board [4h 2h 5h 8c]
Seat 1: d3c887a5 (big blind) folded on the Turn
Seat 2: Hero folded before Flop (didn't bet)
Seat 3: e4fafec0 won ($0.8)
Seat 4: 39b943a9 folded before Flop (didn't bet)
Seat 5: eeac0a40 (button) folded before Flop (didn't bet)
Seat 6: 69abf22c (small blind) folded before Flop


Poker Hand #HD1184085534: Hold'em No Limit  ($0.02/$0.05) - 2023/03/31 22:58:31
Table 'NLHBlue109' 6-max Seat #4 is the button
Seat 1: d3c887a5 ($12.03 in chips)
Seat 2: Hero ($5 in chips)
Seat 3: e4fafec0 ($8.42 in chips)
Seat 4: 39b943a9 ($5.79 in chips)
Seat 5: eeac0a40 ($5.21 in chips)
Seat 6: 69abf22c ($4.2 in chips)
eeac0a40: posts small blind $0.02
69abf22c: posts big blind $0.05
*** HOLE CARDS ***
Dealt to d3c887a5 
Dealt to Hero [Qc 3h]
Dealt to e4fafec0 
Dealt to 39b943a9 
Dealt to eeac0a40 
Dealt to 69abf22c 
d3c887a5: raises $0.1 to $0.15
Hero: folds
e4fafec0: folds
39b943a9: folds
eeac0a40: folds
69abf22c: calls $0.1
*** FLOP *** [8c Td 2h]
69abf22c: checks
d3c887a5: bets $0.28
69abf22c: calls $0.28
*** TURN *** [8c Td 2h] [Ad]
69abf22c: checks
d3c887a5: bets $0.66
69abf22c: folds
Uncalled bet ($0.66) returned to d3c887a5
*** SHOWDOWN ***
d3c887a5 collected $0.83 from pot
*** SUMMARY ***
Total pot $0.88 | Rake $0.05 | Jackpot $0 | Bingo $0 | Fortune $0
Board [8c Td 2h Ad]
Seat 1: d3c887a5 won ($0.83)
Seat 2: Hero folded before Flop (didn't bet)
Seat 3: e4fafec0 folded before Flop (didn't bet)
Seat 4: 39b943a9 (button) folded before Flop (didn't bet)
Seat 5: eeac0a40 (small blind) folded before Flop
Seat 6: 69abf22c (big blind) folded on the Turn


Poker Hand #HD1184085434: Hold'em No Limit  ($0.02/$0.05) - 2023/03/31 22:57:28
Table 'NLHBlue109' 6-max Seat #3 is the button
Seat 1: d3c887a5 ($9.69 in chips)
Seat 2: Hero ($5 in chips)
Seat 3: e4fafec0 ($8.42 in chips)
Seat 4: 39b943a9 ($5.81 in chips)
Seat 5: eeac0a40 ($7.9 in chips)
Seat 6: 69abf22c ($4.2 in chips)
39b943a9: posts small blind $0.02
eeac0a40: posts big blind $0.05
*** HOLE CARDS ***
Dealt to d3c887a5 
Dealt to Hero [7s Ks]
Dealt to e4fafec0 
Dealt to 39b943a9 
Dealt to eeac0a40 
Dealt to 69abf22c 
69abf22c: folds
d3c887a5: calls $0.05
Hero: folds
e4fafec0: folds
39b943a9: folds
eeac0a40: raises $0.21 to $0.26
d3c887a5: calls $0.21
*** FLOP *** [Jc Jh 8s]
eeac0a40: checks
d3c887a5: bets $0.27
eeac0a40: calls $0.27
*** TURN *** [Jc Jh 8s] [9h]
eeac0a40: checks
d3c887a5: bets $0.81
eeac0a40: calls $0.81
*** RIVER *** [Jc Jh 8s 9h] [8d]
eeac0a40: checks
d3c887a5: bets $1.35
eeac0a40: calls $1.35
d3c887a5: shows [4s 8c] (Eights Full over Jacks)
eeac0a40: shows [Ac Ad] (Pair of Aces and Pair of Jacks)
*** SHOWDOWN ***
d3c887a5 collected $5.03 from pot
*** SUMMARY ***
Total pot $5.4 | Rake $0.32 | Jackpot $0.05 | Bingo $0 | Fortune $0
Board [Jc Jh 8s 9h 8d]
Seat 1: d3c887a5 showed [4s 8c] and won ($5.03) with Eights Full over Jacks
Seat 2: Hero folded before Flop (didn't bet)
Seat 3: e4fafec0 (button) folded before Flop (didn't bet)
Seat 4: 39b943a9 (small blind) folded before Flop
Seat 5: eeac0a40 (big blind) showed [Ac Ad] and lost with Pair of Aces and Pair of Jacks
Seat 6: 69abf22c folded before Flop (didn't bet)


Poker Hand #HD1184085350: Hold'em No Limit  ($0.02/$0.05) - 2023/03/31 22:56:33
Table 'NLHBlue109' 6-max Seat #2 is the button
Seat 1: d3c887a5 ($10.14 in chips)
Seat 2: Hero ($5.32 in chips)
Seat 3: e4fafec0 ($7.54 in chips)
Seat 4: 39b943a9 ($5.86 in chips)
Seat 5: eeac0a40 ($7.9 in chips)
Seat 6: 69abf22c ($4.2 in chips)
e4fafec0: posts small blind $0.02
39b943a9: posts big blind $0.05
*** HOLE CARDS ***
Dealt to d3c887a5 
Dealt to Hero [4s 4h]
Dealt to e4fafec0 
Dealt to 39b943a9 
Dealt to eeac0a40 
Dealt to 69abf22c 
eeac0a40: folds
69abf22c: folds
d3c887a5: raises $0.05 to $0.1
Hero: calls $0.1
e4fafec0: raises $0.35 to $0.45
39b943a9: folds
d3c887a5: calls $0.35
Hero: calls $0.35
*** FLOP *** [Tc 7h Ad]
e4fafec0: checks
d3c887a5: checks
Hero: checks
*** TURN *** [Tc 7h Ad] [5h]
e4fafec0: bets $1.05
d3c887a5: folds
Hero: folds
Uncalled bet ($1.05) returned to e4fafec0
*** SHOWDOWN ***
e4fafec0 collected $1.33 from pot
*** SUMMARY ***
Total pot $1.4 | Rake $0.07 | Jackpot $0 | Bingo $0 | Fortune $0
Board [Tc 7h Ad 5h]
Seat 1: d3c887a5 folded on the Turn
Seat 2: Hero (button) folded on the Turn
Seat 3: e4fafec0 (small blind) won ($1.33)
Seat 4: 39b943a9 (big blind) folded before Flop
Seat 5: eeac0a40 folded before Flop (didn't bet)
Seat 6: 69abf22c folded before Flop (didn't bet)


Poker Hand #HD1184085292: Hold'em No Limit  ($0.02/$0.05) - 2023/03/31 22:55:54
Table 'NLHBlue109' 6-max Seat #1 is the button
Seat 1: d3c887a5 ($10.39 in chips)
Seat 2: Hero ($5 in chips)
Seat 3: e4fafec0 ($7.64 in chips)
Seat 4: 39b943a9 ($5.86 in chips)
Seat 5: eeac0a40 ($7.9 in chips)
Seat 6: 69abf22c ($4.2 in chips)
Hero: posts small blind $0.02
e4fafec0: posts big blind $0.05
*** HOLE CARDS ***
Dealt to d3c887a5 
Dealt to Hero [5h 5c]
Dealt to e4fafec0 
Dealt to 39b943a9 
Dealt to eeac0a40 
Dealt to 69abf22c 
39b943a9: folds
eeac0a40: folds
69abf22c: folds
d3c887a5: raises $0.05 to $0.1
Hero: calls $0.08
e4fafec0: calls $0.05
*** FLOP *** [4c 7d 8d]
Hero: checks
e4fafec0: checks
d3c887a5: checks
*** TURN *** [4c 7d 8d] [As]
Hero: bets $0.15
e4fafec0: folds
d3c887a5: calls $0.15
*** RIVER *** [4c 7d 8d As] [7h]
Hero: bets $0.3
d3c887a5: folds
Uncalled bet ($0.3) returned to Hero
*** SHOWDOWN ***
Hero collected $0.57 from pot
*** SUMMARY ***
Total pot $0.6 | Rake $0.03 | Jackpot $0 | Bingo $0 | Fortune $0
Board [4c 7d 8d As 7h]
Seat 1: d3c887a5 (button) folded on the River
Seat 2: Hero (small blind) won ($0.57)
Seat 3: e4fafec0 (big blind) folded on the Turn
Seat 4: 39b943a9 folded before Flop (didn't bet)
Seat 5: eeac0a40 folded before Flop (didn't bet)
Seat 6: 69abf22c folded before Flop (didn't bet)


Poker Hand #HD1184085230: Hold'em No Limit  ($0.02/$0.05) - 2023/03/31 22:55:14
Table 'NLHBlue109' 6-max Seat #6 is the button
Seat 1: d3c887a5 ($10.52 in chips)
Seat 2: Hero ($5 in chips)
Seat 3: e4fafec0 ($7.04 in chips)
Seat 4: 39b943a9 ($5.99 in chips)
Seat 5: eeac0a40 ($7.9 in chips)
Seat 6: 69abf22c ($4.2 in chips)
d3c887a5: posts small blind $0.02
Hero: posts big blind $0.05
*** HOLE CARDS ***
Dealt to d3c887a5 
Dealt to Hero [5h 5d]
Dealt to e4fafec0 
Dealt to 39b943a9 
Dealt to eeac0a40 
Dealt to 69abf22c 
e4fafec0: raises $0.08 to $0.13
39b943a9: calls $0.13
eeac0a40: folds
69abf22c: folds
d3c887a5: calls $0.11
Hero: calls $0.08
*** FLOP *** [3c Qd Ah]
d3c887a5: checks
Hero: checks
e4fafec0: bets $0.26
39b943a9: folds
d3c887a5: folds
Hero: calls $0.26
*** TURN *** [3c Qd Ah] [2s]
Hero: checks
e4fafec0: checks
*** RIVER *** [3c Qd Ah 2s] [Tc]
Hero: checks
e4fafec0: bets $1.04
Hero: folds
Uncalled bet ($1.04) returned to e4fafec0
*** SHOWDOWN ***
e4fafec0 collected $0.99 from pot
*** SUMMARY ***
Total pot $1.04 | Rake $0.05 | Jackpot $0 | Bingo $0 | Fortune $0
Board [3c Qd Ah 2s Tc]
Seat 1: d3c887a5 (small blind) folded on the Flop
Seat 2: Hero (big blind) folded on the River
Seat 3: e4fafec0 won ($0.99)
Seat 4: 39b943a9 folded on the Flop
Seat 5: eeac0a40 folded before Flop (didn't bet)
Seat 6: 69abf22c (button) folded before Flop (didn't bet)


Poker Hand #HD1184085159: Hold'em No Limit  ($0.02/$0.05) - 2023/03/31 22:54:38
Table 'NLHBlue109' 6-max Seat #5 is the button
Seat 1: d3c887a5 ($10.85 in chips)
Seat 2: Hero ($5 in chips)
Seat 3: e4fafec0 ($6.62 in chips)
Seat 4: 39b943a9 ($5.99 in chips)
Seat 5: eeac0a40 ($7.9 in chips)
Seat 6: 69abf22c ($4.33 in chips)
69abf22c: posts small blind $0.02
d3c887a5: posts big blind $0.05
*** HOLE CARDS ***
Dealt to d3c887a5 
Dealt to Hero [Th 3h]
Dealt to e4fafec0 
Dealt to 39b943a9 
Dealt to eeac0a40 
Dealt to 69abf22c 
Hero: folds
e4fafec0: raises $0.08 to $0.13
39b943a9: folds
eeac0a40: folds
69abf22c: calls $0.11
d3c887a5: calls $0.08
*** FLOP *** [Ks Kh 3c]
69abf22c: checks
d3c887a5: bets $0.2
e4fafec0: raises $0.79 to $0.99
69abf22c: folds
d3c887a5: folds
Uncalled bet ($0.79) returned to e4fafec0
*** SHOWDOWN ***
e4fafec0 collected $0.75 from pot
*** SUMMARY ***
Total pot $0.79 | Rake $0.04 | Jackpot $0 | Bingo $0 | Fortune $0
Board [Ks Kh 3c]
Seat 1: d3c887a5 (big blind) folded on the Flop
Seat 2: Hero folded before Flop (didn't bet)
Seat 3: e4fafec0 won ($0.75)
Seat 4: 39b943a9 folded before Flop (didn't bet)
Seat 5: eeac0a40 (button) folded before Flop (didn't bet)
Seat 6: 69abf22c (small blind) folded on the Flop


Poker Hand #HD1184085106: Hold'em No Limit  ($0.02/$0.05) - 2023/03/31 22:54:09
Table 'NLHBlue109' 6-max Seat #4 is the button
Seat 1: d3c887a5 ($10.6 in chips)
Seat 2: Hero ($5 in chips)
Seat 3: e4fafec0 ($6.72 in chips)
Seat 4: 39b943a9 ($6.09 in chips)
Seat 5: eeac0a40 ($7.92 in chips)
Seat 6: 69abf22c ($4.38 in chips)
eeac0a40: posts small blind $0.02
69abf22c: posts big blind $0.05
*** HOLE CARDS ***
Dealt to d3c887a5 
Dealt to Hero [Jc 8h]
Dealt to e4fafec0 
Dealt to 39b943a9 
Dealt to eeac0a40 
Dealt to 69abf22c 
d3c887a5: raises $0.05 to $0.1
Hero: folds
e4fafec0: calls $0.1
39b943a9: calls $0.1
eeac0a40: folds
69abf22c: folds
*** FLOP *** [3h 9d 8c]
d3c887a5: bets $0.37
e4fafec0: folds
39b943a9: folds
Uncalled bet ($0.37) returned to d3c887a5
*** SHOWDOWN ***
d3c887a5 collected $0.35 from pot
*** SUMMARY ***
Total pot $0.37 | Rake $0.02 | Jackpot $0 | Bingo $0 | Fortune $0
Board [3h 9d 8c]
Seat 1: d3c887a5 won ($0.35)
Seat 2: Hero folded before Flop (didn't bet)
Seat 3: e4fafec0 folded on the Flop
Seat 4: 39b943a9 (button) folded on the Flop
Seat 5: eeac0a40 (small blind) folded before Flop
Seat 6: 69abf22c (big blind) folded before Flop


Poker Hand #HD1184085016: Hold'em No Limit  ($0.02/$0.05) - 2023/03/31 22:53:06
Table 'NLHBlue109' 6-max Seat #3 is the button
Seat 1: d3c887a5 ($10.7 in chips)
Seat 2: Hero ($5 in chips)
Seat 3: e4fafec0 ($6.72 in chips)
Seat 4: 39b943a9 ($6.11 in chips)
Seat 5: eeac0a40 ($7.97 in chips)
Seat 6: 69abf22c ($3.56 in chips)
39b943a9: posts small blind $0.02
eeac0a40: posts big blind $0.05
*** HOLE CARDS ***
Dealt to d3c887a5 
Dealt to Hero [Kd Ac]
Dealt to e4fafec0 
Dealt to 39b943a9 
Dealt to eeac0a40 
Dealt to 69abf22c 
69abf22c: raises $0.05 to $0.1
d3c887a5: calls $0.1
Hero: raises $0.3 to $0.4
e4fafec0: folds
39b943a9: folds
eeac0a40: folds
69abf22c: calls $0.3
d3c887a5: folds
*** FLOP *** [7s 3d 7h]
69abf22c: checks
Hero: checks
*** TURN *** [7s 3d 7h] [Td]
69abf22c: bets $0.38
Hero: calls $0.38
*** RIVER *** [7s 3d 7h Td] [7d]
69abf22c: checks
Hero: checks
69abf22c: shows [5h 5s] (Sevens Full over Fives)
Hero: shows [Kd Ac] (Three Sevens)
*** SHOWDOWN ***
69abf22c collected $1.6 from pot
*** SUMMARY ***
Total pot $1.73 | Rake $0.08 | Jackpot $0.05 | Bingo $0 | Fortune $0
Board [7s 3d 7h Td 7d]
Seat 1: d3c887a5 folded before Flop
Seat 2: Hero showed [Kd Ac] and lost with Three Sevens
Seat 3: e4fafec0 (button) folded before Flop (didn't bet)
Seat 4: 39b943a9 (small blind) folded before Flop
Seat 5: eeac0a40 (big blind) folded before Flop
Seat 6: 69abf22c showed [5h 5s] and won ($1.6) with Sevens Full over Fives


Poker Hand #HD1184084958: Hold'em No Limit  ($0.02/$0.05) - 2023/03/31 22:52:25
Table 'NLHBlue109' 6-max Seat #2 is the button
Seat 1: d3c887a5 ($10.23 in chips)
Seat 2: Hero ($5 in chips)
Seat 3: e4fafec0 ($7.2 in chips)
Seat 4: 39b943a9 ($6.16 in chips)
Seat 5: eeac0a40 ($7.97 in chips)
Seat 6: 69abf22c ($3.56 in chips)
e4fafec0: posts small blind $0.02
39b943a9: posts big blind $0.05
*** HOLE CARDS ***
Dealt to d3c887a5 
Dealt to Hero [As 6d]
Dealt to e4fafec0 
Dealt to 39b943a9 
Dealt to eeac0a40 
Dealt to 69abf22c 
eeac0a40: folds
69abf22c: folds
d3c887a5: raises $0.43 to $0.48
Hero: folds
e4fafec0: calls $0.46
39b943a9: folds
*** FLOP *** [9d Kc 5s]
e4fafec0: checks
d3c887a5: bets $0.76
e4fafec0: folds
Uncalled bet ($0.76) returned to d3c887a5
*** SHOWDOWN ***
d3c887a5 collected $0.95 from pot
*** SUMMARY ***
Total pot $1.01 | Rake $0.06 | Jackpot $0 | Bingo $0 | Fortune $0
Board [9d Kc 5s]
Seat 1: d3c887a5 won ($0.95)
Seat 2: Hero (button) folded before Flop (didn't bet)
Seat 3: e4fafec0 (small blind) folded on the Flop
Seat 4: 39b943a9 (big blind) folded before Flop
Seat 5: eeac0a40 folded before Flop (didn't bet)
Seat 6: 69abf22c folded before Flop (didn't bet)


Poker Hand #HD1184084890: Hold'em No Limit  ($0.02/$0.05) - 2023/03/31 22:51:45
Table 'NLHBlue109' 6-max Seat #1 is the button
Seat 1: d3c887a5 ($9.97 in chips)
Seat 2: Hero ($5 in chips)
Seat 3: e4fafec0 ($7.47 in chips)
Seat 4: 39b943a9 ($6.16 in chips)
Seat 5: eeac0a40 ($7.97 in chips)
Seat 6: 69abf22c ($3.56 in chips)
Hero: posts small blind $0.02
e4fafec0: posts big blind $0.05
*** HOLE CARDS ***
Dealt to d3c887a5 
Dealt to Hero [4s 6h]
Dealt to e4fafec0 
Dealt to 39b943a9 
Dealt to eeac0a40 
Dealt to 69abf22c 
39b943a9: folds
eeac0a40: folds
69abf22c: folds
d3c887a5: raises $0.05 to $0.1
Hero: folds
e4fafec0: calls $0.05
*** FLOP *** [2d Jd 7d]
e4fafec0: checks
d3c887a5: checks
*** TURN *** [2d Jd 7d] [6d]
e4fafec0: bets $0.17
d3c887a5: raises $0.42 to $0.59
e4fafec0: folds
Uncalled bet ($0.42) returned to d3c887a5
*** SHOWDOWN ***
d3c887a5 collected $0.53 from pot
*** SUMMARY ***
Total pot $0.56 | Rake $0.03 | Jackpot $0 | Bingo $0 | Fortune $0
Board [2d Jd 7d 6d]
Seat 1: d3c887a5 (button) won ($0.53)
Seat 2: Hero (small blind) folded before Flop
Seat 3: e4fafec0 (big blind) folded on the Turn
Seat 4: 39b943a9 folded before Flop (didn't bet)
Seat 5: eeac0a40 folded before Flop (didn't bet)
Seat 6: 69abf22c folded before Flop (didn't bet)


Poker Hand #HD1184084808: Hold'em No Limit  ($0.02/$0.05) - 2023/03/31 22:50:51
Table 'NLHBlue109' 6-max Seat #6 is the button
Seat 1: d3c887a5 ($10.3 in chips)
Seat 2: Hero ($5 in chips)
Seat 3: e4fafec0 ($7.47 in chips)
Seat 4: 39b943a9 ($6.16 in chips)
Seat 5: eeac0a40 ($7.55 in chips)
Seat 6: 69abf22c ($3.56 in chips)
d3c887a5: posts small blind $0.02
Hero: posts big blind $0.05
*** HOLE CARDS ***
Dealt to d3c887a5 
Dealt to Hero [Th As]
Dealt to e4fafec0 
Dealt to 39b943a9 
Dealt to eeac0a40 
Dealt to 69abf22c 
e4fafec0: folds
39b943a9: folds
eeac0a40: raises $0.08 to $0.13
69abf22c: folds
d3c887a5: calls $0.11
Hero: calls $0.08
*** FLOP *** [Kc 2s 9c]
d3c887a5: checks
Hero: checks
eeac0a40: checks
*** TURN *** [Kc 2s 9c] [7s]
d3c887a5: checks
Hero: checks
eeac0a40: bets $0.2
d3c887a5: calls $0.2
Hero: folds
*** RIVER *** [Kc 2s 9c 7s] [Ad]
d3c887a5: checks
eeac0a40: checks
d3c887a5: shows [8h Ts] (Ace-High)
eeac0a40: shows [8d 9d] (Pair of Nines)
*** SHOWDOWN ***
eeac0a40 collected $0.75 from pot
*** SUMMARY ***
Total pot $0.79 | Rake $0.04 | Jackpot $0 | Bingo $0 | Fortune $0
Board [Kc 2s 9c 7s Ad]
Seat 1: d3c887a5 (small blind) showed [8h Ts] and lost with Ace-High
Seat 2: Hero (big blind) folded on the Turn
Seat 3: e4fafec0 folded before Flop (didn't bet)
Seat 4: 39b943a9 folded before Flop (didn't bet)
Seat 5: eeac0a40 showed [8d 9d] and won ($0.75) with Pair of Nines
Seat 6: 69abf22c (button) folded before Flop (didn't bet)


Poker Hand #HD1184084726: Hold'em No Limit  ($0.02/$0.05) - 2023/03/31 22:49:56
Table 'NLHBlue109' 6-max Seat #5 is the button
Seat 1: d3c887a5 ($9.92 in chips)
Seat 2: Hero ($5 in chips)
Seat 3: e4fafec0 ($7.6 in chips)
Seat 4: 39b943a9 ($6.29 in chips)
Seat 5: eeac0a40 ($7.68 in chips)
Seat 6: 69abf22c ($3.58 in chips)
69abf22c: posts small blind $0.02
d3c887a5: posts big blind $0.05
*** HOLE CARDS ***
Dealt to d3c887a5 
Dealt to Hero [8s 4s]
Dealt to e4fafec0 
Dealt to 39b943a9 
Dealt to eeac0a40 
Dealt to 69abf22c 
Hero: folds
e4fafec0: raises $0.08 to $0.13
39b943a9: calls $0.13
eeac0a40: calls $0.13
69abf22c: folds
d3c887a5: calls $0.08
*** FLOP *** [Kd Td 4d]
d3c887a5: checks
e4fafec0: checks
39b943a9: checks
eeac0a40: checks
*** TURN *** [Kd Td 4d] [Ad]
d3c887a5: bets $0.41
e4fafec0: folds
39b943a9: folds
eeac0a40: folds
Uncalled bet ($0.41) returned to d3c887a5
*** SHOWDOWN ***
d3c887a5 collected $0.51 from pot
*** SUMMARY ***
Total pot $0.54 | Rake $0.03 | Jackpot $0 | Bingo $0 | Fortune $0
Board [Kd Td 4d Ad]
Seat 1: d3c887a5 (big blind) won ($0.51)
Seat 2: Hero folded before Flop (didn't bet)
Seat 3: e4fafec0 folded on the Turn
Seat 4: 39b943a9 folded on the Turn
Seat 5: eeac0a40 (button) folded on the Turn
Seat 6: 69abf22c (small blind) folded before Flop


Poker Hand #HD1184084641: Hold'em No Limit  ($0.02/$0.05) - 2023/03/31 22:49:00
Table 'NLHBlue109' 6-max Seat #4 is the button
Seat 1: d3c887a5 ($10.79 in chips)
Seat 2: Hero ($5 in chips)
Seat 3: e4fafec0 ($7.8 in chips)
Seat 4: 39b943a9 ($5.29 in chips)
Seat 5: eeac0a40 ($7.7 in chips)
Seat 6: 69abf22c ($3.63 in chips)
eeac0a40: posts small blind $0.02
69abf22c: posts big blind $0.05
*** HOLE CARDS ***
Dealt to d3c887a5 
Dealt to Hero [Qd Js]
Dealt to e4fafec0 
Dealt to 39b943a9 
Dealt to eeac0a40 
Dealt to 69abf22c 
d3c887a5: raises $0.15 to $0.2
Hero: folds
e4fafec0: calls $0.2
39b943a9: raises $0.67 to $0.87
eeac0a40: folds
69abf22c: folds
d3c887a5: calls $0.67
e4fafec0: folds
*** FLOP *** [9d Th 9c]
d3c887a5: checks
39b943a9: checks
*** TURN *** [9d Th 9c] [Kh]
d3c887a5: checks
39b943a9: bets $1.01
d3c887a5: folds
Uncalled bet ($1.01) returned to 39b943a9
*** SHOWDOWN ***
39b943a9 collected $1.87 from pot
*** SUMMARY ***
Total pot $2.01 | Rake $0.09 | Jackpot $0.05 | Bingo $0 | Fortune $0
Board [9d Th 9c Kh]
Seat 1: d3c887a5 folded on the Turn
Seat 2: Hero folded before Flop (didn't bet)
Seat 3: e4fafec0 folded before Flop
Seat 4: 39b943a9 (button) won ($1.87)
Seat 5: eeac0a40 (small blind) folded before Flop
Seat 6: 69abf22c (big blind) folded before Flop


Poker Hand #HD1184084506: Hold'em No Limit  ($0.02/$0.05) - 2023/03/31 22:47:45
Table 'NLHBlue109' 6-max Seat #3 is the button
Seat 1: d3c887a5 ($8.84 in chips)
Seat 2: Hero ($5 in chips)
Seat 3: e4fafec0 ($9.78 in chips)
Seat 4: 39b943a9 ($5.31 in chips)
Seat 5: eeac0a40 ($7.75 in chips)
Seat 6: 69abf22c ($3.63 in chips)
39b943a9: posts small blind $0.02
eeac0a40: posts big blind $0.05
*** HOLE CARDS ***
Dealt to d3c887a5 
Dealt to Hero [7d 7c]
Dealt to e4fafec0 
Dealt to 39b943a9 
Dealt to eeac0a40 
Dealt to 69abf22c 
69abf22c: folds
d3c887a5: calls $0.05
Hero: raises $0.15 to $0.2
e4fafec0: calls $0.2
39b943a9: folds
eeac0a40: folds
d3c887a5: calls $0.15
*** FLOP *** [5d Kh 6d]
d3c887a5: checks
Hero: checks
e4fafec0: checks
*** TURN *** [5d Kh 6d] [2c]
d3c887a5: checks
Hero: checks
e4fafec0: bets $0.51
d3c887a5: calls $0.51
Hero: folds
*** RIVER *** [5d Kh 6d 2c] [4h]
d3c887a5: checks
e4fafec0: bets $1.27
d3c887a5: calls $1.27
e4fafec0: shows [9c Jd] (King-High)
d3c887a5: shows [3s 2h] (Sixes-High Straight)
*** SHOWDOWN ***
d3c887a5 collected $3.93 from pot
*** SUMMARY ***
Total pot $4.23 | Rake $0.25 | Jackpot $0.05 | Bingo $0 | Fortune $0
Board [5d Kh 6d 2c 4h]
Seat 1: d3c887a5 showed [3s 2h] and won ($3.93) with Sixes-High Straight
Seat 2: Hero folded on the Turn
Seat 3: e4fafec0 (button) showed [9c Jd] and lost with King-High
Seat 4: 39b943a9 (small blind) folded before Flop
Seat 5: eeac0a40 (big blind) folded before Flop
Seat 6: 69abf22c folded before Flop (didn't bet)


Poker Hand #HD1184084480: Hold'em No Limit  ($0.02/$0.05) - 2023/03/31 22:47:29
Table 'NLHBlue109' 6-max Seat #2 is the button
Seat 1: d3c887a5 ($8.77 in chips)
Seat 2: Hero ($5 in chips)
Seat 3: e4fafec0 ($9.8 in chips)
Seat 4: 39b943a9 ($5.36 in chips)
Seat 5: eeac0a40 ($7.75 in chips)
Seat 6: 69abf22c ($3.63 in chips)
e4fafec0: posts small blind $0.02
39b943a9: posts big blind $0.05
*** HOLE CARDS ***
Dealt to d3c887a5 
Dealt to Hero [Kc 2h]
Dealt to e4fafec0 
Dealt to 39b943a9 
Dealt to eeac0a40 
Dealt to 69abf22c 
eeac0a40: folds
69abf22c: folds
d3c887a5: raises $0.1 to $0.15
Hero: folds
e4fafec0: folds
39b943a9: folds
Uncalled bet ($0.1) returned to d3c887a5
*** SHOWDOWN ***
d3c887a5 collected $0.12 from pot
*** SUMMARY ***
Total pot $0.12 | Rake $0 | Jackpot $0 | Bingo $0 | Fortune $0
Seat 1: d3c887a5 collected ($0.12)
Seat 2: Hero (button) folded before Flop (didn't bet)
Seat 3: e4fafec0 (small blind) folded before Flop
Seat 4: 39b943a9 (big blind) folded before Flop
Seat 5: eeac0a40 folded before Flop (didn't bet)
Seat 6: 69abf22c folded before Flop (didn't bet)


Poker Hand #HD1184084408: Hold'em No Limit  ($0.02/$0.05) - 2023/03/31 22:46:48
Table 'NLHBlue109' 6-max Seat #1 is the button
Seat 1: d3c887a5 ($9.96 in chips)
Seat 2: Hero ($5 in chips)
Seat 3: e4fafec0 ($8.75 in chips)
Seat 4: 39b943a9 ($5.36 in chips)
Seat 5: eeac0a40 ($7.75 in chips)
Seat 6: 69abf22c ($3.63 in chips)
Hero: posts small blind $0.02
e4fafec0: posts big blind $0.05
*** HOLE CARDS ***
Dealt to d3c887a5 
Dealt to Hero [Jd Qc]
Dealt to e4fafec0 
Dealt to 39b943a9 
Dealt to eeac0a40 
Dealt to 69abf22c 
39b943a9: folds
eeac0a40: folds
69abf22c: folds
d3c887a5: raises $0.1 to $0.15
Hero: folds
e4fafec0: calls $0.1
*** FLOP *** [Th 9h 2d]
e4fafec0: checks
d3c887a5: bets $0.24
e4fafec0: calls $0.24
*** TURN *** [Th 9h 2d] [3s]
e4fafec0: checks
d3c887a5: bets $0.8
e4fafec0: calls $0.8
*** RIVER *** [Th 9h 2d 3s] [9s]
e4fafec0: checks
d3c887a5: checks
e4fafec0: shows [Qs Tc] (Pair of Tens and Pair of Nines)
d3c887a5: shows [Jc Ts] (Pair of Tens and Pair of Nines)
*** SHOWDOWN ***
e4fafec0 collected $2.24 from pot
*** SUMMARY ***
Total pot $2.4 | Rake $0.11 | Jackpot $0.05 | Bingo $0 | Fortune $0
Board [Th 9h 2d 3s 9s]
Seat 1: d3c887a5 (button) showed [Jc Ts] and lost with Pair of Tens and Pair of Nines
Seat 2: Hero (small blind) folded before Flop
Seat 3: e4fafec0 (big blind) showed [Qs Tc] and won ($2.24) with Pair of Tens and Pair of Nines
Seat 4: 39b943a9 folded before Flop (didn't bet)
Seat 5: eeac0a40 folded before Flop (didn't bet)
Seat 6: 69abf22c folded before Flop (didn't bet)


Poker Hand #HD1184084350: Hold'em No Limit  ($0.02/$0.05) - 2023/03/31 22:46:12
Table 'NLHBlue109' 6-max Seat #6 is the button
Seat 1: d3c887a5 ($10.33 in chips)
Seat 2: Hero ($5 in chips)
Seat 3: e4fafec0 ($8.75 in chips)
Seat 4: 39b943a9 ($5.36 in chips)
Seat 5: eeac0a40 ($7.37 in chips)
Seat 6: 69abf22c ($3.63 in chips)
d3c887a5: posts small blind $0.02
Hero: posts big blind $0.05
*** HOLE CARDS ***
Dealt to d3c887a5 
Dealt to Hero [3c 8c]
Dealt to e4fafec0 
Dealt to 39b943a9 
Dealt to eeac0a40 
Dealt to 69abf22c 
e4fafec0: folds
39b943a9: folds
eeac0a40: raises $0.08 to $0.13
69abf22c: folds
d3c887a5: calls $0.11
Hero: folds
*** FLOP *** [Kc Jc 7c]
d3c887a5: bets $0.24
eeac0a40: calls $0.24
*** TURN *** [Kc Jc 7c] [8d]
d3c887a5: checks
eeac0a40: bets $0.48
d3c887a5: folds
Uncalled bet ($0.48) returned to eeac0a40
*** SHOWDOWN ***
eeac0a40 collected $0.75 from pot
*** SUMMARY ***
Total pot $0.79 | Rake $0.04 | Jackpot $0 | Bingo $0 | Fortune $0
Board [Kc Jc 7c 8d]
Seat 1: d3c887a5 (small blind) folded on the Turn
Seat 2: Hero (big blind) folded before Flop
Seat 3: e4fafec0 folded before Flop (didn't bet)
Seat 4: 39b943a9 folded before Flop (didn't bet)
Seat 5: eeac0a40 won ($0.75)
Seat 6: 69abf22c (button) folded before Flop (didn't bet)


Poker Hand #HD1184084310: Hold'em No Limit  ($0.02/$0.05) - 2023/03/31 22:45:45
Table 'NLHBlue109' 6-max Seat #5 is the button
Seat 1: d3c887a5 ($10.38 in chips)
Seat 2: Hero ($5 in chips)
Seat 3: e4fafec0 ($8.87 in chips)
Seat 4: 39b943a9 ($5.36 in chips)
Seat 5: eeac0a40 ($7.08 in chips)
Seat 6: 69abf22c ($3.65 in chips)
69abf22c: posts small blind $0.02
d3c887a5: posts big blind $0.05
*** HOLE CARDS ***
Dealt to d3c887a5 
Dealt to Hero [8d 8h]
Dealt to e4fafec0 
Dealt to 39b943a9 
Dealt to eeac0a40 
Dealt to 69abf22c 
Hero: raises $0.07 to $0.12
e4fafec0: calls $0.12
39b943a9: folds
eeac0a40: raises $0.5 to $0.62
69abf22c: folds
d3c887a5: folds
Hero: folds
e4fafec0: folds
Uncalled bet ($0.5) returned to eeac0a40
*** SHOWDOWN ***
eeac0a40 collected $0.41 from pot
*** SUMMARY ***
Total pot $0.43 | Rake $0.02 | Jackpot $0 | Bingo $0 | Fortune $0
Seat 1: d3c887a5 (big blind) folded before Flop
Seat 2: Hero folded before Flop
Seat 3: e4fafec0 folded before Flop
Seat 4: 39b943a9 folded before Flop (didn't bet)
Seat 5: eeac0a40 (button) collected ($0.41)
Seat 6: 69abf22c (small blind) folded before Flop


Poker Hand #HD1184084276: Hold'em No Limit  ($0.02/$0.05) - 2023/03/31 22:45:25
Table 'NLHBlue109' 6-max Seat #4 is the button
Seat 1: d3c887a5 ($10.38 in chips)
Seat 2: Hero ($5 in chips)
Seat 3: e4fafec0 ($8.87 in chips)
Seat 4: 39b943a9 ($5.36 in chips)
Seat 5: eeac0a40 ($7.1 in chips)
Seat 6: 69abf22c ($3.63 in chips)
eeac0a40: posts small blind $0.02
69abf22c: posts big blind $0.05
*** HOLE CARDS ***
Dealt to d3c887a5 
Dealt to Hero [Td 8h]
Dealt to e4fafec0 
Dealt to 39b943a9 
Dealt to eeac0a40 
Dealt to 69abf22c 
d3c887a5: folds
Hero: folds
e4fafec0: folds
39b943a9: folds
eeac0a40: folds
Uncalled bet ($0.03) returned to 69abf22c
*** SHOWDOWN ***
69abf22c collected $0.04 from pot
*** SUMMARY ***
Total pot $0.04 | Rake $0 | Jackpot $0 | Bingo $0 | Fortune $0
Seat 1: d3c887a5 folded before Flop (didn't bet)
Seat 2: Hero folded before Flop (didn't bet)
Seat 3: e4fafec0 folded before Flop (didn't bet)
Seat 4: 39b943a9 (button) folded before Flop (didn't bet)
Seat 5: eeac0a40 (small blind) folded before Flop
Seat 6: 69abf22c (big blind) collected ($0.04)


Poker Hand #HD1184084259: Hold'em No Limit  ($0.02/$0.05) - 2023/03/31 22:45:09
Table 'NLHBlue109' 6-max Seat #3 is the button
Seat 1: d3c887a5 ($10.38 in chips)
Seat 2: Hero ($5 in chips)
Seat 3: e4fafec0 ($8.8 in chips)
Seat 4: 39b943a9 ($5.38 in chips)
Seat 5: eeac0a40 ($7.15 in chips)
Seat 6: 69abf22c ($3.63 in chips)
39b943a9: posts small blind $0.02
eeac0a40: posts big blind $0.05
*** HOLE CARDS ***
Dealt to d3c887a5 
Dealt to Hero [6s 2h]
Dealt to e4fafec0 
Dealt to 39b943a9 
Dealt to eeac0a40 
Dealt to 69abf22c 
69abf22c: folds
d3c887a5: folds
Hero: folds
e4fafec0: raises $0.08 to $0.13
39b943a9: folds
eeac0a40: folds
Uncalled bet ($0.08) returned to e4fafec0
*** SHOWDOWN ***
e4fafec0 collected $0.12 from pot
*** SUMMARY ***
Total pot $0.12 | Rake $0 | Jackpot $0 | Bingo $0 | Fortune $0
Seat 1: d3c887a5 folded before Flop (didn't bet)
Seat 2: Hero folded before Flop (didn't bet)
Seat 3: e4fafec0 (button) collected ($0.12)
Seat 4: 39b943a9 (small blind) folded before Flop
Seat 5: eeac0a40 (big blind) folded before Flop
Seat 6: 69abf22c folded before Flop (didn't bet)


Poker Hand #HD1184084198: Hold'em No Limit  ($0.02/$0.05) - 2023/03/31 22:44:36
Table 'NLHBlue109' 6-max Seat #2 is the button
Seat 1: d3c887a5 ($10.19 in chips)
Seat 2: Hero ($5 in chips)
Seat 3: e4fafec0 ($8.9 in chips)
Seat 4: 39b943a9 ($5.48 in chips)
Seat 5: eeac0a40 ($7.15 in chips)
Seat 6: 69abf22c ($3.63 in chips)
e4fafec0: posts small blind $0.02
39b943a9: posts big blind $0.05
*** HOLE CARDS ***
Dealt to d3c887a5 
Dealt to Hero [5c Qc]
Dealt to e4fafec0 
Dealt to 39b943a9 
Dealt to eeac0a40 
Dealt to 69abf22c 
eeac0a40: folds
69abf22c: folds
d3c887a5: raises $0.05 to $0.1
Hero: folds
e4fafec0: calls $0.08
39b943a9: calls $0.05
*** FLOP *** [Jd 3c Qd]
e4fafec0: checks
39b943a9: checks
d3c887a5: bets $0.23
e4fafec0: folds
39b943a9: folds
Uncalled bet ($0.23) returned to d3c887a5
*** SHOWDOWN ***
d3c887a5 collected $0.29 from pot
*** SUMMARY ***
Total pot $0.3 | Rake $0.01 | Jackpot $0 | Bingo $0 | Fortune $0
Board [Jd 3c Qd]
Seat 1: d3c887a5 won ($0.29)
Seat 2: Hero (button) folded before Flop (didn't bet)
Seat 3: e4fafec0 (small blind) folded on the Flop
Seat 4: 39b943a9 (big blind) folded on the Flop
Seat 5: eeac0a40 folded before Flop (didn't bet)
Seat 6: 69abf22c folded before Flop (didn't bet)


Poker Hand #HD1184084046: Hold'em No Limit  ($0.02/$0.05) - 2023/03/31 22:42:51
Table 'NLHBlue109' 6-max Seat #1 is the button
Seat 1: d3c887a5 ($5.13 in chips)
Seat 2: Hero ($5 in chips)
Seat 3: e4fafec0 ($8.95 in chips)
Seat 4: 39b943a9 ($5.48 in chips)
Seat 5: eeac0a40 ($7.15 in chips)
Seat 6: 69abf22c ($4.33 in chips)
Hero: posts small blind $0.02
e4fafec0: posts big blind $0.05
*** HOLE CARDS ***
Dealt to d3c887a5 
Dealt to Hero [Js Ac]
Dealt to e4fafec0 
Dealt to 39b943a9 
Dealt to eeac0a40 
Dealt to 69abf22c 
39b943a9: folds
eeac0a40: folds
69abf22c: raises $0.1 to $0.15
d3c887a5: calls $0.15
Hero: raises $0.55 to $0.7
e4fafec0: folds
69abf22c: calls $0.55
d3c887a5: calls $0.55
*** FLOP *** [5s 5h Kc]
Hero: bets $0.71
69abf22c: folds
d3c887a5: calls $0.71
*** TURN *** [5s 5h Kc] [Jc]
Hero: bets $1.18
d3c887a5: raises $2.54 to $3.72 and is all-in
Hero: calls $2.41 and is all-in
Uncalled bet ($0.13) returned to d3c887a5
d3c887a5: shows [5d 8s] (Three Fives)
Hero: shows [Js Ac] (Pair of Jacks and Pair of Fives)
*** RIVER *** [5s 5h Kc Jc] [8c]
*** SHOWDOWN ***
d3c887a5 collected $10.06 from pot
*** SUMMARY ***
Total pot $10.75 | Rake $0.64 | Jackpot $0.05 | Bingo $0 | Fortune $0
Board [5s 5h Kc Jc 8c]
Seat 1: d3c887a5 (button) showed [5d 8s] and won ($10.06) with Fives Full over Eights
Seat 2: Hero (small blind) showed [Js Ac] and lost with Pair of Jacks and Pair of Fives
Seat 3: e4fafec0 (big blind) folded before Flop
Seat 4: 39b943a9 folded before Flop (didn't bet)
Seat 5: eeac0a40 folded before Flop (didn't bet)
Seat 6: 69abf22c folded on the Flop


Poker Hand #HD1184083923: Hold'em No Limit  ($0.02/$0.05) - 2023/03/31 22:41:25
Table 'NLHBlue109' 6-max Seat #6 is the button
Seat 1: d3c887a5 ($5.26 in chips)
Seat 2: Hero ($5.43 in chips)
Seat 3: e4fafec0 ($6.78 in chips)
Seat 4: 39b943a9 ($5.48 in chips)
Seat 5: eeac0a40 ($7.15 in chips)
Seat 6: 69abf22c ($4.33 in chips)
d3c887a5: posts small blind $0.02
Hero: posts big blind $0.05
*** HOLE CARDS ***
Dealt to d3c887a5 
Dealt to Hero [Ah Jc]
Dealt to e4fafec0 
Dealt to 39b943a9 
Dealt to eeac0a40 
Dealt to 69abf22c 
e4fafec0: raises $0.08 to $0.13
39b943a9: folds
eeac0a40: folds
69abf22c: folds
d3c887a5: calls $0.11
Hero: calls $0.08
*** FLOP *** [3c 4d Ad]
d3c887a5: checks
Hero: bets $0.2
e4fafec0: calls $0.2
d3c887a5: folds
*** TURN *** [3c 4d Ad] [Kh]
Hero: bets $0.4
e4fafec0: raises $1.59 to $1.99
Hero: calls $1.59
*** RIVER *** [3c 4d Ad Kh] [3s]
Hero: checks
e4fafec0: checks
Hero: shows [Ah Jc] (Pair of Aces and Pair of Treys)
e4fafec0: shows [5h 2h] (Fives-High Straight)
*** SHOWDOWN ***
e4fafec0 collected $4.49 from pot
*** SUMMARY ***
Total pot $4.77 | Rake $0.23 | Jackpot $0.05 | Bingo $0 | Fortune $0
Board [3c 4d Ad Kh 3s]
Seat 1: d3c887a5 (small blind) folded on the Flop
Seat 2: Hero (big blind) showed [Ah Jc] and lost with Pair of Aces and Pair of Treys
Seat 3: e4fafec0 showed [5h 2h] and won ($4.49) with Fives-High Straight
Seat 4: 39b943a9 folded before Flop (didn't bet)
Seat 5: eeac0a40 folded before Flop (didn't bet)
Seat 6: 69abf22c (button) folded before Flop (didn't bet)


Poker Hand #HD1184083825: Hold'em No Limit  ($0.02/$0.05) - 2023/03/31 22:40:19
Table 'NLHBlue109' 6-max Seat #5 is the button
Seat 1: d3c887a5 ($4.63 in chips)
Seat 2: Hero ($5.43 in chips)
Seat 3: e4fafec0 ($7.47 in chips)
Seat 4: 39b943a9 ($5.48 in chips)
Seat 5: eeac0a40 ($7.15 in chips)
Seat 6: 69abf22c ($4.35 in chips)
69abf22c: posts small blind $0.02
d3c887a5: posts big blind $0.05
*** HOLE CARDS ***
Dealt to d3c887a5 
Dealt to Hero [Kh 3s]
Dealt to e4fafec0 
Dealt to 39b943a9 
Dealt to eeac0a40 
Dealt to 69abf22c 
Hero: folds
e4fafec0: raises $0.08 to $0.13
39b943a9: folds
eeac0a40: folds
69abf22c: folds
d3c887a5: raises $0.21 to $0.34
e4fafec0: calls $0.21
*** FLOP *** [6c Jd 9d]
d3c887a5: bets $0.35
e4fafec0: calls $0.35
*** TURN *** [6c Jd 9d] [4c]
d3c887a5: bets $0.7
e4fafec0: folds
Uncalled bet ($0.7) returned to d3c887a5
*** SHOWDOWN ***
d3c887a5 collected $1.32 from pot
*** SUMMARY ***
Total pot $1.4 | Rake $0.08 | Jackpot $0 | Bingo $0 | Fortune $0
Board [6c Jd 9d 4c]
Seat 1: d3c887a5 (big blind) won ($1.32)
Seat 2: Hero folded before Flop (didn't bet)
Seat 3: e4fafec0 folded on the Turn
Seat 4: 39b943a9 folded before Flop (didn't bet)
Seat 5: eeac0a40 (button) folded before Flop (didn't bet)
Seat 6: 69abf22c (small blind) folded before Flop


Poker Hand #HD1184083746: Hold'em No Limit  ($0.02/$0.05) - 2023/03/31 22:39:35
Table 'NLHBlue109' 6-max Seat #4 is the button
Seat 1: d3c887a5 ($4.12 in chips)
Seat 2: Hero ($5.43 in chips)
Seat 3: e4fafec0 ($7.47 in chips)
Seat 4: 39b943a9 ($5.48 in chips)
Seat 5: eeac0a40 ($7.67 in chips)
Seat 6: 69abf22c ($4.4 in chips)
eeac0a40: posts small blind $0.02
69abf22c: posts big blind $0.05
*** HOLE CARDS ***
Dealt to d3c887a5 
Dealt to Hero [Qc 5d]
Dealt to e4fafec0 
Dealt to 39b943a9 
Dealt to eeac0a40 
Dealt to 69abf22c 
d3c887a5: calls $0.05
Hero: folds
e4fafec0: folds
39b943a9: folds
eeac0a40: raises $0.21 to $0.26
69abf22c: folds
d3c887a5: calls $0.21
*** FLOP *** [Tc 6s 2d]
eeac0a40: bets $0.26
d3c887a5: calls $0.26
*** TURN *** [Tc 6s 2d] [6h]
eeac0a40: checks
d3c887a5: bets $1.09
eeac0a40: folds
Uncalled bet ($1.09) returned to d3c887a5
*** SHOWDOWN ***
d3c887a5 collected $1.03 from pot
*** SUMMARY ***
Total pot $1.09 | Rake $0.06 | Jackpot $0 | Bingo $0 | Fortune $0
Board [Tc 6s 2d 6h]
Seat 1: d3c887a5 won ($1.03)
Seat 2: Hero folded before Flop (didn't bet)
Seat 3: e4fafec0 folded before Flop (didn't bet)
Seat 4: 39b943a9 (button) folded before Flop (didn't bet)
Seat 5: eeac0a40 (small blind) folded on the Turn
Seat 6: 69abf22c (big blind) folded before Flop


Poker Hand #HD1184083656: Hold'em No Limit  ($0.02/$0.05) - 2023/03/31 22:38:39
Table 'NLHBlue109' 6-max Seat #3 is the button
Seat 1: d3c887a5 ($4.22 in chips)
Seat 2: Hero ($5.43 in chips)
Seat 3: e4fafec0 ($7.84 in chips)
Seat 4: 39b943a9 ($5 in chips)
Seat 5: eeac0a40 ($7.72 in chips)
Seat 6: 69abf22c ($4.4 in chips)
39b943a9: posts small blind $0.02
eeac0a40: posts big blind $0.05
*** HOLE CARDS ***
Dealt to d3c887a5 
Dealt to Hero [Jd 9s]
Dealt to e4fafec0 
Dealt to 39b943a9 
Dealt to eeac0a40 
Dealt to 69abf22c 
69abf22c: folds
d3c887a5: raises $0.05 to $0.1
Hero: folds
e4fafec0: raises $0.27 to $0.37
39b943a9: raises $0.77 to $1.14
eeac0a40: folds
d3c887a5: folds
e4fafec0: folds
Uncalled bet ($0.77) returned to 39b943a9
*** SHOWDOWN ***
39b943a9 collected $0.85 from pot
*** SUMMARY ***
Total pot $0.89 | Rake $0.04 | Jackpot $0 | Bingo $0 | Fortune $0
Seat 1: d3c887a5 folded before Flop
Seat 2: Hero folded before Flop (didn't bet)
Seat 3: e4fafec0 (button) folded before Flop
Seat 4: 39b943a9 (small blind) collected ($0.85)
Seat 5: eeac0a40 (big blind) folded before Flop
Seat 6: 69abf22c folded before Flop (didn't bet)


Poker Hand #HD1184083605: Hold'em No Limit  ($0.02/$0.05) - 2023/03/31 22:38:02
Table 'NLHBlue109' 6-max Seat #2 is the button
Seat 1: d3c887a5 ($4.42 in chips)
Seat 2: Hero ($5.43 in chips)
Seat 3: e4fafec0 ($7.61 in chips)
Seat 4: 39b943a9 ($5 in chips)
Seat 5: eeac0a40 ($7.72 in chips)
Seat 6: 69abf22c ($4.4 in chips)
e4fafec0: posts small blind $0.02
39b943a9: posts big blind $0.05
*** HOLE CARDS ***
Dealt to d3c887a5 
Dealt to Hero [5c Qs]
Dealt to e4fafec0 
Dealt to 39b943a9 
Dealt to eeac0a40 
Dealt to 69abf22c 
eeac0a40: folds
69abf22c: folds
d3c887a5: calls $0.05
Hero: folds
e4fafec0: raises $0.15 to $0.2
39b943a9: folds
d3c887a5: calls $0.15
*** FLOP *** [9d 8d 5d]
e4fafec0: bets $0.34
d3c887a5: folds
Uncalled bet ($0.34) returned to e4fafec0
*** SHOWDOWN ***
e4fafec0 collected $0.43 from pot
*** SUMMARY ***
Total pot $0.45 | Rake $0.02 | Jackpot $0 | Bingo $0 | Fortune $0
Board [9d 8d 5d]
Seat 1: d3c887a5 folded on the Flop
Seat 2: Hero (button) folded before Flop (didn't bet)
Seat 3: e4fafec0 (small blind) won ($0.43)
Seat 4: 39b943a9 (big blind) folded before Flop
Seat 5: eeac0a40 folded before Flop (didn't bet)
Seat 6: 69abf22c folded before Flop (didn't bet)


Poker Hand #HD1184083502: Hold'em No Limit  ($0.02/$0.05) - 2023/03/31 22:36:58
Table 'NLHBlue109' 6-max Seat #1 is the button
Seat 1: d3c887a5 ($4.57 in chips)
Seat 2: Hero ($5.45 in chips)
Seat 3: e4fafec0 ($7.31 in chips)
Seat 4: 39b943a9 ($5 in chips)
Seat 5: eeac0a40 ($7.87 in chips)
Seat 6: 69abf22c ($4.4 in chips)
Hero: posts small blind $0.02
e4fafec0: posts big blind $0.05
*** HOLE CARDS ***
Dealt to d3c887a5 
Dealt to Hero [Kd Qh]
Dealt to e4fafec0 
Dealt to 39b943a9 
Dealt to eeac0a40 
Dealt to 69abf22c 
39b943a9: folds
eeac0a40: raises $0.1 to $0.15
69abf22c: folds
d3c887a5: calls $0.15
Hero: folds
e4fafec0: calls $0.1
*** FLOP *** [Kh 6c 7d]
e4fafec0: checks
eeac0a40: checks
d3c887a5: checks
*** TURN *** [Kh 6c 7d] [6h]
e4fafec0: bets $0.36
eeac0a40: folds
d3c887a5: folds
Uncalled bet ($0.36) returned to e4fafec0
*** SHOWDOWN ***
e4fafec0 collected $0.45 from pot
*** SUMMARY ***
Total pot $0.47 | Rake $0.02 | Jackpot $0 | Bingo $0 | Fortune $0
Board [Kh 6c 7d 6h]
Seat 1: d3c887a5 (button) folded on the Turn
Seat 2: Hero (small blind) folded before Flop
Seat 3: e4fafec0 (big blind) won ($0.45)
Seat 4: 39b943a9 folded before Flop (didn't bet)
Seat 5: eeac0a40 folded on the Turn
Seat 6: 69abf22c folded before Flop (didn't bet)


Poker Hand #HD1184083457: Hold'em No Limit  ($0.02/$0.05) - 2023/03/31 22:36:30
Table 'NLHBlue109' 6-max Seat #6 is the button
Seat 1: d3c887a5 ($4.7 in chips)
Seat 2: Hero ($5.5 in chips)
Seat 3: e4fafec0 ($7.14 in chips)
Seat 4: 39b943a9 ($5 in chips)
Seat 5: eeac0a40 ($7.87 in chips)
Seat 6: 69abf22c ($4.4 in chips)
d3c887a5: posts small blind $0.02
Hero: posts big blind $0.05
*** HOLE CARDS ***
Dealt to d3c887a5 
Dealt to Hero [2c 9d]
Dealt to e4fafec0 
Dealt to 39b943a9 
Dealt to eeac0a40 
Dealt to 69abf22c 
e4fafec0: raises $0.08 to $0.13
39b943a9: folds
eeac0a40: folds
69abf22c: folds
d3c887a5: calls $0.11
Hero: folds
*** FLOP *** [Ah 3h As]
d3c887a5: checks
e4fafec0: bets $0.24
d3c887a5: folds
Uncalled bet ($0.24) returned to e4fafec0
*** SHOWDOWN ***
e4fafec0 collected $0.3 from pot
*** SUMMARY ***
Total pot $0.31 | Rake $0.01 | Jackpot $0 | Bingo $0 | Fortune $0
Board [Ah 3h As]
Seat 1: d3c887a5 (small blind) folded on the Flop
Seat 2: Hero (big blind) folded before Flop
Seat 3: e4fafec0 won ($0.3)
Seat 4: 39b943a9 folded before Flop (didn't bet)
Seat 5: eeac0a40 folded before Flop (didn't bet)
Seat 6: 69abf22c (button) folded before Flop (didn't bet)


Poker Hand #HD1184083368: Hold'em No Limit  ($0.02/$0.05) - 2023/03/31 22:35:20
Table 'NLHBlue109' 6-max Seat #5 is the button
Seat 1: d3c887a5 ($4.83 in chips)
Seat 2: Hero ($5.5 in chips)
Seat 3: e4fafec0 ($7.27 in chips)
Seat 4: 39b943a9 ($5 in chips)
Seat 5: eeac0a40 ($7.61 in chips)
Seat 6: 69abf22c ($4.42 in chips)
69abf22c: posts small blind $0.02
d3c887a5: posts big blind $0.05
*** HOLE CARDS ***
Dealt to d3c887a5 
Dealt to Hero [Ac 3h]
Dealt to e4fafec0 
Dealt to 39b943a9 
Dealt to eeac0a40 
Dealt to 69abf22c 
Hero: folds
e4fafec0: raises $0.08 to $0.13
39b943a9: folds
eeac0a40: calls $0.13
69abf22c: folds
d3c887a5: calls $0.08
*** FLOP *** [Qd 9h Ts]
d3c887a5: checks
e4fafec0: checks
eeac0a40: checks
*** TURN *** [Qd 9h Ts] [9d]
d3c887a5: checks
e4fafec0: checks
eeac0a40: checks
*** RIVER *** [Qd 9h Ts 9d] [5s]
d3c887a5: checks
e4fafec0: checks
eeac0a40: checks
d3c887a5: shows [Jc 6d] (Pair of Nines)
e4fafec0: shows [6c 7s] (Pair of Nines)
eeac0a40: shows [2h 2c] (Pair of Nines and Pair of Twos)
*** SHOWDOWN ***
eeac0a40 collected $0.39 from pot
*** SUMMARY ***
Total pot $0.41 | Rake $0.02 | Jackpot $0 | Bingo $0 | Fortune $0
Board [Qd 9h Ts 9d 5s]
Seat 1: d3c887a5 (big blind) showed [Jc 6d] and lost with Pair of Nines
Seat 2: Hero folded before Flop (didn't bet)
Seat 3: e4fafec0 showed [6c 7s] and lost with Pair of Nines
Seat 4: 39b943a9 folded before Flop (didn't bet)
Seat 5: eeac0a40 (button) showed [2h 2c] and won ($0.39) with Pair of Nines and Pair of Twos
Seat 6: 69abf22c (small blind) folded before Flop


Poker Hand #HD1184083331: Hold'em No Limit  ($0.02/$0.05) - 2023/03/31 22:34:53
Table 'NLHBlue109' 6-max Seat #4 is the button
Seat 1: d3c887a5 ($4.88 in chips)
Seat 2: Hero ($5.5 in chips)
Seat 3: e4fafec0 ($7.27 in chips)
Seat 4: 39b943a9 ($5 in chips)
Seat 5: eeac0a40 ($7.51 in chips)
Seat 6: 69abf22c ($4.47 in chips)
eeac0a40: posts small blind $0.02
69abf22c: posts big blind $0.05
*** HOLE CARDS ***
Dealt to d3c887a5 
Dealt to Hero [3d 6d]
Dealt to e4fafec0 
Dealt to 39b943a9 
Dealt to eeac0a40 
Dealt to 69abf22c 
d3c887a5: calls $0.05
Hero: folds
e4fafec0: folds
39b943a9: folds
eeac0a40: raises $0.21 to $0.26
69abf22c: folds
d3c887a5: folds
Uncalled bet ($0.21) returned to eeac0a40
*** SHOWDOWN ***
eeac0a40 collected $0.15 from pot
*** SUMMARY ***
Total pot $0.15 | Rake $0 | Jackpot $0 | Bingo $0 | Fortune $0
Seat 1: d3c887a5 folded before Flop
Seat 2: Hero folded before Flop (didn't bet)
Seat 3: e4fafec0 folded before Flop (didn't bet)
Seat 4: 39b943a9 (button) folded before Flop (didn't bet)
Seat 5: eeac0a40 (small blind) collected ($0.15)
Seat 6: 69abf22c (big blind) folded before Flop


Poker Hand #HD1184083280: Hold'em No Limit  ($0.02/$0.05) - 2023/03/31 22:34:15
Table 'NLHBlue109' 6-max Seat #3 is the button
Seat 1: d3c887a5 ($5.35 in chips)
Seat 2: Hero ($5.5 in chips)
Seat 3: e4fafec0 ($7.27 in chips)
Seat 4: 39b943a9 ($5 in chips)
Seat 5: eeac0a40 ($7.06 in chips)
Seat 6: 69abf22c ($4.47 in chips)
39b943a9: posts small blind $0.02
eeac0a40: posts big blind $0.05
*** HOLE CARDS ***
Dealt to d3c887a5 
Dealt to Hero [9d 6c]
Dealt to e4fafec0 
Dealt to 39b943a9 
Dealt to eeac0a40 
Dealt to 69abf22c 
69abf22c: folds
d3c887a5: raises $0.1 to $0.15
Hero: folds
e4fafec0: folds
39b943a9: folds
eeac0a40: calls $0.1
*** FLOP *** [Ts 7s 5h]
eeac0a40: checks
d3c887a5: bets $0.32
eeac0a40: raises $0.71 to $1.03
d3c887a5: folds
Uncalled bet ($0.71) returned to eeac0a40
*** SHOWDOWN ***
eeac0a40 collected $0.92 from pot
*** SUMMARY ***
Total pot $0.96 | Rake $0.04 | Jackpot $0 | Bingo $0 | Fortune $0
Board [Ts 7s 5h]
Seat 1: d3c887a5 folded on the Flop
Seat 2: Hero folded before Flop (didn't bet)
Seat 3: e4fafec0 (button) folded before Flop (didn't bet)
Seat 4: 39b943a9 (small blind) folded before Flop
Seat 5: eeac0a40 (big blind) won ($0.92)
Seat 6: 69abf22c folded before Flop (didn't bet)


Poker Hand #HD1184083231: Hold'em No Limit  ($0.02/$0.05) - 2023/03/31 22:33:41
Table 'NLHBlue109' 6-max Seat #2 is the button
Seat 1: d3c887a5 ($5.28 in chips)
Seat 2: Hero ($5.5 in chips)
Seat 3: e4fafec0 ($7.29 in chips)
Seat 4: 39b943a9 ($5.05 in chips)
Seat 5: eeac0a40 ($7.06 in chips)
Seat 6: 69abf22c ($4.47 in chips)
e4fafec0: posts small blind $0.02
39b943a9: posts big blind $0.05
*** HOLE CARDS ***
Dealt to d3c887a5 
Dealt to Hero [Jc Td]
Dealt to e4fafec0 
Dealt to 39b943a9 
Dealt to eeac0a40 
Dealt to 69abf22c 
eeac0a40: folds
69abf22c: folds
d3c887a5: calls $0.05
Hero: folds
e4fafec0: folds
39b943a9: checks
*** FLOP *** [3h Ac 4d]
39b943a9: checks
d3c887a5: bets $0.12
39b943a9: folds
Uncalled bet ($0.12) returned to d3c887a5
*** SHOWDOWN ***
d3c887a5 collected $0.12 from pot
*** SUMMARY ***
Total pot $0.12 | Rake $0 | Jackpot $0 | Bingo $0 | Fortune $0
Board [3h Ac 4d]
Seat 1: d3c887a5 won ($0.12)
Seat 2: Hero (button) folded before Flop (didn't bet)
Seat 3: e4fafec0 (small blind) folded before Flop
Seat 4: 39b943a9 (big blind) folded on the Flop
Seat 5: eeac0a40 folded before Flop (didn't bet)
Seat 6: 69abf22c folded before Flop (didn't bet)


Poker Hand #HD1184083166: Hold'em No Limit  ($0.02/$0.05) - 2023/03/31 22:32:55
Table 'NLHBlue109' 6-max Seat #1 is the button
Seat 1: d3c887a5 ($5.56 in chips)
Seat 2: Hero ($5.2 in chips)
Seat 3: e4fafec0 ($7.34 in chips)
Seat 4: 39b943a9 ($5.05 in chips)
Seat 5: eeac0a40 ($7.06 in chips)
Seat 6: 69abf22c ($4.47 in chips)
Hero: posts small blind $0.02
e4fafec0: posts big blind $0.05
*** HOLE CARDS ***
Dealt to d3c887a5 
Dealt to Hero [9d 9c]
Dealt to e4fafec0 
Dealt to 39b943a9 
Dealt to eeac0a40 
Dealt to 69abf22c 
39b943a9: folds
eeac0a40: folds
69abf22c: folds
d3c887a5: calls $0.05
Hero: raises $0.23 to $0.28
e4fafec0: folds
d3c887a5: calls $0.23
*** FLOP *** [Kh 2c Qd]
Hero: bets $0.36
d3c887a5: folds
Uncalled bet ($0.36) returned to Hero
*** SHOWDOWN ***
Hero collected $0.58 from pot
*** SUMMARY ***
Total pot $0.61 | Rake $0.03 | Jackpot $0 | Bingo $0 | Fortune $0
Board [Kh 2c Qd]
Seat 1: d3c887a5 (button) folded on the Flop
Seat 2: Hero (small blind) won ($0.58)
Seat 3: e4fafec0 (big blind) folded before Flop
Seat 4: 39b943a9 folded before Flop (didn't bet)
Seat 5: eeac0a40 folded before Flop (didn't bet)
Seat 6: 69abf22c folded before Flop (didn't bet)


Poker Hand #HD1184083063: Hold'em No Limit  ($0.02/$0.05) - 2023/03/31 22:31:41
Table 'NLHBlue109' 6-max Seat #6 is the button
Seat 1: d3c887a5 ($5.66 in chips)
Seat 2: Hero ($5.54 in chips)
Seat 3: e4fafec0 ($6.93 in chips)
Seat 4: 39b943a9 ($5.05 in chips)
Seat 5: eeac0a40 ($7.06 in chips)
Seat 6: 69abf22c ($4.47 in chips)
d3c887a5: posts small blind $0.02
Hero: posts big blind $0.05
e4fafec0: straddle $0.1
*** HOLE CARDS ***
Dealt to d3c887a5 
Dealt to Hero [9d Td]
Dealt to e4fafec0 
Dealt to 39b943a9 
Dealt to eeac0a40 
Dealt to 69abf22c 
39b943a9: folds
eeac0a40: folds
69abf22c: folds
d3c887a5: calls $0.08
Hero: raises $0.24 to $0.34
e4fafec0: calls $0.24
d3c887a5: folds
*** FLOP *** [5s 5h 5d]
Hero: checks
e4fafec0: checks
*** TURN *** [5s 5h 5d] [Ah]
Hero: checks
e4fafec0: checks
*** RIVER *** [5s 5h 5d Ah] [3c]
Hero: checks
e4fafec0: bets $0.59
Hero: folds
Uncalled bet ($0.59) returned to e4fafec0
*** SHOWDOWN ***
e4fafec0 collected $0.75 from pot
*** SUMMARY ***
Total pot $0.78 | Rake $0.03 | Jackpot $0 | Bingo $0 | Fortune $0
Board [5s 5h 5d Ah 3c]
Seat 1: d3c887a5 (small blind) folded before Flop
Seat 2: Hero (big blind) folded on the River
Seat 3: e4fafec0 won ($0.75)
Seat 4: 39b943a9 folded before Flop (didn't bet)
Seat 5: eeac0a40 folded before Flop (didn't bet)
Seat 6: 69abf22c (button) folded before Flop (didn't bet)


Poker Hand #HD1184083045: Hold'em No Limit  ($0.02/$0.05) - 2023/03/31 22:31:28
Table 'NLHBlue109' 6-max Seat #5 is the button
Seat 1: d3c887a5 ($5.64 in chips)
Seat 2: Hero ($5.54 in chips)
Seat 3: e4fafec0 ($6.93 in chips)
Seat 4: 39b943a9 ($5.05 in chips)
Seat 5: eeac0a40 ($7.06 in chips)
Seat 6: 69abf22c ($4.49 in chips)
69abf22c: posts small blind $0.02
d3c887a5: posts big blind $0.05
*** HOLE CARDS ***
Dealt to d3c887a5 
Dealt to Hero [Tc Kh]
Dealt to e4fafec0 
Dealt to 39b943a9 
Dealt to eeac0a40 
Dealt to 69abf22c 
Hero: folds
e4fafec0: folds
39b943a9: folds
eeac0a40: folds
69abf22c: folds
Uncalled bet ($0.03) returned to d3c887a5
*** SHOWDOWN ***
d3c887a5 collected $0.04 from pot
*** SUMMARY ***
Total pot $0.04 | Rake $0 | Jackpot $0 | Bingo $0 | Fortune $0
Seat 1: d3c887a5 (big blind) collected ($0.04)
Seat 2: Hero folded before Flop (didn't bet)
Seat 3: e4fafec0 folded before Flop (didn't bet)
Seat 4: 39b943a9 folded before Flop (didn't bet)
Seat 5: eeac0a40 (button) folded before Flop (didn't bet)
Seat 6: 69abf22c (small blind) folded before Flop


Poker Hand #HD1184082987: Hold'em No Limit  ($0.02/$0.05) - 2023/03/31 22:30:44
Table 'NLHBlue109' 6-max Seat #4 is the button
Seat 1: d3c887a5 ($5.39 in chips)
Seat 2: Hero ($5.54 in chips)
Seat 3: e4fafec0 ($7.13 in chips)
Seat 4: 39b943a9 ($5.05 in chips)
Seat 5: eeac0a40 ($7.08 in chips)
Seat 6: 69abf22c ($4.54 in chips)
eeac0a40: posts small blind $0.02
69abf22c: posts big blind $0.05
*** HOLE CARDS ***
Dealt to d3c887a5 
Dealt to Hero [4s 8h]
Dealt to e4fafec0 
Dealt to 39b943a9 
Dealt to eeac0a40 
Dealt to 69abf22c 
d3c887a5: calls $0.05
Hero: folds
e4fafec0: raises $0.15 to $0.2
39b943a9: folds
eeac0a40: folds
69abf22c: folds
d3c887a5: calls $0.15
*** FLOP *** [Jh 5h 9c]
d3c887a5: checks
e4fafec0: checks
*** TURN *** [Jh 5h 9c] [Ts]
d3c887a5: bets $0.47
e4fafec0: folds
Uncalled bet ($0.47) returned to d3c887a5
*** SHOWDOWN ***
d3c887a5 collected $0.45 from pot
*** SUMMARY ***
Total pot $0.47 | Rake $0.02 | Jackpot $0 | Bingo $0 | Fortune $0
Board [Jh 5h 9c Ts]
Seat 1: d3c887a5 won ($0.45)
Seat 2: Hero folded before Flop (didn't bet)
Seat 3: e4fafec0 folded on the Turn
Seat 4: 39b943a9 (button) folded before Flop (didn't bet)
Seat 5: eeac0a40 (small blind) folded before Flop
Seat 6: 69abf22c (big blind) folded before Flop


Poker Hand #HD1184082970: Hold'em No Limit  ($0.02/$0.05) - 2023/03/31 22:30:32
Table 'NLHBlue109' 6-max Seat #3 is the button
Seat 1: d3c887a5 ($5.39 in chips)
Seat 2: Hero ($5.54 in chips)
Seat 3: e4fafec0 ($7.13 in chips)
Seat 4: 39b943a9 ($5 in chips)
Seat 5: eeac0a40 ($7.13 in chips)
Seat 6: 69abf22c ($4.54 in chips)
39b943a9: posts small blind $0.02
eeac0a40: posts big blind $0.05
*** HOLE CARDS ***
Dealt to d3c887a5 
Dealt to Hero [Kc 4h]
Dealt to e4fafec0 
Dealt to 39b943a9 
Dealt to eeac0a40 
Dealt to 69abf22c 
69abf22c: folds
d3c887a5: folds
Hero: folds
e4fafec0: folds
39b943a9: raises $0.1 to $0.15
eeac0a40: folds
Uncalled bet ($0.1) returned to 39b943a9
*** SHOWDOWN ***
39b943a9 collected $0.1 from pot
*** SUMMARY ***
Total pot $0.1 | Rake $0 | Jackpot $0 | Bingo $0 | Fortune $0
Seat 1: d3c887a5 folded before Flop (didn't bet)
Seat 2: Hero folded before Flop (didn't bet)
Seat 3: e4fafec0 (button) folded before Flop (didn't bet)
Seat 4: 39b943a9 (small blind) collected ($0.1)
Seat 5: eeac0a40 (big blind) folded before Flop
Seat 6: 69abf22c folded before Flop (didn't bet)


Poker Hand #HD1184082887: Hold'em No Limit  ($0.02/$0.05) - 2023/03/31 22:29:31
Table 'NLHBlue109' 6-max Seat #2 is the button
Seat 1: d3c887a5 ($4.77 in chips)
Seat 2: Hero ($5.54 in chips)
Seat 3: e4fafec0 ($7.78 in chips)
Seat 4: 39b943a9 ($5 in chips)
Seat 5: eeac0a40 ($7.13 in chips)
Seat 6: 69abf22c ($4.54 in chips)
e4fafec0: posts small blind $0.02
39b943a9: posts big blind $0.05
*** HOLE CARDS ***
Dealt to d3c887a5 
Dealt to Hero [8s Kc]
Dealt to e4fafec0 
Dealt to 39b943a9 
Dealt to eeac0a40 
Dealt to 69abf22c 
eeac0a40: folds
69abf22c: folds
d3c887a5: calls $0.05
Hero: folds
e4fafec0: raises $0.15 to $0.2
39b943a9: folds
d3c887a5: calls $0.15
*** FLOP *** [Kh 3c 2d]
e4fafec0: checks
d3c887a5: bets $0.45
e4fafec0: calls $0.45
*** TURN *** [Kh 3c 2d] [5h]
e4fafec0: checks
d3c887a5: checks
*** RIVER *** [Kh 3c 2d 5h] [9s]
e4fafec0: checks
d3c887a5: checks
e4fafec0: shows [Qc Ah] (Ace-High)
d3c887a5: shows [9c 8h] (Pair of Nines)
*** SHOWDOWN ***
d3c887a5 collected $1.27 from pot
*** SUMMARY ***
Total pot $1.35 | Rake $0.08 | Jackpot $0 | Bingo $0 | Fortune $0
Board [Kh 3c 2d 5h 9s]
Seat 1: d3c887a5 showed [9c 8h] and won ($1.27) with Pair of Nines
Seat 2: Hero (button) folded before Flop (didn't bet)
Seat 3: e4fafec0 (small blind) showed [Qc Ah] and lost with Ace-High
Seat 4: 39b943a9 (big blind) folded before Flop
Seat 5: eeac0a40 folded before Flop (didn't bet)
Seat 6: 69abf22c folded before Flop (didn't bet)


Poker Hand #HD1184082831: Hold'em No Limit  ($0.02/$0.05) - 2023/03/31 22:28:47
Table 'NLHBlue109' 6-max Seat #1 is the button
Seat 1: d3c887a5 ($4.6 in chips)
Seat 2: Hero ($5.56 in chips)
Seat 3: e4fafec0 ($7.95 in chips)
Seat 4: 39b943a9 ($5 in chips)
Seat 5: eeac0a40 ($7.13 in chips)
Seat 6: 69abf22c ($4.54 in chips)
Hero: posts small blind $0.02
e4fafec0: posts big blind $0.05
*** HOLE CARDS ***
Dealt to d3c887a5 
Dealt to Hero [Qs 8c]
Dealt to e4fafec0 
Dealt to 39b943a9 
Dealt to eeac0a40 
Dealt to 69abf22c 
39b943a9: folds
eeac0a40: folds
69abf22c: folds
d3c887a5: calls $0.05
Hero: folds
e4fafec0: checks
*** FLOP *** [3c 6s 8s]
e4fafec0: bets $0.12
d3c887a5: raises $0.27 to $0.39
e4fafec0: folds
Uncalled bet ($0.27) returned to d3c887a5
*** SHOWDOWN ***
d3c887a5 collected $0.34 from pot
*** SUMMARY ***
Total pot $0.36 | Rake $0.02 | Jackpot $0 | Bingo $0 | Fortune $0
Board [3c 6s 8s]
Seat 1: d3c887a5 (button) won ($0.34)
Seat 2: Hero (small blind) folded before Flop
Seat 3: e4fafec0 (big blind) folded on the Flop
Seat 4: 39b943a9 folded before Flop (didn't bet)
Seat 5: eeac0a40 folded before Flop (didn't bet)
Seat 6: 69abf22c folded before Flop (didn't bet)


Poker Hand #HD1184082736: Hold'em No Limit  ($0.02/$0.05) - 2023/03/31 22:27:41
Table 'NLHBlue109' 6-max Seat #6 is the button
Seat 1: d3c887a5 ($5.08 in chips)
Seat 2: Hero ($5 in chips)
Seat 3: e4fafec0 ($7.95 in chips)
Seat 4: 39b943a9 ($5 in chips)
Seat 5: eeac0a40 ($7.26 in chips)
Seat 6: 69abf22c ($4.54 in chips)
d3c887a5: posts small blind $0.02
Hero: posts big blind $0.05
*** HOLE CARDS ***
Dealt to d3c887a5 
Dealt to Hero [Kd Ac]
Dealt to e4fafec0 
Dealt to 39b943a9 
Dealt to eeac0a40 
Dealt to 69abf22c 
e4fafec0: folds
39b943a9: folds
eeac0a40: raises $0.08 to $0.13
69abf22c: folds
d3c887a5: calls $0.11
Hero: raises $0.35 to $0.48
eeac0a40: folds
d3c887a5: calls $0.35
*** FLOP *** [Td 5c 9c]
d3c887a5: checks
Hero: checks
*** TURN *** [Td 5c 9c] [Qh]
d3c887a5: checks
Hero: bets $0.55
d3c887a5: folds
Uncalled bet ($0.55) returned to Hero
*** SHOWDOWN ***
Hero collected $1.04 from pot
*** SUMMARY ***
Total pot $1.09 | Rake $0.05 | Jackpot $0 | Bingo $0 | Fortune $0
Board [Td 5c 9c Qh]
Seat 1: d3c887a5 (small blind) folded on the Turn
Seat 2: Hero (big blind) won ($1.04)
Seat 3: e4fafec0 folded before Flop (didn't bet)
Seat 4: 39b943a9 folded before Flop (didn't bet)
Seat 5: eeac0a40 folded before Flop
Seat 6: 69abf22c (button) folded before Flop (didn't bet)


Poker Hand #HD1184082721: Hold'em No Limit  ($0.02/$0.05) - 2023/03/31 22:27:31
Table 'NLHBlue109' 6-max Seat #5 is the button
Seat 1: d3c887a5 ($5.06 in chips)
Seat 2: Hero ($5 in chips)
Seat 3: e4fafec0 ($7.95 in chips)
Seat 4: 39b943a9 ($5 in chips)
Seat 5: eeac0a40 ($7.26 in chips)
Seat 6: 69abf22c ($4.56 in chips)
69abf22c: posts small blind $0.02
d3c887a5: posts big blind $0.05
*** HOLE CARDS ***
Dealt to d3c887a5 
Dealt to Hero [2d 9c]
Dealt to e4fafec0 
Dealt to 39b943a9 
Dealt to eeac0a40 
Dealt to 69abf22c 
Hero: folds
e4fafec0: folds
39b943a9: folds
eeac0a40: folds
69abf22c: folds
Uncalled bet ($0.03) returned to d3c887a5
*** SHOWDOWN ***
d3c887a5 collected $0.04 from pot
*** SUMMARY ***
Total pot $0.04 | Rake $0 | Jackpot $0 | Bingo $0 | Fortune $0
Seat 1: d3c887a5 (big blind) collected ($0.04)
Seat 2: Hero folded before Flop (didn't bet)
Seat 3: e4fafec0 folded before Flop (didn't bet)
Seat 4: 39b943a9 folded before Flop (didn't bet)
Seat 5: eeac0a40 (button) folded before Flop (didn't bet)
Seat 6: 69abf22c (small blind) folded before Flop


Poker Hand #HD1184082666: Hold'em No Limit  ($0.02/$0.05) - 2023/03/31 22:26:58
Table 'NLHBlue109' 6-max Seat #4 is the button
Seat 1: d3c887a5 ($5.43 in chips)
Seat 2: Hero ($5 in chips)
Seat 3: e4fafec0 ($7.55 in chips)
Seat 4: 39b943a9 ($5 in chips)
Seat 5: eeac0a40 ($7.28 in chips)
Seat 6: 69abf22c ($4.61 in chips)
eeac0a40: posts small blind $0.02
69abf22c: posts big blind $0.05
*** HOLE CARDS ***
Dealt to d3c887a5 
Dealt to Hero [7s 5h]
Dealt to e4fafec0 
Dealt to 39b943a9 
Dealt to eeac0a40 
Dealt to 69abf22c 
d3c887a5: raises $0.05 to $0.1
Hero: folds
e4fafec0: raises $0.27 to $0.37
39b943a9: folds
eeac0a40: folds
69abf22c: folds
d3c887a5: calls $0.27
*** FLOP *** [Ac 6s 2d]
d3c887a5: checks
e4fafec0: bets $0.41
d3c887a5: folds
Uncalled bet ($0.41) returned to e4fafec0
*** SHOWDOWN ***
e4fafec0 collected $0.77 from pot
*** SUMMARY ***
Total pot $0.81 | Rake $0.04 | Jackpot $0 | Bingo $0 | Fortune $0
Board [Ac 6s 2d]
Seat 1: d3c887a5 folded on the Flop
Seat 2: Hero folded before Flop (didn't bet)
Seat 3: e4fafec0 won ($0.77)
Seat 4: 39b943a9 (button) folded before Flop (didn't bet)
Seat 5: eeac0a40 (small blind) folded before Flop
Seat 6: 69abf22c (big blind) folded before Flop


Poker Hand #HD1184082626: Hold'em No Limit  ($0.02/$0.05) - 2023/03/31 22:26:33
Table 'NLHBlue109' 6-max Seat #3 is the button
Seat 1: d3c887a5 ($5.58 in chips)
Seat 2: Hero ($5 in chips)
Seat 3: e4fafec0 ($7.2 in chips)
Seat 4: 39b943a9 ($5 in chips)
Seat 5: eeac0a40 ($7.33 in chips)
Seat 6: 69abf22c ($4.76 in chips)
39b943a9: posts small blind $0.02
eeac0a40: posts big blind $0.05
*** HOLE CARDS ***
Dealt to d3c887a5 
Dealt to Hero [Qh 9c]
Dealt to e4fafec0 
Dealt to 39b943a9 
Dealt to eeac0a40 
Dealt to 69abf22c 
69abf22c: raises $0.1 to $0.15
d3c887a5: calls $0.15
Hero: folds
e4fafec0: raises $0.52 to $0.67
39b943a9: folds
eeac0a40: folds
69abf22c: folds
d3c887a5: folds
Uncalled bet ($0.52) returned to e4fafec0
*** SHOWDOWN ***
e4fafec0 collected $0.5 from pot
*** SUMMARY ***
Total pot $0.52 | Rake $0.02 | Jackpot $0 | Bingo $0 | Fortune $0
Seat 1: d3c887a5 folded before Flop
Seat 2: Hero folded before Flop (didn't bet)
Seat 3: e4fafec0 (button) collected ($0.5)
Seat 4: 39b943a9 (small blind) folded before Flop
Seat 5: eeac0a40 (big blind) folded before Flop
Seat 6: 69abf22c folded before Flop


Poker Hand #HD1184082505: Hold'em No Limit  ($0.02/$0.05) - 2023/03/31 22:25:09
Table 'NLHBlue109' 6-max Seat #2 is the button
Seat 1: d3c887a5 ($3.63 in chips)
Seat 2: Hero ($5 in chips)
Seat 3: e4fafec0 ($8.5 in chips)
Seat 4: 39b943a9 ($5 in chips)
Seat 5: eeac0a40 ($7.48 in chips)
Seat 6: 69abf22c ($5.36 in chips)
e4fafec0: posts small blind $0.02
39b943a9: posts big blind $0.05
*** HOLE CARDS ***
Dealt to d3c887a5 
Dealt to Hero [5s 2c]
Dealt to e4fafec0 
Dealt to 39b943a9 
Dealt to eeac0a40 
Dealt to 69abf22c 
eeac0a40: raises $0.1 to $0.15
69abf22c: calls $0.15
d3c887a5: calls $0.15
Hero: folds
e4fafec0: calls $0.13
39b943a9: calls $0.1
*** FLOP *** [9c 5h 2h]
e4fafec0: checks
39b943a9: checks
eeac0a40: checks
69abf22c: bets $0.45
d3c887a5: calls $0.45
e4fafec0: calls $0.45
39b943a9: folds
eeac0a40: folds
*** TURN *** [9c 5h 2h] [Jd]
e4fafec0: checks
69abf22c: checks
d3c887a5: bets $0.7
e4fafec0: calls $0.7
69abf22c: folds
*** RIVER *** [9c 5h 2h Jd] [4h]
e4fafec0: checks
d3c887a5: bets $2.33 and is all-in
e4fafec0: folds
Uncalled bet ($2.33) returned to d3c887a5
*** SHOWDOWN ***
d3c887a5 collected $3.25 from pot
*** SUMMARY ***
Total pot $3.5 | Rake $0.2 | Jackpot $0.05 | Bingo $0 | Fortune $0
Board [9c 5h 2h Jd 4h]
Seat 1: d3c887a5 won ($3.25)
Seat 2: Hero (button) folded before Flop (didn't bet)
Seat 3: e4fafec0 (small blind) folded on the River
Seat 4: 39b943a9 (big blind) folded on the Flop
Seat 5: eeac0a40 folded on the Flop
Seat 6: 69abf22c folded on the Turn


Poker Hand #HD1184082422: Hold'em No Limit  ($0.02/$0.05) - 2023/03/31 22:24:18
Table 'NLHBlue109' 6-max Seat #1 is the button
Seat 1: d3c887a5 ($3.63 in chips)
Seat 2: Hero ($5 in chips)
Seat 3: e4fafec0 ($8.34 in chips)
Seat 5: eeac0a40 ($7.48 in chips)
Seat 6: 69abf22c ($5.51 in chips)
Hero: posts small blind $0.02
e4fafec0: posts big blind $0.05
*** HOLE CARDS ***
Dealt to d3c887a5 
Dealt to Hero [3c 4h]
Dealt to e4fafec0 
Dealt to eeac0a40 
Dealt to 69abf22c 
eeac0a40: folds
69abf22c: raises $0.1 to $0.15
d3c887a5: folds
Hero: folds
e4fafec0: calls $0.1
*** FLOP *** [5s 7c 7s]
e4fafec0: checks
69abf22c: checks
*** TURN *** [5s 7c 7s] [8s]
e4fafec0: bets $0.24
69abf22c: folds
Uncalled bet ($0.24) returned to e4fafec0
*** SHOWDOWN ***
e4fafec0 collected $0.31 from pot
*** SUMMARY ***
Total pot $0.32 | Rake $0.01 | Jackpot $0 | Bingo $0 | Fortune $0
Board [5s 7c 7s 8s]
Seat 1: d3c887a5 (button) folded before Flop (didn't bet)
Seat 2: Hero (small blind) folded before Flop
Seat 3: e4fafec0 (big blind) won ($0.31)
Seat 5: eeac0a40 folded before Flop (didn't bet)
Seat 6: 69abf22c folded on the Turn


Poker Hand #HD1184082376: Hold'em No Limit  ($0.02/$0.05) - 2023/03/31 22:23:42
Table 'NLHBlue109' 6-max Seat #6 is the button
Seat 1: d3c887a5 ($3.76 in chips)
Seat 2: Hero ($5 in chips)
Seat 3: e4fafec0 ($7.98 in chips)
Seat 5: eeac0a40 ($7.48 in chips)
Seat 6: 69abf22c ($5.51 in chips)
d3c887a5: posts small blind $0.02
Hero: posts big blind $0.05
*** HOLE CARDS ***
Dealt to d3c887a5 
Dealt to Hero [6d 6h]
Dealt to e4fafec0 
Dealt to eeac0a40 
Dealt to 69abf22c 
e4fafec0: raises $0.08 to $0.13
eeac0a40: folds
69abf22c: folds
d3c887a5: calls $0.11
Hero: calls $0.08
*** FLOP *** [9s 2d Kc]
d3c887a5: checks
Hero: bets $0.13
e4fafec0: raises $0.49 to $0.62
d3c887a5: folds
Hero: folds
Uncalled bet ($0.49) returned to e4fafec0
*** SHOWDOWN ***
e4fafec0 collected $0.62 from pot
*** SUMMARY ***
Total pot $0.65 | Rake $0.03 | Jackpot $0 | Bingo $0 | Fortune $0
Board [9s 2d Kc]
Seat 1: d3c887a5 (small blind) folded on the Flop
Seat 2: Hero (big blind) folded on the Flop
Seat 3: e4fafec0 won ($0.62)
Seat 5: eeac0a40 folded before Flop (didn't bet)
Seat 6: 69abf22c (button) folded before Flop (didn't bet)


Poker Hand #HD1184082263: Hold'em No Limit  ($0.02/$0.05) - 2023/03/31 22:22:37
Table 'NLHBlue109' 6-max Seat #5 is the button
Seat 1: d3c887a5 ($4.2 in chips)
Seat 2: Hero ($5 in chips)
Seat 3: e4fafec0 ($8.42 in chips)
Seat 5: eeac0a40 ($7.48 in chips)
Seat 6: 69abf22c ($4.69 in chips)
69abf22c: posts small blind $0.02
d3c887a5: posts big blind $0.05
*** HOLE CARDS ***
Dealt to d3c887a5 
Dealt to Hero [3d Qs]
Dealt to e4fafec0 
Dealt to eeac0a40 
Dealt to 69abf22c 
Hero: folds
e4fafec0: raises $0.08 to $0.13
eeac0a40: folds
69abf22c: raises $0.31 to $0.44
d3c887a5: calls $0.39
e4fafec0: calls $0.31
*** FLOP *** [9c 8d Qc]
69abf22c: bets $0.96
d3c887a5: folds
e4fafec0: folds
Uncalled bet ($0.96) returned to 69abf22c
*** SHOWDOWN ***
69abf22c collected $1.26 from pot
*** SUMMARY ***
Total pot $1.32 | Rake $0.06 | Jackpot $0 | Bingo $0 | Fortune $0
Board [9c 8d Qc]
Seat 1: d3c887a5 (big blind) folded on the Flop
Seat 2: Hero folded before Flop (didn't bet)
Seat 3: e4fafec0 folded on the Flop
Seat 5: eeac0a40 (button) folded before Flop (didn't bet)
Seat 6: 69abf22c (small blind) won ($1.26)


Poker Hand #HD1184082179: Hold'em No Limit  ($0.02/$0.05) - 2023/03/31 22:21:44
Table 'NLHBlue109' 6-max Seat #3 is the button
Seat 1: d3c887a5 ($4.4 in chips)
Seat 2: Hero ($5 in chips)
Seat 3: e4fafec0 ($8.78 in chips)
Seat 5: eeac0a40 ($7.5 in chips)
Seat 6: 69abf22c ($1 in chips)
eeac0a40: posts small blind $0.02
69abf22c: posts big blind $0.05
*** HOLE CARDS ***
Dealt to d3c887a5 
Dealt to Hero [2d 4h]
Dealt to e4fafec0 
Dealt to eeac0a40 
Dealt to 69abf22c 
d3c887a5: calls $0.05
Hero: folds
e4fafec0: raises $0.15 to $0.2
eeac0a40: folds
69abf22c: calls $0.15
d3c887a5: calls $0.15
*** FLOP *** [Th Qd Ad]
69abf22c: checks
d3c887a5: checks
e4fafec0: checks
*** TURN *** [Th Qd Ad] [5d]
69abf22c: bets $0.16
d3c887a5: folds
e4fafec0: calls $0.16
*** RIVER *** [Th Qd Ad 5d] [Jh]
69abf22c: bets $0.64 and is all-in
e4fafec0: folds
Uncalled bet ($0.64) returned to 69abf22c
*** SHOWDOWN ***
69abf22c collected $0.9 from pot
*** SUMMARY ***
Total pot $0.94 | Rake $0.04 | Jackpot $0 | Bingo $0 | Fortune $0
Board [Th Qd Ad 5d Jh]
Seat 1: d3c887a5 folded on the Turn
Seat 2: Hero folded before Flop (didn't bet)
Seat 3: e4fafec0 (button) folded on the River
Seat 5: eeac0a40 (small blind) folded before Flop
Seat 6: 69abf22c (big blind) won ($0.9)


Poker Hand #HD1184082064: Hold'em No Limit  ($0.02/$0.05) - 2023/03/31 22:20:33
Table 'NLHBlue109' 6-max Seat #2 is the button
Seat 1: d3c887a5 ($4.62 in chips)
Seat 2: Hero ($5 in chips)
Seat 3: e4fafec0 ($9 in chips)
Seat 5: eeac0a40 ($7.09 in chips)
e4fafec0: posts small blind $0.02
eeac0a40: posts big blind $0.05
*** HOLE CARDS ***
Dealt to d3c887a5 
Dealt to Hero [5h 9h]
Dealt to e4fafec0 
Dealt to eeac0a40 
d3c887a5: calls $0.05
Hero: folds
e4fafec0: calls $0.03
eeac0a40: raises $0.17 to $0.22
d3c887a5: calls $0.17
e4fafec0: calls $0.17
*** FLOP *** [3s Td Kc]
e4fafec0: checks
eeac0a40: checks
d3c887a5: checks
*** TURN *** [3s Td Kc] [7h]
e4fafec0: checks
eeac0a40: checks
d3c887a5: checks
*** RIVER *** [3s Td Kc 7h] [Qs]
e4fafec0: checks
eeac0a40: checks
d3c887a5: checks
e4fafec0: shows [6c 5s] (King-High)
eeac0a40: shows [2d 2c] (Pair of Twos)
d3c887a5: shows [8d 4c] (King-High)
*** SHOWDOWN ***
eeac0a40 collected $0.63 from pot
*** SUMMARY ***
Total pot $0.66 | Rake $0.03 | Jackpot $0 | Bingo $0 | Fortune $0
Board [3s Td Kc 7h Qs]
Seat 1: d3c887a5 showed [8d 4c] and lost with King-High
Seat 2: Hero (button) folded before Flop (didn't bet)
Seat 3: e4fafec0 (small blind) showed [6c 5s] and lost with King-High
Seat 5: eeac0a40 (big blind) showed [2d 2c] and won ($0.63) with Pair of Twos


Poker Hand #HD1184081982: Hold'em No Limit  ($0.02/$0.05) - 2023/03/31 22:19:49
Table 'NLHBlue109' 6-max Seat #1 is the button
Seat 1: d3c887a5 ($4.82 in chips)
Seat 2: Hero ($5.01 in chips)
Seat 3: e4fafec0 ($8.8 in chips)
Seat 5: eeac0a40 ($7.09 in chips)
Hero: posts small blind $0.02
e4fafec0: posts big blind $0.05
*** HOLE CARDS ***
Dealt to d3c887a5 
Dealt to Hero [4s Qs]
Dealt to e4fafec0 
Dealt to eeac0a40 
eeac0a40: folds
d3c887a5: calls $0.05
Hero: folds
e4fafec0: raises $0.15 to $0.2
d3c887a5: calls $0.15
*** FLOP *** [9s Td 4h]
e4fafec0: bets $0.21
d3c887a5: folds
Uncalled bet ($0.21) returned to e4fafec0
*** SHOWDOWN ***
e4fafec0 collected $0.4 from pot
*** SUMMARY ***
Total pot $0.42 | Rake $0.02 | Jackpot $0 | Bingo $0 | Fortune $0
Board [9s Td 4h]
Seat 1: d3c887a5 (button) folded on the Flop
Seat 2: Hero (small blind) folded before Flop
Seat 3: e4fafec0 (big blind) won ($0.4)
Seat 5: eeac0a40 folded before Flop (didn't bet)


Poker Hand #HD1184081930: Hold'em No Limit  ($0.02/$0.05) - 2023/03/31 22:19:15
Table 'NLHBlue109' 6-max Seat #5 is the button
Seat 1: d3c887a5 ($4.95 in chips)
Seat 2: Hero ($5.06 in chips)
Seat 3: e4fafec0 ($8.63 in chips)
Seat 4: a4280f1e ($5 in chips)
Seat 5: eeac0a40 ($7.09 in chips)
d3c887a5: posts small blind $0.02
Hero: posts big blind $0.05
*** HOLE CARDS ***
Dealt to d3c887a5 
Dealt to Hero [Js 2s]
Dealt to e4fafec0 
Dealt to a4280f1e 
Dealt to eeac0a40 
e4fafec0: raises $0.08 to $0.13
a4280f1e: folds
eeac0a40: folds
d3c887a5: calls $0.11
Hero: folds
*** FLOP *** [Td 5d 5h]
d3c887a5: checks
e4fafec0: bets $0.31
d3c887a5: folds
Uncalled bet ($0.31) returned to e4fafec0
*** SHOWDOWN ***
e4fafec0 collected $0.3 from pot
*** SUMMARY ***
Total pot $0.31 | Rake $0.01 | Jackpot $0 | Bingo $0 | Fortune $0
Board [Td 5d 5h]
Seat 1: d3c887a5 (small blind) folded on the Flop
Seat 2: Hero (big blind) folded before Flop
Seat 3: e4fafec0 won ($0.3)
Seat 4: a4280f1e folded before Flop (didn't bet)
Seat 5: eeac0a40 (button) folded before Flop (didn't bet)


Poker Hand #HD1184081785: Hold'em No Limit  ($0.02/$0.05) - 2023/03/31 22:17:46
Table 'NLHBlue109' 6-max Seat #4 is the button
Seat 1: d3c887a5 ($5 in chips)
Seat 2: Hero ($5.06 in chips)
Seat 3: e4fafec0 ($5.82 in chips)
Seat 4: a4280f1e ($5.45 in chips)
Seat 5: eeac0a40 ($7.11 in chips)
eeac0a40: posts small blind $0.02
d3c887a5: posts big blind $0.05
*** HOLE CARDS ***
Dealt to d3c887a5 
Dealt to Hero [6d 9s]
Dealt to e4fafec0 
Dealt to a4280f1e 
Dealt to eeac0a40 
Hero: folds
e4fafec0: raises $0.08 to $0.13
a4280f1e: raises $0.25 to $0.38
eeac0a40: folds
d3c887a5: folds
e4fafec0: calls $0.25
*** FLOP *** [2c 3h Qs]
e4fafec0: checks
a4280f1e: checks
*** TURN *** [2c 3h Qs] [Tc]
e4fafec0: bets $0.63
a4280f1e: calls $0.63
*** RIVER *** [2c 3h Qs Tc] [Jc]
e4fafec0: bets $2.09
a4280f1e: calls $2.09
e4fafec0: shows [5c 7c] (Jack High Flush)
a4280f1e: shows [Kc Ad] (Aces-High Straight)
*** SHOWDOWN ***
e4fafec0 collected $5.91 from pot
*** SUMMARY ***
Total pot $6.27 | Rake $0.31 | Jackpot $0.05 | Bingo $0 | Fortune $0
Board [2c 3h Qs Tc Jc]
Seat 1: d3c887a5 (big blind) folded before Flop
Seat 2: Hero folded before Flop (didn't bet)
Seat 3: e4fafec0 showed [5c 7c] and won ($5.91) with Jack High Flush
Seat 4: a4280f1e (button) showed [Kc Ad] and lost with Aces-High Straight
Seat 5: eeac0a40 (small blind) folded before Flop


Poker Hand #HD1184081728: Hold'em No Limit  ($0.02/$0.05) - 2023/03/31 22:17:10
Table 'NLHBlue109' 6-max Seat #3 is the button
Seat 2: Hero ($5.06 in chips)
Seat 3: e4fafec0 ($6.26 in chips)
Seat 4: a4280f1e ($5 in chips)
Seat 5: eeac0a40 ($7.16 in chips)
a4280f1e: posts small blind $0.02
eeac0a40: posts big blind $0.05
*** HOLE CARDS ***
Dealt to Hero [Jc 7h]
Dealt to e4fafec0 
Dealt to a4280f1e 
Dealt to eeac0a40 
Hero: folds
e4fafec0: raises $0.08 to $0.13
a4280f1e: raises $0.31 to $0.44
eeac0a40: folds
e4fafec0: calls $0.31
*** FLOP *** [Kd Jh Js]
a4280f1e: bets $0.32
e4fafec0: folds
Uncalled bet ($0.32) returned to a4280f1e
*** SHOWDOWN ***
a4280f1e collected $0.89 from pot
*** SUMMARY ***
Total pot $0.93 | Rake $0.04 | Jackpot $0 | Bingo $0 | Fortune $0
Board [Kd Jh Js]
Seat 2: Hero folded before Flop (didn't bet)
Seat 3: e4fafec0 (button) folded on the Flop
Seat 4: a4280f1e (small blind) won ($0.89)
Seat 5: eeac0a40 (big blind) folded before Flop


Poker Hand #HD1184081710: Hold'em No Limit  ($0.02/$0.05) - 2023/03/31 22:17:01
Table 'NLHBlue109' 6-max Seat #2 is the button
Seat 2: Hero ($5.06 in chips)
Seat 3: e4fafec0 ($6.21 in chips)
Seat 4: a4280f1e ($5 in chips)
Seat 5: eeac0a40 ($7.16 in chips)
e4fafec0: posts small blind $0.02
a4280f1e: posts big blind $0.05
*** HOLE CARDS ***
Dealt to Hero [Ad 6s]
Dealt to e4fafec0 
Dealt to a4280f1e 
Dealt to eeac0a40 
eeac0a40: folds
Hero: folds
e4fafec0: raises $0.08 to $0.13
a4280f1e: folds
Uncalled bet ($0.08) returned to e4fafec0
*** SHOWDOWN ***
e4fafec0 collected $0.1 from pot
*** SUMMARY ***
Total pot $0.1 | Rake $0 | Jackpot $0 | Bingo $0 | Fortune $0
Seat 2: Hero (button) folded before Flop (didn't bet)
Seat 3: e4fafec0 (small blind) collected ($0.1)
Seat 4: a4280f1e (big blind) folded before Flop
Seat 5: eeac0a40 folded before Flop (didn't bet)


Poker Hand #HD1184081668: Hold'em No Limit  ($0.02/$0.05) - 2023/03/31 22:16:34
Table 'NLHBlue109' 6-max Seat #5 is the button
Seat 2: Hero ($5.08 in chips)
Seat 3: e4fafec0 ($5.82 in chips)
Seat 5: eeac0a40 ($7.57 in chips)
Hero: posts small blind $0.02
e4fafec0: posts big blind $0.05
*** HOLE CARDS ***
Dealt to Hero [8h 7c]
Dealt to e4fafec0 
Dealt to eeac0a40 
eeac0a40: raises $0.08 to $0.13
Hero: folds
e4fafec0: raises $0.28 to $0.41
eeac0a40: calls $0.28
*** FLOP *** [2c Qh Js]
e4fafec0: bets $0.63
eeac0a40: folds
Uncalled bet ($0.63) returned to e4fafec0
*** SHOWDOWN ***
e4fafec0 collected $0.8 from pot
*** SUMMARY ***
Total pot $0.84 | Rake $0.04 | Jackpot $0 | Bingo $0 | Fortune $0
Board [2c Qh Js]
Seat 2: Hero (small blind) folded before Flop
Seat 3: e4fafec0 (big blind) won ($0.8)
Seat 5: eeac0a40 (button) folded on the Flop


Poker Hand #HD1184081594: Hold'em No Limit  ($0.02/$0.05) - 2023/03/31 22:15:48
Table 'NLHBlue109' 6-max Seat #3 is the button
Seat 2: Hero ($5.13 in chips)
Seat 3: e4fafec0 ($6.11 in chips)
Seat 5: eeac0a40 ($7.26 in chips)
eeac0a40: posts small blind $0.02
Hero: posts big blind $0.05
*** HOLE CARDS ***
Dealt to Hero [Ks 7h]
Dealt to e4fafec0 
Dealt to eeac0a40 
e4fafec0: raises $0.08 to $0.13
eeac0a40: calls $0.11
Hero: folds
*** FLOP *** [Th Jh Ac]
eeac0a40: checks
e4fafec0: bets $0.16
eeac0a40: calls $0.16
*** TURN *** [Th Jh Ac] [3h]
eeac0a40: checks
e4fafec0: checks
*** RIVER *** [Th Jh Ac 3h] [8s]
eeac0a40: checks
e4fafec0: checks
eeac0a40: shows [Jc 9h] (Pair of Jacks)
e4fafec0: shows [Tc 7c] (Pair of Tens)
*** SHOWDOWN ***
eeac0a40 collected $0.6 from pot
*** SUMMARY ***
Total pot $0.63 | Rake $0.03 | Jackpot $0 | Bingo $0 | Fortune $0
Board [Th Jh Ac 3h 8s]
Seat 2: Hero (big blind) folded before Flop
Seat 3: e4fafec0 (button) showed [Tc 7c] and lost with Pair of Tens
Seat 5: eeac0a40 (small blind) showed [Jc 9h] and won ($0.6) with Pair of Jacks


Poker Hand #HD1184081553: Hold'em No Limit  ($0.02/$0.05) - 2023/03/31 22:15:22
Table 'NLHBlue109' 6-max Seat #2 is the button
Seat 2: Hero ($5 in chips)
Seat 3: e4fafec0 ($6.13 in chips)
Seat 5: eeac0a40 ($7.38 in chips)
e4fafec0: posts small blind $0.02
eeac0a40: posts big blind $0.05
*** HOLE CARDS ***
Dealt to Hero [Kh Qs]
Dealt to e4fafec0 
Dealt to eeac0a40 
Hero: raises $0.07 to $0.12
e4fafec0: folds
eeac0a40: calls $0.07
*** FLOP *** [4h Qc 9h]
eeac0a40: checks
Hero: bets $0.13
eeac0a40: folds
Uncalled bet ($0.13) returned to Hero
*** SHOWDOWN ***
Hero collected $0.25 from pot
*** SUMMARY ***
Total pot $0.26 | Rake $0.01 | Jackpot $0 | Bingo $0 | Fortune $0
Board [4h Qc 9h]
Seat 2: Hero (button) won ($0.25)
Seat 3: e4fafec0 (small blind) folded before Flop
Seat 5: eeac0a40 (big blind) folded on the Flop


Poker Hand #HD1184081537: Hold'em No Limit  ($0.02/$0.05) - 2023/03/31 22:15:12
Table 'NLHBlue109' 6-max Seat #5 is the button
Seat 2: Hero ($5 in chips)
Seat 3: e4fafec0 ($6.11 in chips)
Seat 5: eeac0a40 ($7.38 in chips)
Hero: posts small blind $0.02
e4fafec0: posts big blind $0.05
*** HOLE CARDS ***
Dealt to Hero [9c 6s]
Dealt to e4fafec0 
Dealt to eeac0a40 
eeac0a40: folds
Hero: folds
Uncalled bet ($0.03) returned to e4fafec0
*** SHOWDOWN ***
e4fafec0 collected $0.04 from pot
*** SUMMARY ***
Total pot $0.04 | Rake $0 | Jackpot $0 | Bingo $0 | Fortune $0
Seat 2: Hero (small blind) folded before Flop
Seat 3: e4fafec0 (big blind) collected ($0.04)
Seat 5: eeac0a40 (button) folded before Flop (didn't bet)


Poker Hand #HD1184081528: Hold'em No Limit  ($0.02/$0.05) - 2023/03/31 22:15:05
Table 'NLHBlue109' 6-max Seat #3 is the button
Seat 2: Hero ($5 in chips)
Seat 3: e4fafec0 ($6.04 in chips)
Seat 5: eeac0a40 ($7.4 in chips)
eeac0a40: posts small blind $0.02
Hero: posts big blind $0.05
*** HOLE CARDS ***
Dealt to Hero [5c 6d]
Dealt to e4fafec0 
Dealt to eeac0a40 
e4fafec0: raises $0.08 to $0.13
eeac0a40: folds
Hero: folds
Uncalled bet ($0.08) returned to e4fafec0
*** SHOWDOWN ***
e4fafec0 collected $0.12 from pot
*** SUMMARY ***
Total pot $0.12 | Rake $0 | Jackpot $0 | Bingo $0 | Fortune $0
Seat 2: Hero (big blind) folded before Flop
Seat 3: e4fafec0 (button) collected ($0.12)
Seat 5: eeac0a40 (small blind) folded before Flop


Poker Hand #HD1184081513: Hold'em No Limit  ($0.02/$0.05) - 2023/03/31 22:14:56
Table 'NLHBlue109' 6-max Seat #2 is the button
Seat 2: Hero ($5 in chips)
Seat 3: e4fafec0 ($5.99 in chips)
Seat 5: eeac0a40 ($7.45 in chips)
e4fafec0: posts small blind $0.02
eeac0a40: posts big blind $0.05
*** HOLE CARDS ***
Dealt to Hero [5c 5h]
Dealt to e4fafec0 
Dealt to eeac0a40 
Hero: folds
e4fafec0: raises $0.08 to $0.13
eeac0a40: folds
Uncalled bet ($0.08) returned to e4fafec0
*** SHOWDOWN ***
e4fafec0 collected $0.1 from pot
*** SUMMARY ***
Total pot $0.1 | Rake $0 | Jackpot $0 | Bingo $0 | Fortune $0
Seat 2: Hero (button) folded before Flop (didn't bet)
Seat 3: e4fafec0 (small blind) collected ($0.1)
Seat 5: eeac0a40 (big blind) folded before Flop


Poker Hand #HD1184081416: Hold'em No Limit  ($0.02/$0.05) - 2023/03/31 22:13:55
Table 'NLHBlue109' 6-max Seat #5 is the button
Seat 2: Hero ($5.02 in chips)
Seat 3: e4fafec0 ($8.5 in chips)
Seat 4: 216513dd ($5.04 in chips)
Seat 5: eeac0a40 ($5.22 in chips)
Hero: posts small blind $0.02
e4fafec0: posts big blind $0.05
*** HOLE CARDS ***
Dealt to Hero [Ac 8h]
Dealt to e4fafec0 
Dealt to 216513dd 
Dealt to eeac0a40 
216513dd: folds
eeac0a40: raises $0.08 to $0.13
Hero: folds
e4fafec0: raises $0.28 to $0.41
eeac0a40: calls $0.28
*** FLOP *** [2d Qh 9d]
e4fafec0: bets $0.42
eeac0a40: calls $0.42
*** TURN *** [2d Qh 9d] [Ts]
e4fafec0: checks
eeac0a40: checks
*** RIVER *** [2d Qh 9d Ts] [6s]
e4fafec0: bets $1.68
eeac0a40: raises $2.71 to $4.39 and is all-in
e4fafec0: folds
Uncalled bet ($2.71) returned to eeac0a40
*** SHOWDOWN ***
eeac0a40 collected $4.74 from pot
*** SUMMARY ***
Total pot $5.04 | Rake $0.25 | Jackpot $0.05 | Bingo $0 | Fortune $0
Board [2d Qh 9d Ts 6s]
Seat 2: Hero (small blind) folded before Flop
Seat 3: e4fafec0 (big blind) folded on the River
Seat 4: 216513dd folded before Flop (didn't bet)
Seat 5: eeac0a40 (button) won ($4.74)


Poker Hand #HD1184081407: Hold'em No Limit  ($0.02/$0.05) - 2023/03/31 22:13:49
Table 'NLHBlue109' 6-max Seat #4 is the button
Seat 2: Hero ($5 in chips)
Seat 3: e4fafec0 ($8.5 in chips)
Seat 4: 216513dd ($5.04 in chips)
Seat 5: eeac0a40 ($5.24 in chips)
eeac0a40: posts small blind $0.02
Hero: posts big blind $0.05
*** HOLE CARDS ***
Dealt to Hero [9s Kh]
Dealt to e4fafec0 
Dealt to 216513dd 
Dealt to eeac0a40 
e4fafec0: folds
216513dd: folds
eeac0a40: folds
Uncalled bet ($0.03) returned to Hero
*** SHOWDOWN ***
Hero collected $0.04 from pot
*** SUMMARY ***
Total pot $0.04 | Rake $0 | Jackpot $0 | Bingo $0 | Fortune $0
Seat 2: Hero (big blind) collected ($0.04)
Seat 3: e4fafec0 folded before Flop (didn't bet)
Seat 4: 216513dd (button) folded before Flop (didn't bet)
Seat 5: eeac0a40 (small blind) folded before Flop


Poker Hand #HD1184081362: Hold'em No Limit  ($0.02/$0.05) - 2023/03/31 22:13:22
Table 'NLHBlue109' 6-max Seat #3 is the button
Seat 1: d87378b5 ($6.15 in chips)
Seat 2: Hero ($5 in chips)
Seat 3: e4fafec0 ($8.63 in chips)
Seat 4: 216513dd ($5.17 in chips)
Seat 5: eeac0a40 ($5 in chips)
216513dd: posts small blind $0.02
eeac0a40: posts big blind $0.05
*** HOLE CARDS ***
Dealt to d87378b5 
Dealt to Hero [Jh 8c]
Dealt to e4fafec0 
Dealt to 216513dd 
Dealt to eeac0a40 
d87378b5: folds
Hero: folds
e4fafec0: raises $0.08 to $0.13
216513dd: calls $0.11
eeac0a40: raises $0.51 to $0.64
e4fafec0: folds
216513dd: folds
Uncalled bet ($0.51) returned to eeac0a40
*** SHOWDOWN ***
eeac0a40 collected $0.37 from pot
*** SUMMARY ***
Total pot $0.39 | Rake $0.02 | Jackpot $0 | Bingo $0 | Fortune $0
Seat 1: d87378b5 folded before Flop (didn't bet)
Seat 2: Hero folded before Flop (didn't bet)
Seat 3: e4fafec0 (button) folded before Flop
Seat 4: 216513dd (small blind) folded before Flop
Seat 5: eeac0a40 (big blind) collected ($0.37)


Poker Hand #HD1184081336: Hold'em No Limit  ($0.02/$0.05) - 2023/03/31 22:13:10
Table 'NLHBlue109' 6-max Seat #2 is the button
Seat 1: d87378b5 ($6.08 in chips)
Seat 2: Hero ($5 in chips)
Seat 3: e4fafec0 ($8.65 in chips)
Seat 4: 216513dd ($5.22 in chips)
Seat 5: eeac0a40 ($5 in chips)
e4fafec0: posts small blind $0.02
216513dd: posts big blind $0.05
*** HOLE CARDS ***
Dealt to d87378b5 
Dealt to Hero [3h 7c]
Dealt to e4fafec0 
Dealt to 216513dd 
Dealt to eeac0a40 
eeac0a40: folds
d87378b5: raises $0.07 to $0.12
Hero: folds
e4fafec0: folds
216513dd: folds
Uncalled bet ($0.07) returned to d87378b5
*** SHOWDOWN ***
d87378b5 collected $0.12 from pot
*** SUMMARY ***
Total pot $0.12 | Rake $0 | Jackpot $0 | Bingo $0 | Fortune $0
Seat 1: d87378b5 collected ($0.12)
Seat 2: Hero (button) folded before Flop (didn't bet)
Seat 3: e4fafec0 (small blind) folded before Flop
Seat 4: 216513dd (big blind) folded before Flop
Seat 5: eeac0a40 folded before Flop (didn't bet)


Poker Hand #HD1184081229: Hold'em No Limit  ($0.02/$0.05) - 2023/03/31 22:11:59
Table 'NLHBlue109' 6-max Seat #1 is the button
Seat 1: d87378b5 ($6.08 in chips)
Seat 2: Hero ($5 in chips)
Seat 3: e4fafec0 ($10.49 in chips)
Seat 4: 216513dd ($1.84 in chips)
Seat 5: eeac0a40 ($6.54 in chips)
Hero: posts small blind $0.02
e4fafec0: posts big blind $0.05
*** HOLE CARDS ***
Dealt to d87378b5 
Dealt to Hero [7d 5h]
Dealt to e4fafec0 
Dealt to 216513dd 
Dealt to eeac0a40 
216513dd: raises $0.07 to $0.12
eeac0a40: calls $0.12
d87378b5: folds
Hero: folds
e4fafec0: calls $0.07
*** FLOP *** [Td 2s 3s]
e4fafec0: checks
216513dd: bets $0.29
eeac0a40: calls $0.29
e4fafec0: raises $1.25 to $1.54
216513dd: raises $0.18 to $1.72 and is all-in
eeac0a40: calls $1.43
e4fafec0: calls $0.18
*** TURN *** [Td 2s 3s] [Ad]
e4fafec0: checks
eeac0a40: checks
*** RIVER *** [Td 2s 3s Ad] [6h]
e4fafec0: bets $5.54
eeac0a40: folds
Uncalled bet ($5.54) returned to e4fafec0
e4fafec0: shows [Tc 6c] (Pair of Tens and Pair of Sixes)
216513dd: shows [Ac As] (Three Aces)
*** SHOWDOWN ***
216513dd collected $5.22 from pot
*** SUMMARY ***
Total pot $5.54 | Rake $0.27 | Jackpot $0.05 | Bingo $0 | Fortune $0
Board [Td 2s 3s Ad 6h]
Seat 1: d87378b5 (button) folded before Flop (didn't bet)
Seat 2: Hero (small blind) folded before Flop
Seat 3: e4fafec0 (big blind) showed [Tc 6c] and lost with Pair of Tens and Pair of Sixes
Seat 4: 216513dd showed [Ac As] and won ($5.22) with Three Aces
Seat 5: eeac0a40 folded on the River


Poker Hand #HD1184081152: Hold'em No Limit  ($0.02/$0.05) - 2023/03/31 22:11:09
Table 'NLHBlue109' 6-max Seat #5 is the button
Seat 1: d87378b5 ($6.1 in chips)
Seat 2: Hero ($5.45 in chips)
Seat 3: e4fafec0 ($10.62 in chips)
Seat 4: 216513dd ($1.97 in chips)
Seat 5: eeac0a40 ($5 in chips)
d87378b5: posts small blind $0.02
Hero: posts big blind $0.05
*** HOLE CARDS ***
Dealt to d87378b5 
Dealt to Hero [Qc Qd]
Dealt to e4fafec0 
Dealt to 216513dd 
Dealt to eeac0a40 
e4fafec0: raises $0.08 to $0.13
216513dd: calls $0.13
eeac0a40: calls $0.13
d87378b5: folds
Hero: raises $0.69 to $0.82
e4fafec0: folds
216513dd: folds
eeac0a40: calls $0.69
*** FLOP *** [9h 6h 5h]
Hero: bets $0.64
eeac0a40: calls $0.64
*** TURN *** [9h 6h 5h] [Kh]
Hero: checks
eeac0a40: checks
*** RIVER *** [9h 6h 5h Kh] [4s]
Hero: checks
eeac0a40: bets $1.83
Hero: folds
Uncalled bet ($1.83) returned to eeac0a40
eeac0a40: shows [5c 4c] (Pair of Fives and Pair of Fours)
*** SHOWDOWN ***
eeac0a40 collected $3 from pot
*** SUMMARY ***
Total pot $3.2 | Rake $0.15 | Jackpot $0.05 | Bingo $0 | Fortune $0
Board [9h 6h 5h Kh 4s]
Seat 1: d87378b5 (small blind) folded before Flop
Seat 2: Hero (big blind) folded on the River
Seat 3: e4fafec0 folded before Flop
Seat 4: 216513dd folded before Flop
Seat 5: eeac0a40 (button) showed [5c 4c] and won ($3) with Pair of Fives and Pair of Fours


Poker Hand #HD1184081128: Hold'em No Limit  ($0.02/$0.05) - 2023/03/31 22:10:57
Table 'NLHBlue109' 6-max Seat #4 is the button
Seat 1: d87378b5 ($6.08 in chips)
Seat 2: Hero ($5.45 in chips)
Seat 3: e4fafec0 ($10.62 in chips)
Seat 4: 216513dd ($1.97 in chips)
Seat 5: eeac0a40 ($5 in chips)
eeac0a40: posts small blind $0.02
d87378b5: posts big blind $0.05
*** HOLE CARDS ***
Dealt to d87378b5 
Dealt to Hero [8s 6s]
Dealt to e4fafec0 
Dealt to 216513dd 
Dealt to eeac0a40 
Hero: folds
e4fafec0: folds
216513dd: folds
eeac0a40: folds
Uncalled bet ($0.03) returned to d87378b5
*** SHOWDOWN ***
d87378b5 collected $0.04 from pot
*** SUMMARY ***
Total pot $0.04 | Rake $0 | Jackpot $0 | Bingo $0 | Fortune $0
Seat 1: d87378b5 (big blind) collected ($0.04)
Seat 2: Hero folded before Flop (didn't bet)
Seat 3: e4fafec0 folded before Flop (didn't bet)
Seat 4: 216513dd (button) folded before Flop (didn't bet)
Seat 5: eeac0a40 (small blind) folded before Flop


Poker Hand #HD1184081065: Hold'em No Limit  ($0.02/$0.05) - 2023/03/31 22:10:11
Table 'NLHBlue109' 6-max Seat #3 is the button
Seat 1: d87378b5 ($6.08 in chips)
Seat 2: Hero ($5.45 in chips)
Seat 3: e4fafec0 ($10.89 in chips)
Seat 4: 216513dd ($1.99 in chips)
Seat 5: eeac0a40 ($5.19 in chips)
Seat 6: 7a12a669 ($5.81 in chips)
216513dd: posts small blind $0.02
eeac0a40: posts big blind $0.05
*** HOLE CARDS ***
Dealt to d87378b5 
Dealt to Hero [4h Tc]
Dealt to e4fafec0 
Dealt to 216513dd 
Dealt to eeac0a40 
Dealt to 7a12a669 
7a12a669: folds
d87378b5: folds
Hero: folds
e4fafec0: raises $0.08 to $0.13
216513dd: folds
eeac0a40: raises $0.37 to $0.5
e4fafec0: raises $10.39 to $10.89 and is all-in
eeac0a40: calls $4.69 and is all-in
Uncalled bet ($5.7) returned to e4fafec0
e4fafec0: shows [Ks Kh]
eeac0a40: shows [9c 9d]
*** FIRST FLOP *** [7d 8h 8s]
*** FIRST TURN *** [7d 8h 8s] [6s]
*** FIRST RIVER *** [7d 8h 8s 6s] [9s]
*** SECOND FLOP *** [Ac Jc Kd]
*** SECOND TURN *** [Ac Jc Kd] [Ah]
*** SECOND RIVER *** [Ac Jc Kd Ah] [2h]
*** FIRST SHOWDOWN ***
eeac0a40 collected $4.93 from pot
*** SECOND SHOWDOWN ***
e4fafec0 collected $4.92 from pot
*** SUMMARY ***
Total pot $10.4 | Rake $0.5 | Jackpot $0.05 | Bingo $0 | Fortune $0
Hand was run two times
FIRST Board [7d 8h 8s 6s 9s]
SECOND Board [Ac Jc Kd Ah 2h]
Seat 1: d87378b5 folded before Flop (didn't bet)
Seat 2: Hero folded before Flop (didn't bet)
Seat 3: e4fafec0 (button) showed [Ks Kh] and lost with Pair of Kings and Pair of Eights, and won ($4.92) with Kings Full over Aces
Seat 4: 216513dd (small blind) folded before Flop
Seat 5: eeac0a40 (big blind) showed [9c 9d] and won ($4.93) with Nines Full over Eights, and lost with Pair of Aces and Pair of Nines
Seat 6: 7a12a669 folded before Flop (didn't bet)


Poker Hand #HD1184081017: Hold'em No Limit  ($0.02/$0.05) - 2023/03/31 22:09:43
Table 'NLHBlue109' 6-max Seat #2 is the button
Seat 1: d87378b5 ($6.08 in chips)
Seat 2: Hero ($5.57 in chips)
Seat 3: e4fafec0 ($10.91 in chips)
Seat 4: 216513dd ($1.86 in chips)
Seat 5: eeac0a40 ($5.19 in chips)
Seat 6: 7a12a669 ($5.81 in chips)
e4fafec0: posts small blind $0.02
216513dd: posts big blind $0.05
*** HOLE CARDS ***
Dealt to d87378b5 
Dealt to Hero [Ad 9s]
Dealt to e4fafec0 
Dealt to 216513dd 
Dealt to eeac0a40 
Dealt to 7a12a669 
eeac0a40: folds
7a12a669: folds
d87378b5: folds
Hero: raises $0.07 to $0.12
e4fafec0: folds
216513dd: raises $0.23 to $0.35
Hero: folds
Uncalled bet ($0.23) returned to 216513dd
*** SHOWDOWN ***
216513dd collected $0.25 from pot
*** SUMMARY ***
Total pot $0.26 | Rake $0.01 | Jackpot $0 | Bingo $0 | Fortune $0
Seat 1: d87378b5 folded before Flop (didn't bet)
Seat 2: Hero (button) folded before Flop
Seat 3: e4fafec0 (small blind) folded before Flop
Seat 4: 216513dd (big blind) collected ($0.25)
Seat 5: eeac0a40 folded before Flop (didn't bet)
Seat 6: 7a12a669 folded before Flop (didn't bet)


Poker Hand #HD1184080975: Hold'em No Limit  ($0.02/$0.05) - 2023/03/31 22:09:18
Table 'NLHBlue109' 6-max Seat #1 is the button
Seat 1: d87378b5 ($6.01 in chips)
Seat 2: Hero ($5.59 in chips)
Seat 3: e4fafec0 ($10.96 in chips)
Seat 4: 216513dd ($1.86 in chips)
Seat 5: eeac0a40 ($5.19 in chips)
Seat 6: 7a12a669 ($5.81 in chips)
Hero: posts small blind $0.02
e4fafec0: posts big blind $0.05
*** HOLE CARDS ***
Dealt to d87378b5 
Dealt to Hero [7d Kd]
Dealt to e4fafec0 
Dealt to 216513dd 
Dealt to eeac0a40 
Dealt to 7a12a669 
216513dd: folds
eeac0a40: folds
7a12a669: folds
d87378b5: raises $0.07 to $0.12
Hero: folds
e4fafec0: folds
Uncalled bet ($0.07) returned to d87378b5
*** SHOWDOWN ***
d87378b5 collected $0.12 from pot
*** SUMMARY ***
Total pot $0.12 | Rake $0 | Jackpot $0 | Bingo $0 | Fortune $0
Seat 1: d87378b5 (button) collected ($0.12)
Seat 2: Hero (small blind) folded before Flop
Seat 3: e4fafec0 (big blind) folded before Flop
Seat 4: 216513dd folded before Flop (didn't bet)
Seat 5: eeac0a40 folded before Flop (didn't bet)
Seat 6: 7a12a669 folded before Flop (didn't bet)


Poker Hand #HD1184080946: Hold'em No Limit  ($0.02/$0.05) - 2023/03/31 22:08:57
Table 'NLHBlue109' 6-max Seat #6 is the button
Seat 1: d87378b5 ($6.03 in chips)
Seat 2: Hero ($5.64 in chips)
Seat 3: e4fafec0 ($11.09 in chips)
Seat 4: 216513dd ($1.86 in chips)
Seat 5: eeac0a40 ($5 in chips)
Seat 6: 7a12a669 ($5.81 in chips)
d87378b5: posts small blind $0.02
Hero: posts big blind $0.05
*** HOLE CARDS ***
Dealt to d87378b5 
Dealt to Hero [9h 7s]
Dealt to e4fafec0 
Dealt to 216513dd 
Dealt to eeac0a40 
Dealt to 7a12a669 
e4fafec0: raises $0.08 to $0.13
216513dd: folds
eeac0a40: raises $0.35 to $0.48
7a12a669: folds
d87378b5: folds
Hero: folds
e4fafec0: folds
Uncalled bet ($0.35) returned to eeac0a40
*** SHOWDOWN ***
eeac0a40 collected $0.32 from pot
*** SUMMARY ***
Total pot $0.33 | Rake $0.01 | Jackpot $0 | Bingo $0 | Fortune $0
Seat 1: d87378b5 (small blind) folded before Flop
Seat 2: Hero (big blind) folded before Flop
Seat 3: e4fafec0 folded before Flop
Seat 4: 216513dd folded before Flop (didn't bet)
Seat 5: eeac0a40 collected ($0.32)
Seat 6: 7a12a669 (button) folded before Flop (didn't bet)


Poker Hand #HD1184080845: Hold'em No Limit  ($0.02/$0.05) - 2023/03/31 22:07:56
Table 'NLHBlue109' 6-max Seat #5 is the button
Seat 1: d87378b5 ($5 in chips)
Seat 2: Hero ($5.64 in chips)
Seat 3: e4fafec0 ($11.09 in chips)
Seat 4: 216513dd ($3.03 in chips)
Seat 5: eeac0a40 ($5 in chips)
Seat 6: 7a12a669 ($5.83 in chips)
7a12a669: posts small blind $0.02
d87378b5: posts big blind $0.05
*** HOLE CARDS ***
Dealt to d87378b5 
Dealt to Hero [Jc 2d]
Dealt to e4fafec0 
Dealt to 216513dd 
Dealt to eeac0a40 
Dealt to 7a12a669 
Hero: folds
e4fafec0: folds
216513dd: raises $0.07 to $0.12
eeac0a40: folds
7a12a669: folds
d87378b5: raises $0.34 to $0.46
216513dd: calls $0.34
*** FLOP *** [Jh 2s 3s]
d87378b5: bets $0.71
216513dd: calls $0.71
*** TURN *** [Jh 2s 3s] [7c]
d87378b5: bets $3.83 and is all-in
216513dd: folds
Uncalled bet ($3.83) returned to d87378b5
*** SHOWDOWN ***
d87378b5 collected $2.2 from pot
*** SUMMARY ***
Total pot $2.36 | Rake $0.11 | Jackpot $0.05 | Bingo $0 | Fortune $0
Board [Jh 2s 3s 7c]
Seat 1: d87378b5 (big blind) won ($2.2)
Seat 2: Hero folded before Flop (didn't bet)
Seat 3: e4fafec0 folded before Flop (didn't bet)
Seat 4: 216513dd folded on the Turn
Seat 5: eeac0a40 (button) folded before Flop (didn't bet)
Seat 6: 7a12a669 (small blind) folded before Flop


Poker Hand #HD1184080748: Hold'em No Limit  ($0.02/$0.05) - 2023/03/31 22:06:52
Table 'NLHBlue109' 6-max Seat #4 is the button
Seat 1: d87378b5 ($5 in chips)
Seat 2: Hero ($5.64 in chips)
Seat 3: e4fafec0 ($10.39 in chips)
Seat 4: 216513dd ($3.38 in chips)
Seat 5: eeac0a40 ($5.32 in chips)
Seat 6: 7a12a669 ($5.88 in chips)
eeac0a40: posts small blind $0.02
7a12a669: posts big blind $0.05
*** HOLE CARDS ***
Dealt to d87378b5 
Dealt to Hero [Kh 4s]
Dealt to e4fafec0 
Dealt to 216513dd 
Dealt to eeac0a40 
Dealt to 7a12a669 
d87378b5: folds
Hero: folds
e4fafec0: raises $0.08 to $0.13
216513dd: calls $0.13
eeac0a40: calls $0.11
7a12a669: folds
*** FLOP *** [8c Kc Qs]
eeac0a40: checks
e4fafec0: bets $0.22
216513dd: calls $0.22
eeac0a40: calls $0.22
*** TURN *** [8c Kc Qs] [5c]
eeac0a40: checks
e4fafec0: checks
216513dd: checks
*** RIVER *** [8c Kc Qs 5c] [2s]
eeac0a40: checks
e4fafec0: bets $0.55
216513dd: folds
eeac0a40: folds
Uncalled bet ($0.55) returned to e4fafec0
*** SHOWDOWN ***
e4fafec0 collected $1.05 from pot
*** SUMMARY ***
Total pot $1.1 | Rake $0.05 | Jackpot $0 | Bingo $0 | Fortune $0
Board [8c Kc Qs 5c 2s]
Seat 1: d87378b5 folded before Flop (didn't bet)
Seat 2: Hero folded before Flop (didn't bet)
Seat 3: e4fafec0 won ($1.05)
Seat 4: 216513dd (button) folded on the River
Seat 5: eeac0a40 (small blind) folded on the River
Seat 6: 7a12a669 (big blind) folded before Flop


Poker Hand #HD1184080711: Hold'em No Limit  ($0.02/$0.05) - 2023/03/31 22:06:26
Table 'NLHBlue109' 6-max Seat #3 is the button
Seat 1: d87378b5 ($5 in chips)
Seat 2: Hero ($5.57 in chips)
Seat 3: e4fafec0 ($10.39 in chips)
Seat 4: 216513dd ($3.4 in chips)
Seat 5: eeac0a40 ($5.37 in chips)
Seat 6: 7a12a669 ($5.88 in chips)
216513dd: posts small blind $0.02
eeac0a40: posts big blind $0.05
*** HOLE CARDS ***
Dealt to d87378b5 
Dealt to Hero [Ts Ac]
Dealt to e4fafec0 
Dealt to 216513dd 
Dealt to eeac0a40 
Dealt to 7a12a669 
7a12a669: folds
d87378b5: folds
Hero: raises $0.07 to $0.12
e4fafec0: folds
216513dd: folds
eeac0a40: folds
Uncalled bet ($0.07) returned to Hero
*** SHOWDOWN ***
Hero collected $0.12 from pot
*** SUMMARY ***
Total pot $0.12 | Rake $0 | Jackpot $0 | Bingo $0 | Fortune $0
Seat 1: d87378b5 folded before Flop (didn't bet)
Seat 2: Hero collected ($0.12)
Seat 3: e4fafec0 (button) folded before Flop (didn't bet)
Seat 4: 216513dd (small blind) folded before Flop
Seat 5: eeac0a40 (big blind) folded before Flop
Seat 6: 7a12a669 folded before Flop (didn't bet)


Poker Hand #HD1184080667: Hold'em No Limit  ($0.02/$0.05) - 2023/03/31 22:05:50
Table 'NLHBlue109' 6-max Seat #2 is the button
Seat 1: d87378b5 ($5 in chips)
Seat 2: Hero ($5.69 in chips)
Seat 3: e4fafec0 ($10.41 in chips)
Seat 4: 216513dd ($3.27 in chips)
Seat 5: eeac0a40 ($5.37 in chips)
Seat 6: 7a12a669 ($5.88 in chips)
e4fafec0: posts small blind $0.02
216513dd: posts big blind $0.05
*** HOLE CARDS ***
Dealt to d87378b5 
Dealt to Hero [Ks 9h]
Dealt to e4fafec0 
Dealt to 216513dd 
Dealt to eeac0a40 
Dealt to 7a12a669 
eeac0a40: folds
7a12a669: folds
d87378b5: folds
Hero: raises $0.07 to $0.12
e4fafec0: folds
216513dd: calls $0.07
*** FLOP *** [3h Ah 8s]
216513dd: checks
Hero: checks
*** TURN *** [3h Ah 8s] [Ad]
216513dd: bets $0.13
Hero: folds
Uncalled bet ($0.13) returned to 216513dd
*** SHOWDOWN ***
216513dd collected $0.25 from pot
*** SUMMARY ***
Total pot $0.26 | Rake $0.01 | Jackpot $0 | Bingo $0 | Fortune $0
Board [3h Ah 8s Ad]
Seat 1: d87378b5 folded before Flop (didn't bet)
Seat 2: Hero (button) folded on the Turn
Seat 3: e4fafec0 (small blind) folded before Flop
Seat 4: 216513dd (big blind) won ($0.25)
Seat 5: eeac0a40 folded before Flop (didn't bet)
Seat 6: 7a12a669 folded before Flop (didn't bet)


Poker Hand #HD1184080656: Hold'em No Limit  ($0.02/$0.05) - 2023/03/31 22:05:42
Table 'NLHBlue109' 6-max Seat #1 is the button
Seat 1: d87378b5 ($5 in chips)
Seat 2: Hero ($5.71 in chips)
Seat 3: e4fafec0 ($10.39 in chips)
Seat 4: 216513dd ($3.27 in chips)
Seat 5: eeac0a40 ($5.37 in chips)
Seat 6: 7a12a669 ($5.88 in chips)
Hero: posts small blind $0.02
e4fafec0: posts big blind $0.05
*** HOLE CARDS ***
Dealt to d87378b5 
Dealt to Hero [4d Qs]
Dealt to e4fafec0 
Dealt to 216513dd 
Dealt to eeac0a40 
Dealt to 7a12a669 
216513dd: folds
eeac0a40: folds
7a12a669: folds
d87378b5: folds
Hero: folds
Uncalled bet ($0.03) returned to e4fafec0
*** SHOWDOWN ***
e4fafec0 collected $0.04 from pot
*** SUMMARY ***
Total pot $0.04 | Rake $0 | Jackpot $0 | Bingo $0 | Fortune $0
Seat 1: d87378b5 (button) folded before Flop (didn't bet)
Seat 2: Hero (small blind) folded before Flop
Seat 3: e4fafec0 (big blind) collected ($0.04)
Seat 4: 216513dd folded before Flop (didn't bet)
Seat 5: eeac0a40 folded before Flop (didn't bet)
Seat 6: 7a12a669 folded before Flop (didn't bet)


Poker Hand #HD1184080635: Hold'em No Limit  ($0.02/$0.05) - 2023/03/31 22:05:34
Table 'NLHBlue109' 6-max Seat #6 is the button
Seat 1: d87378b5 ($5.02 in chips)
Seat 2: Hero ($5.69 in chips)
Seat 3: e4fafec0 ($10.39 in chips)
Seat 4: 216513dd ($3.27 in chips)
Seat 5: eeac0a40 ($5.37 in chips)
Seat 6: 7a12a669 ($5.88 in chips)
d87378b5: posts small blind $0.02
Hero: posts big blind $0.05
*** HOLE CARDS ***
Dealt to d87378b5 
Dealt to Hero [6d As]
Dealt to e4fafec0 
Dealt to 216513dd 
Dealt to eeac0a40 
Dealt to 7a12a669 
e4fafec0: folds
216513dd: folds
eeac0a40: folds
7a12a669: folds
d87378b5: folds
Uncalled bet ($0.03) returned to Hero
*** SHOWDOWN ***
Hero collected $0.04 from pot
*** SUMMARY ***
Total pot $0.04 | Rake $0 | Jackpot $0 | Bingo $0 | Fortune $0
Seat 1: d87378b5 (small blind) folded before Flop
Seat 2: Hero (big blind) collected ($0.04)
Seat 3: e4fafec0 folded before Flop (didn't bet)
Seat 4: 216513dd folded before Flop (didn't bet)
Seat 5: eeac0a40 folded before Flop (didn't bet)
Seat 6: 7a12a669 (button) folded before Flop (didn't bet)


Poker Hand #HD1184080571: Hold'em No Limit  ($0.02/$0.05) - 2023/03/31 22:04:48
Table 'NLHBlue109' 6-max Seat #5 is the button
Seat 1: d87378b5 ($5.07 in chips)
Seat 2: Hero ($5 in chips)
Seat 3: e4fafec0 ($10.39 in chips)
Seat 4: 216513dd ($4.01 in chips)
Seat 5: eeac0a40 ($5.37 in chips)
Seat 6: 7a12a669 ($5.9 in chips)
7a12a669: posts small blind $0.02
d87378b5: posts big blind $0.05
*** HOLE CARDS ***
Dealt to d87378b5 
Dealt to Hero [Ah Th]
Dealt to e4fafec0 
Dealt to 216513dd 
Dealt to eeac0a40 
Dealt to 7a12a669 
Hero: raises $0.07 to $0.12
e4fafec0: folds
216513dd: raises $0.23 to $0.35
eeac0a40: folds
7a12a669: folds
d87378b5: folds
Hero: calls $0.23
*** FLOP *** [3h 4c 5d]
Hero: checks
216513dd: bets $0.39
Hero: calls $0.39
*** TURN *** [3h 4c 5d] [2s]
Hero: checks
216513dd: checks
*** RIVER *** [3h 4c 5d 2s] [9s]
Hero: checks
216513dd: checks
Hero: shows [Ah Th] (Fives-High Straight)
216513dd: shows [Jd Js] (Pair of Jacks)
*** SHOWDOWN ***
Hero collected $1.43 from pot
*** SUMMARY ***
Total pot $1.55 | Rake $0.07 | Jackpot $0.05 | Bingo $0 | Fortune $0
Board [3h 4c 5d 2s 9s]
Seat 1: d87378b5 (big blind) folded before Flop
Seat 2: Hero showed [Ah Th] and won ($1.43) with Fives-High Straight
Seat 3: e4fafec0 folded before Flop (didn't bet)
Seat 4: 216513dd showed [Jd Js] and lost with Pair of Jacks
Seat 5: eeac0a40 (button) folded before Flop (didn't bet)
Seat 6: 7a12a669 (small blind) folded before Flop


Poker Hand #HD1184080536: Hold'em No Limit  ($0.02/$0.05) - 2023/03/31 22:04:26
Table 'NLHBlue109' 6-max Seat #4 is the button
Seat 1: d87378b5 ($5.07 in chips)
Seat 2: Hero ($5 in chips)
Seat 3: e4fafec0 ($10.25 in chips)
Seat 4: 216513dd ($4.01 in chips)
Seat 5: eeac0a40 ($5.39 in chips)
Seat 6: 7a12a669 ($6.03 in chips)
eeac0a40: posts small blind $0.02
7a12a669: posts big blind $0.05
*** HOLE CARDS ***
Dealt to d87378b5 
Dealt to Hero [9c 8s]
Dealt to e4fafec0 
Dealt to 216513dd 
Dealt to eeac0a40 
Dealt to 7a12a669 
d87378b5: folds
Hero: folds
e4fafec0: raises $0.08 to $0.13
216513dd: folds
eeac0a40: folds
7a12a669: calls $0.08
*** FLOP *** [7d Js 2d]
7a12a669: checks
e4fafec0: bets $0.14
7a12a669: folds
Uncalled bet ($0.14) returned to e4fafec0
*** SHOWDOWN ***
e4fafec0 collected $0.27 from pot
*** SUMMARY ***
Total pot $0.28 | Rake $0.01 | Jackpot $0 | Bingo $0 | Fortune $0
Board [7d Js 2d]
Seat 1: d87378b5 folded before Flop (didn't bet)
Seat 2: Hero folded before Flop (didn't bet)
Seat 3: e4fafec0 won ($0.27)
Seat 4: 216513dd (button) folded before Flop (didn't bet)
Seat 5: eeac0a40 (small blind) folded before Flop
Seat 6: 7a12a669 (big blind) folded on the Flop


Poker Hand #HD1184080454: Hold'em No Limit  ($0.02/$0.05) - 2023/03/31 22:03:34
Table 'NLHBlue109' 6-max Seat #3 is the button
Seat 1: d87378b5 ($5.07 in chips)
Seat 2: Hero ($5 in chips)
Seat 3: e4fafec0 ($10.66 in chips)
Seat 4: 216513dd ($4.03 in chips)
Seat 5: eeac0a40 ($5 in chips)
Seat 6: 7a12a669 ($6.03 in chips)
216513dd: posts small blind $0.02
eeac0a40: posts big blind $0.05
*** HOLE CARDS ***
Dealt to d87378b5 
Dealt to Hero [6d 7c]
Dealt to e4fafec0 
Dealt to 216513dd 
Dealt to eeac0a40 
Dealt to 7a12a669 
7a12a669: folds
d87378b5: folds
Hero: folds
e4fafec0: raises $0.08 to $0.13
216513dd: folds
eeac0a40: calls $0.08
*** FLOP *** [Jc Js 4d]
eeac0a40: checks
e4fafec0: checks
*** TURN *** [Jc Js 4d] [Qs]
eeac0a40: checks
e4fafec0: bets $0.28
eeac0a40: calls $0.28
*** RIVER *** [Jc Js 4d Qs] [As]
eeac0a40: bets $0.98
e4fafec0: folds
Uncalled bet ($0.98) returned to eeac0a40
*** SHOWDOWN ***
eeac0a40 collected $0.8 from pot
*** SUMMARY ***
Total pot $0.84 | Rake $0.04 | Jackpot $0 | Bingo $0 | Fortune $0
Board [Jc Js 4d Qs As]
Seat 1: d87378b5 folded before Flop (didn't bet)
Seat 2: Hero folded before Flop (didn't bet)
Seat 3: e4fafec0 (button) folded on the River
Seat 4: 216513dd (small blind) folded before Flop
Seat 5: eeac0a40 (big blind) won ($0.8)
Seat 6: 7a12a669 folded before Flop (didn't bet)


Poker Hand #HD1184080333: Hold'em No Limit  ($0.02/$0.05) - 2023/03/31 22:02:19
Table 'NLHBlue109' 6-max Seat #2 is the button
Seat 1: d87378b5 ($5.07 in chips)
Seat 2: Hero ($5 in chips)
Seat 3: e4fafec0 ($5.87 in chips)
Seat 4: 216513dd ($4.08 in chips)
Seat 5: eeac0a40 ($5.29 in chips)
Seat 6: 7a12a669 ($6.03 in chips)
e4fafec0: posts small blind $0.02
216513dd: posts big blind $0.05
*** HOLE CARDS ***
Dealt to d87378b5 
Dealt to Hero [3d 9h]
Dealt to e4fafec0 
Dealt to 216513dd 
Dealt to eeac0a40 
Dealt to 7a12a669 
eeac0a40: raises $0.1 to $0.15
7a12a669: folds
d87378b5: folds
Hero: folds
e4fafec0: calls $0.13
216513dd: folds
*** FLOP *** [7d Ad 6c]
e4fafec0: checks
eeac0a40: bets $0.2
e4fafec0: calls $0.2
*** TURN *** [7d Ad 6c] [3s]
e4fafec0: checks
eeac0a40: bets $0.46
e4fafec0: raises $1.67 to $2.13
eeac0a40: raises $2.81 to $4.94 and is all-in
e4fafec0: calls $2.81
eeac0a40: shows [Kd Ac] (Pair of Aces)
e4fafec0: shows [5h 4s] (Sevens-High Straight)
*** RIVER *** [7d Ad 6c 3s] [Ah]
*** SHOWDOWN ***
e4fafec0 collected $10.08 from pot
*** SUMMARY ***
Total pot $10.63 | Rake $0.5 | Jackpot $0.05 | Bingo $0 | Fortune $0
Board [7d Ad 6c 3s Ah]
Seat 1: d87378b5 folded before Flop (didn't bet)
Seat 2: Hero (button) folded before Flop (didn't bet)
Seat 3: e4fafec0 (small blind) showed [5h 4s] and won ($10.08) with Sevens-High Straight
Seat 4: 216513dd (big blind) folded before Flop
Seat 5: eeac0a40 showed [Kd Ac] and lost with Three Aces
Seat 6: 7a12a669 folded before Flop (didn't bet)


Poker Hand #HD1184080320: Hold'em No Limit  ($0.02/$0.05) - 2023/03/31 22:02:10
Table 'NLHBlue109' 6-max Seat #1 is the button
Seat 1: d87378b5 ($5.07 in chips)
Seat 2: Hero ($5 in chips)
Seat 3: e4fafec0 ($5.85 in chips)
Seat 4: 216513dd ($4.08 in chips)
Seat 5: eeac0a40 ($5.29 in chips)
Seat 6: 7a12a669 ($6.03 in chips)
Hero: posts small blind $0.02
e4fafec0: posts big blind $0.05
*** HOLE CARDS ***
Dealt to d87378b5 
Dealt to Hero [3s Jc]
Dealt to e4fafec0 
Dealt to 216513dd 
Dealt to eeac0a40 
Dealt to 7a12a669 
216513dd: folds
eeac0a40: folds
7a12a669: folds
d87378b5: folds
Hero: folds
Uncalled bet ($0.03) returned to e4fafec0
*** SHOWDOWN ***
e4fafec0 collected $0.04 from pot
*** SUMMARY ***
Total pot $0.04 | Rake $0 | Jackpot $0 | Bingo $0 | Fortune $0
Seat 1: d87378b5 (button) folded before Flop (didn't bet)
Seat 2: Hero (small blind) folded before Flop
Seat 3: e4fafec0 (big blind) collected ($0.04)
Seat 4: 216513dd folded before Flop (didn't bet)
Seat 5: eeac0a40 folded before Flop (didn't bet)
Seat 6: 7a12a669 folded before Flop (didn't bet)


Poker Hand #HD1184080287: Hold'em No Limit  ($0.02/$0.05) - 2023/03/31 22:01:48
Table 'NLHBlue109' 6-max Seat #6 is the button
Seat 1: d87378b5 ($5.09 in chips)
Seat 2: Hero ($5 in chips)
Seat 3: e4fafec0 ($5.78 in chips)
Seat 4: 216513dd ($4.08 in chips)
Seat 5: eeac0a40 ($5.29 in chips)
Seat 6: 7a12a669 ($6.03 in chips)
d87378b5: posts small blind $0.02
Hero: posts big blind $0.05
e4fafec0: straddle $0.1
*** HOLE CARDS ***
Dealt to d87378b5 
Dealt to Hero [4s Jc]
Dealt to e4fafec0 
Dealt to 216513dd 
Dealt to eeac0a40 
Dealt to 7a12a669 
216513dd: folds
eeac0a40: folds
7a12a669: folds
d87378b5: folds
Hero: folds
Uncalled bet ($0.05) returned to e4fafec0
*** SHOWDOWN ***
e4fafec0 collected $0.12 from pot
*** SUMMARY ***
Total pot $0.12 | Rake $0 | Jackpot $0 | Bingo $0 | Fortune $0
Seat 1: d87378b5 (small blind) folded before Flop
Seat 2: Hero (big blind) folded before Flop
Seat 3: e4fafec0 collected ($0.12)
Seat 4: 216513dd folded before Flop (didn't bet)
Seat 5: eeac0a40 folded before Flop (didn't bet)
Seat 6: 7a12a669 (button) folded before Flop (didn't bet)


