Poker Hand #HD1212472839: Hold'em No Limit  ($0.02/$0.05) - 2023/04/21 22:25:04
Table 'NLHBlue37' 6-max Seat #6 is the button
Seat 1: 114302a1 ($5.44 in chips)
Seat 2: bede2c8c ($5 in chips)
Seat 3: Hero ($5.47 in chips)
Seat 4: 1cd48777 ($8.2 in chips)
Seat 5: 1aabe800 ($6.02 in chips)
Seat 6: 4eb7f1df ($5 in chips)
114302a1: posts small blind $0.02
bede2c8c: posts big blind $0.05
*** HOLE CARDS ***
Dealt to 114302a1 
Dealt to bede2c8c 
Dealt to Hero [Tc 9s]
Dealt to 1cd48777 
Dealt to 1aabe800 
Dealt to 4eb7f1df 
Hero: folds
1cd48777: raises $0.1 to $0.15
1aabe800: folds
4eb7f1df: calls $0.15
114302a1: folds
bede2c8c: folds
*** FLOP *** [Qs 2s 8d]
1cd48777: bets $0.19
4eb7f1df: folds
Uncalled bet ($0.19) returned to 1cd48777
*** SHOWDOWN ***
1cd48777 collected $0.35 from pot
*** SUMMARY ***
Total pot $0.37 | Rake $0.02 | Jackpot $0 | Bingo $0 | Fortune $0
Board [Qs 2s 8d]
Seat 1: 114302a1 (small blind) folded before Flop
Seat 2: bede2c8c (big blind) folded before Flop
Seat 3: Hero folded before Flop (didn't bet)
Seat 4: 1cd48777 won ($0.35)
Seat 5: 1aabe800 folded before Flop (didn't bet)
Seat 6: 4eb7f1df (button) folded on the Flop


Poker Hand #HD1212472724: Hold'em No Limit  ($0.02/$0.05) - 2023/04/21 22:23:55
Table 'NLHBlue37' 6-max Seat #5 is the button
Seat 1: 114302a1 ($5.18 in chips)
Seat 2: bede2c8c ($5.07 in chips)
Seat 3: Hero ($5.47 in chips)
Seat 4: 1cd48777 ($8.33 in chips)
Seat 5: 1aabe800 ($6.02 in chips)
Seat 6: 4eb7f1df ($5 in chips)
4eb7f1df: posts small blind $0.02
114302a1: posts big blind $0.05
*** HOLE CARDS ***
Dealt to 114302a1 
Dealt to bede2c8c 
Dealt to Hero [2s 9h]
Dealt to 1cd48777 
Dealt to 1aabe800 
Dealt to 4eb7f1df 
bede2c8c: raises $0.08 to $0.13
Hero: folds
1cd48777: calls $0.13
1aabe800: folds
4eb7f1df: folds
114302a1: calls $0.08
*** FLOP *** [6h Kd 9c]
114302a1: checks
bede2c8c: checks
1cd48777: checks
*** TURN *** [6h Kd 9c] [Qs]
114302a1: bets $0.3
bede2c8c: folds
1cd48777: folds
Uncalled bet ($0.3) returned to 114302a1
*** SHOWDOWN ***
114302a1 collected $0.39 from pot
*** SUMMARY ***
Total pot $0.41 | Rake $0.02 | Jackpot $0 | Bingo $0 | Fortune $0
Board [6h Kd 9c Qs]
Seat 1: 114302a1 (big blind) won ($0.39)
Seat 2: bede2c8c folded on the Turn
Seat 3: Hero folded before Flop (didn't bet)
Seat 4: 1cd48777 folded on the Turn
Seat 5: 1aabe800 (button) folded before Flop (didn't bet)
Seat 6: 4eb7f1df (small blind) folded before Flop


Poker Hand #HD1212472681: Hold'em No Limit  ($0.02/$0.05) - 2023/04/21 22:23:36
Table 'NLHBlue37' 6-max Seat #4 is the button
Seat 1: 114302a1 ($5.18 in chips)
Seat 2: bede2c8c ($5.07 in chips)
Seat 3: Hero ($5.4 in chips)
Seat 4: 1cd48777 ($8.33 in chips)
Seat 5: 1aabe800 ($6.04 in chips)
Seat 6: 4eb7f1df ($5 in chips)
1aabe800: posts small blind $0.02
4eb7f1df: posts big blind $0.05
*** HOLE CARDS ***
Dealt to 114302a1 
Dealt to bede2c8c 
Dealt to Hero [9d Ah]
Dealt to 1cd48777 
Dealt to 1aabe800 
Dealt to 4eb7f1df 
114302a1: folds
bede2c8c: folds
Hero: raises $0.07 to $0.12
1cd48777: folds
1aabe800: folds
4eb7f1df: folds
Uncalled bet ($0.07) returned to Hero
*** SHOWDOWN ***
Hero collected $0.12 from pot
*** SUMMARY ***
Total pot $0.12 | Rake $0 | Jackpot $0 | Bingo $0 | Fortune $0
Seat 1: 114302a1 folded before Flop (didn't bet)
Seat 2: bede2c8c folded before Flop (didn't bet)
Seat 3: Hero collected ($0.12)
Seat 4: 1cd48777 (button) folded before Flop (didn't bet)
Seat 5: 1aabe800 (small blind) folded before Flop
Seat 6: 4eb7f1df (big blind) folded before Flop


Poker Hand #HD1212472648: Hold'em No Limit  ($0.02/$0.05) - 2023/04/21 22:23:19
Table 'NLHBlue37' 6-max Seat #3 is the button
Seat 1: 114302a1 ($5.18 in chips)
Seat 2: bede2c8c ($5.07 in chips)
Seat 3: Hero ($5.4 in chips)
Seat 4: 1cd48777 ($8.28 in chips)
Seat 5: 1aabe800 ($6.09 in chips)
1cd48777: posts small blind $0.02
1aabe800: posts big blind $0.05
*** HOLE CARDS ***
Dealt to 114302a1 
Dealt to bede2c8c 
Dealt to Hero [9h Kc]
Dealt to 1cd48777 
Dealt to 1aabe800 
114302a1: folds
bede2c8c: folds
Hero: folds
1cd48777: raises $0.1 to $0.15
1aabe800: folds
Uncalled bet ($0.1) returned to 1cd48777
*** SHOWDOWN ***
1cd48777 collected $0.1 from pot
*** SUMMARY ***
Total pot $0.1 | Rake $0 | Jackpot $0 | Bingo $0 | Fortune $0
Seat 1: 114302a1 folded before Flop (didn't bet)
Seat 2: bede2c8c folded before Flop (didn't bet)
Seat 3: Hero (button) folded before Flop (didn't bet)
Seat 4: 1cd48777 (small blind) collected ($0.1)
Seat 5: 1aabe800 (big blind) folded before Flop


Poker Hand #HD1212472619: Hold'em No Limit  ($0.02/$0.05) - 2023/04/21 22:23:08
Table 'NLHBlue37' 6-max Seat #2 is the button
Seat 1: 114302a1 ($5.18 in chips)
Seat 2: bede2c8c ($5.07 in chips)
Seat 3: Hero ($5.42 in chips)
Seat 4: 1cd48777 ($8.26 in chips)
Seat 5: 1aabe800 ($6.09 in chips)
Hero: posts small blind $0.02
1cd48777: posts big blind $0.05
*** HOLE CARDS ***
Dealt to 114302a1 
Dealt to bede2c8c 
Dealt to Hero [3c 2d]
Dealt to 1cd48777 
Dealt to 1aabe800 
1aabe800: folds
114302a1: folds
bede2c8c: folds
Hero: folds
Uncalled bet ($0.03) returned to 1cd48777
*** SHOWDOWN ***
1cd48777 collected $0.04 from pot
*** SUMMARY ***
Total pot $0.04 | Rake $0 | Jackpot $0 | Bingo $0 | Fortune $0
Seat 1: 114302a1 folded before Flop (didn't bet)
Seat 2: bede2c8c (button) folded before Flop (didn't bet)
Seat 3: Hero (small blind) folded before Flop
Seat 4: 1cd48777 (big blind) collected ($0.04)
Seat 5: 1aabe800 folded before Flop (didn't bet)


Poker Hand #HD1212472587: Hold'em No Limit  ($0.02/$0.05) - 2023/04/21 22:22:51
Table 'NLHBlue37' 6-max Seat #1 is the button
Seat 1: 114302a1 ($5.18 in chips)
Seat 2: bede2c8c ($5.09 in chips)
Seat 3: Hero ($5.4 in chips)
Seat 4: 1cd48777 ($8.26 in chips)
Seat 5: 1aabe800 ($6.09 in chips)
bede2c8c: posts small blind $0.02
Hero: posts big blind $0.05
*** HOLE CARDS ***
Dealt to 114302a1 
Dealt to bede2c8c 
Dealt to Hero [4c Ac]
Dealt to 1cd48777 
Dealt to 1aabe800 
1cd48777: folds
1aabe800: folds
114302a1: folds
bede2c8c: folds
Uncalled bet ($0.03) returned to Hero
*** SHOWDOWN ***
Hero collected $0.04 from pot
*** SUMMARY ***
Total pot $0.04 | Rake $0 | Jackpot $0 | Bingo $0 | Fortune $0
Seat 1: 114302a1 (button) folded before Flop (didn't bet)
Seat 2: bede2c8c (small blind) folded before Flop
Seat 3: Hero (big blind) collected ($0.04)
Seat 4: 1cd48777 folded before Flop (didn't bet)
Seat 5: 1aabe800 folded before Flop (didn't bet)


Poker Hand #HD1212472459: Hold'em No Limit  ($0.02/$0.05) - 2023/04/21 22:21:41
Table 'NLHBlue37' 6-max Seat #5 is the button
Seat 1: 114302a1 ($5.23 in chips)
Seat 2: bede2c8c ($5.09 in chips)
Seat 3: Hero ($5.4 in chips)
Seat 4: 1cd48777 ($8.49 in chips)
Seat 5: 1aabe800 ($6.09 in chips)
Seat 6: 9e93707c ($7.91 in chips)
9e93707c: posts small blind $0.02
114302a1: posts big blind $0.05
*** HOLE CARDS ***
Dealt to 114302a1 
Dealt to bede2c8c 
Dealt to Hero [Kh 7h]
Dealt to 1cd48777 
Dealt to 1aabe800 
Dealt to 9e93707c 
bede2c8c: folds
Hero: folds
1cd48777: raises $0.05 to $0.1
1aabe800: folds
9e93707c: calls $0.08
114302a1: folds
*** FLOP *** [Tc Jh 7d]
9e93707c: checks
1cd48777: bets $0.13
9e93707c: calls $0.13
*** TURN *** [Tc Jh 7d] [8d]
9e93707c: checks
1cd48777: checks
*** RIVER *** [Tc Jh 7d 8d] [Js]
9e93707c: bets $0.69
1cd48777: folds
Uncalled bet ($0.69) returned to 9e93707c
*** SHOWDOWN ***
9e93707c collected $0.49 from pot
*** SUMMARY ***
Total pot $0.51 | Rake $0.02 | Jackpot $0 | Bingo $0 | Fortune $0
Board [Tc Jh 7d 8d Js]
Seat 1: 114302a1 (big blind) folded before Flop
Seat 2: bede2c8c folded before Flop (didn't bet)
Seat 3: Hero folded before Flop (didn't bet)
Seat 4: 1cd48777 folded on the River
Seat 5: 1aabe800 (button) folded before Flop (didn't bet)
Seat 6: 9e93707c (small blind) won ($0.49)


Poker Hand #HD1212472403: Hold'em No Limit  ($0.02/$0.05) - 2023/04/21 22:21:07
Table 'NLHBlue37' 6-max Seat #4 is the button
Seat 1: 114302a1 ($5.23 in chips)
Seat 2: bede2c8c ($5.09 in chips)
Seat 3: Hero ($5.4 in chips)
Seat 4: 1cd48777 ($8.38 in chips)
Seat 5: 1aabe800 ($6.11 in chips)
Seat 6: 9e93707c ($8.01 in chips)
1aabe800: posts small blind $0.02
9e93707c: posts big blind $0.05
*** HOLE CARDS ***
Dealt to 114302a1 
Dealt to bede2c8c 
Dealt to Hero [8s Ah]
Dealt to 1cd48777 
Dealt to 1aabe800 
Dealt to 9e93707c 
114302a1: folds
bede2c8c: folds
Hero: folds
1cd48777: raises $0.05 to $0.1
1aabe800: folds
9e93707c: calls $0.05
*** FLOP *** [8d 3c 3d]
9e93707c: checks
1cd48777: checks
*** TURN *** [8d 3c 3d] [As]
9e93707c: checks
1cd48777: bets $0.11
9e93707c: folds
Uncalled bet ($0.11) returned to 1cd48777
*** SHOWDOWN ***
1cd48777 collected $0.21 from pot
*** SUMMARY ***
Total pot $0.22 | Rake $0.01 | Jackpot $0 | Bingo $0 | Fortune $0
Board [8d 3c 3d As]
Seat 1: 114302a1 folded before Flop (didn't bet)
Seat 2: bede2c8c folded before Flop (didn't bet)
Seat 3: Hero folded before Flop (didn't bet)
Seat 4: 1cd48777 (button) won ($0.21)
Seat 5: 1aabe800 (small blind) folded before Flop
Seat 6: 9e93707c (big blind) folded on the Turn


Poker Hand #HD1212472334: Hold'em No Limit  ($0.02/$0.05) - 2023/04/21 22:20:31
Table 'NLHBlue37' 6-max Seat #3 is the button
Seat 1: 114302a1 ($5.23 in chips)
Seat 2: bede2c8c ($5.09 in chips)
Seat 3: Hero ($5 in chips)
Seat 4: 1cd48777 ($8.4 in chips)
Seat 5: 1aabe800 ($6.53 in chips)
Seat 6: 9e93707c ($8.01 in chips)
1cd48777: posts small blind $0.02
1aabe800: posts big blind $0.05
*** HOLE CARDS ***
Dealt to 114302a1 
Dealt to bede2c8c 
Dealt to Hero [Ts 9s]
Dealt to 1cd48777 
Dealt to 1aabe800 
Dealt to 9e93707c 
9e93707c: folds
114302a1: folds
bede2c8c: folds
Hero: raises $0.07 to $0.12
1cd48777: folds
1aabe800: raises $0.3 to $0.42
Hero: calls $0.3
*** FLOP *** [5h Js As]
1aabe800: checks
Hero: bets $0.62
1aabe800: folds
Uncalled bet ($0.62) returned to Hero
*** SHOWDOWN ***
Hero collected $0.82 from pot
*** SUMMARY ***
Total pot $0.86 | Rake $0.04 | Jackpot $0 | Bingo $0 | Fortune $0
Board [5h Js As]
Seat 1: 114302a1 folded before Flop (didn't bet)
Seat 2: bede2c8c folded before Flop (didn't bet)
Seat 3: Hero (button) won ($0.82)
Seat 4: 1cd48777 (small blind) folded before Flop
Seat 5: 1aabe800 (big blind) folded on the Flop
Seat 6: 9e93707c folded before Flop (didn't bet)


Poker Hand #HD1212472201: Hold'em No Limit  ($0.02/$0.05) - 2023/04/21 22:19:21
Table 'NLHBlue37' 6-max Seat #2 is the button
Seat 1: 114302a1 ($5 in chips)
Seat 2: bede2c8c ($5.09 in chips)
Seat 3: Hero ($5.02 in chips)
Seat 4: 1cd48777 ($8.63 in chips)
Seat 5: 1aabe800 ($6.53 in chips)
Seat 6: 9e93707c ($8.01 in chips)
Hero: posts small blind $0.02
1cd48777: posts big blind $0.05
*** HOLE CARDS ***
Dealt to 114302a1 
Dealt to bede2c8c 
Dealt to Hero [Qd Tc]
Dealt to 1cd48777 
Dealt to 1aabe800 
Dealt to 9e93707c 
1aabe800: folds
9e93707c: folds
114302a1: raises $0.06 to $0.11
bede2c8c: folds
Hero: folds
1cd48777: calls $0.06
*** FLOP *** [8d 5s 7c]
1cd48777: checks
114302a1: bets $0.12
1cd48777: calls $0.12
*** TURN *** [8d 5s 7c] [7d]
1cd48777: checks
114302a1: checks
*** RIVER *** [8d 5s 7c 7d] [Ts]
1cd48777: checks
114302a1: checks
1cd48777: shows [Jh Kd] (Pair of Sevens)
114302a1: shows [3s 3h] (Pair of Sevens and Pair of Treys)
*** SHOWDOWN ***
114302a1 collected $0.46 from pot
*** SUMMARY ***
Total pot $0.48 | Rake $0.02 | Jackpot $0 | Bingo $0 | Fortune $0
Board [8d 5s 7c 7d Ts]
Seat 1: 114302a1 showed [3s 3h] and won ($0.46) with Pair of Sevens and Pair of Treys
Seat 2: bede2c8c (button) folded before Flop (didn't bet)
Seat 3: Hero (small blind) folded before Flop
Seat 4: 1cd48777 (big blind) showed [Jh Kd] and lost with Pair of Sevens
Seat 5: 1aabe800 folded before Flop (didn't bet)
Seat 6: 9e93707c folded before Flop (didn't bet)


Poker Hand #HD1212472146: Hold'em No Limit  ($0.02/$0.05) - 2023/04/21 22:18:51
Table 'NLHBlue37' 6-max Seat #1 is the button
Seat 1: 114302a1 ($5 in chips)
Seat 2: bede2c8c ($5.11 in chips)
Seat 3: Hero ($5 in chips)
Seat 4: 1cd48777 ($8.63 in chips)
Seat 5: 1aabe800 ($6.53 in chips)
Seat 6: 9e93707c ($8.01 in chips)
bede2c8c: posts small blind $0.02
Hero: posts big blind $0.05
*** HOLE CARDS ***
Dealt to 114302a1 
Dealt to bede2c8c 
Dealt to Hero [Qd 5h]
Dealt to 1cd48777 
Dealt to 1aabe800 
Dealt to 9e93707c 
1cd48777: folds
1aabe800: folds
9e93707c: folds
114302a1: folds
bede2c8c: folds
Uncalled bet ($0.03) returned to Hero
*** SHOWDOWN ***
Hero collected $0.04 from pot
*** SUMMARY ***
Total pot $0.04 | Rake $0 | Jackpot $0 | Bingo $0 | Fortune $0
Seat 1: 114302a1 (button) folded before Flop (didn't bet)
Seat 2: bede2c8c (small blind) folded before Flop
Seat 3: Hero (big blind) collected ($0.04)
Seat 4: 1cd48777 folded before Flop (didn't bet)
Seat 5: 1aabe800 folded before Flop (didn't bet)
Seat 6: 9e93707c folded before Flop (didn't bet)


Poker Hand #HD1212472070: Hold'em No Limit  ($0.02/$0.05) - 2023/04/21 22:18:15
Table 'NLHBlue37' 6-max Seat #6 is the button
Seat 1: 114302a1 ($5 in chips)
Seat 2: bede2c8c ($5.16 in chips)
Seat 3: Hero ($5 in chips)
Seat 4: 1cd48777 ($8.05 in chips)
Seat 5: 1aabe800 ($6.53 in chips)
Seat 6: 9e93707c ($8.29 in chips)
114302a1: posts small blind $0.02
bede2c8c: posts big blind $0.05
*** HOLE CARDS ***
Dealt to 114302a1 
Dealt to bede2c8c 
Dealt to Hero [Jc Ad]
Dealt to 1cd48777 
Dealt to 1aabe800 
Dealt to 9e93707c 
Hero: raises $0.07 to $0.12
1cd48777: raises $0.16 to $0.28
1aabe800: folds
9e93707c: calls $0.28
114302a1: folds
bede2c8c: folds
Hero: calls $0.16
*** FLOP *** [Kd 6s 4c]
Hero: checks
1cd48777: bets $0.46
9e93707c: folds
Hero: folds
Uncalled bet ($0.46) returned to 1cd48777
*** SHOWDOWN ***
1cd48777 collected $0.86 from pot
*** SUMMARY ***
Total pot $0.91 | Rake $0.05 | Jackpot $0 | Bingo $0 | Fortune $0
Board [Kd 6s 4c]
Seat 1: 114302a1 (small blind) folded before Flop
Seat 2: bede2c8c (big blind) folded before Flop
Seat 3: Hero folded on the Flop
Seat 4: 1cd48777 won ($0.86)
Seat 5: 1aabe800 folded before Flop (didn't bet)
Seat 6: 9e93707c (button) folded on the Flop


Poker Hand #HD1212471992: Hold'em No Limit  ($0.02/$0.05) - 2023/04/21 22:17:30
Table 'NLHBlue37' 6-max Seat #5 is the button
Seat 1: 114302a1 ($5 in chips)
Seat 2: bede2c8c ($5.16 in chips)
Seat 3: Hero ($5 in chips)
Seat 4: 1cd48777 ($7.8 in chips)
Seat 5: 1aabe800 ($6.53 in chips)
Seat 6: 9e93707c ($8.52 in chips)
9e93707c: posts small blind $0.02
114302a1: posts big blind $0.05
*** HOLE CARDS ***
Dealt to 114302a1 
Dealt to bede2c8c 
Dealt to Hero [4d 5d]
Dealt to 1cd48777 
Dealt to 1aabe800 
Dealt to 9e93707c 
bede2c8c: folds
Hero: folds
1cd48777: raises $0.05 to $0.1
1aabe800: folds
9e93707c: calls $0.08
114302a1: folds
*** FLOP *** [4h 3c 5c]
9e93707c: checks
1cd48777: bets $0.13
9e93707c: calls $0.13
*** TURN *** [4h 3c 5c] [Kc]
9e93707c: checks
1cd48777: bets $0.26
9e93707c: folds
Uncalled bet ($0.26) returned to 1cd48777
*** SHOWDOWN ***
1cd48777 collected $0.48 from pot
*** SUMMARY ***
Total pot $0.51 | Rake $0.03 | Jackpot $0 | Bingo $0 | Fortune $0
Board [4h 3c 5c Kc]
Seat 1: 114302a1 (big blind) folded before Flop
Seat 2: bede2c8c folded before Flop (didn't bet)
Seat 3: Hero folded before Flop (didn't bet)
Seat 4: 1cd48777 won ($0.48)
Seat 5: 1aabe800 (button) folded before Flop (didn't bet)
Seat 6: 9e93707c (small blind) folded on the Turn


Poker Hand #HD1212471870: Hold'em No Limit  ($0.02/$0.05) - 2023/04/21 22:16:27
Table 'NLHBlue37' 6-max Seat #4 is the button
Seat 1: 114302a1 ($5 in chips)
Seat 2: bede2c8c ($5.16 in chips)
Seat 3: Hero ($5.53 in chips)
Seat 4: 1cd48777 ($7.8 in chips)
Seat 5: 1aabe800 ($6.55 in chips)
Seat 6: 9e93707c ($7.51 in chips)
1aabe800: posts small blind $0.02
9e93707c: posts big blind $0.05
*** HOLE CARDS ***
Dealt to 114302a1 
Dealt to bede2c8c 
Dealt to Hero [Ah Qs]
Dealt to 1cd48777 
Dealt to 1aabe800 
Dealt to 9e93707c 
114302a1: raises $0.06 to $0.11
bede2c8c: folds
Hero: raises $0.21 to $0.32
1cd48777: folds
1aabe800: folds
9e93707c: calls $0.27
114302a1: calls $0.21
*** FLOP *** [9h Td 8d]
9e93707c: bets $0.49
114302a1: folds
Hero: calls $0.49
*** TURN *** [9h Td 8d] [8c]
9e93707c: bets $0.98
Hero: folds
Uncalled bet ($0.98) returned to 9e93707c
*** SHOWDOWN ***
9e93707c collected $1.82 from pot
*** SUMMARY ***
Total pot $1.96 | Rake $0.09 | Jackpot $0.05 | Bingo $0 | Fortune $0
Board [9h Td 8d 8c]
Seat 1: 114302a1 folded on the Flop
Seat 2: bede2c8c folded before Flop (didn't bet)
Seat 3: Hero folded on the Turn
Seat 4: 1cd48777 (button) folded before Flop (didn't bet)
Seat 5: 1aabe800 (small blind) folded before Flop
Seat 6: 9e93707c (big blind) won ($1.82)


Poker Hand #HD1212471710: Hold'em No Limit  ($0.02/$0.05) - 2023/04/21 22:14:59
Table 'NLHBlue37' 6-max Seat #3 is the button
Seat 1: 114302a1 ($5 in chips)
Seat 2: bede2c8c ($5.16 in chips)
Seat 3: Hero ($5.53 in chips)
Seat 4: 1cd48777 ($7.82 in chips)
Seat 5: 1aabe800 ($5 in chips)
Seat 6: 9e93707c ($7.51 in chips)
1cd48777: posts small blind $0.02
1aabe800: posts big blind $0.05
*** HOLE CARDS ***
Dealt to 114302a1 
Dealt to bede2c8c 
Dealt to Hero [3c Tc]
Dealt to 1cd48777 
Dealt to 1aabe800 
Dealt to 9e93707c 
9e93707c: folds
114302a1: raises $0.06 to $0.11
bede2c8c: folds
Hero: folds
1cd48777: folds
1aabe800: calls $0.06
*** FLOP *** [9s 7d 8d]
1aabe800: checks
114302a1: bets $0.12
1aabe800: raises $0.3 to $0.42
114302a1: calls $0.3
*** TURN *** [9s 7d 8d] [Ah]
1aabe800: bets $0.36
114302a1: raises $0.86 to $1.22
1aabe800: calls $0.86
*** RIVER *** [9s 7d 8d Ah] [Jc]
1aabe800: checks
114302a1: checks
1aabe800: shows [9h Td] (Jacks-High Straight)
114302a1: shows [7h 7s] (Three Sevens)
*** SHOWDOWN ***
1aabe800 collected $3.3 from pot
*** SUMMARY ***
Total pot $3.52 | Rake $0.17 | Jackpot $0.05 | Bingo $0 | Fortune $0
Board [9s 7d 8d Ah Jc]
Seat 1: 114302a1 showed [7h 7s] and lost with Three Sevens
Seat 2: bede2c8c folded before Flop (didn't bet)
Seat 3: Hero (button) folded before Flop (didn't bet)
Seat 4: 1cd48777 (small blind) folded before Flop
Seat 5: 1aabe800 (big blind) showed [9h Td] and won ($3.3) with Jacks-High Straight
Seat 6: 9e93707c folded before Flop (didn't bet)


Poker Hand #HD1212471681: Hold'em No Limit  ($0.02/$0.05) - 2023/04/21 22:14:46
Table 'NLHBlue37' 6-max Seat #2 is the button
Seat 1: 114302a1 ($5 in chips)
Seat 2: bede2c8c ($5.16 in chips)
Seat 3: Hero ($5.55 in chips)
Seat 4: 1cd48777 ($7.8 in chips)
Seat 5: 1aabe800 ($1.21 in chips)
Seat 6: 9e93707c ($7.51 in chips)
Hero: posts small blind $0.02
1cd48777: posts big blind $0.05
*** HOLE CARDS ***
Dealt to 114302a1 
Dealt to bede2c8c 
Dealt to Hero [3d 4s]
Dealt to 1cd48777 
Dealt to 1aabe800 
Dealt to 9e93707c 
1aabe800: folds
9e93707c: folds
114302a1: folds
bede2c8c: folds
Hero: folds
Uncalled bet ($0.03) returned to 1cd48777
*** SHOWDOWN ***
1cd48777 collected $0.04 from pot
*** SUMMARY ***
Total pot $0.04 | Rake $0 | Jackpot $0 | Bingo $0 | Fortune $0
Seat 1: 114302a1 folded before Flop (didn't bet)
Seat 2: bede2c8c (button) folded before Flop (didn't bet)
Seat 3: Hero (small blind) folded before Flop
Seat 4: 1cd48777 (big blind) collected ($0.04)
Seat 5: 1aabe800 folded before Flop (didn't bet)
Seat 6: 9e93707c folded before Flop (didn't bet)


Poker Hand #HD1212471637: Hold'em No Limit  ($0.02/$0.05) - 2023/04/21 22:14:23
Table 'NLHBlue37' 6-max Seat #1 is the button
Seat 1: 114302a1 ($5 in chips)
Seat 2: bede2c8c ($5.18 in chips)
Seat 3: Hero ($5.6 in chips)
Seat 4: 1cd48777 ($7.73 in chips)
Seat 5: 1aabe800 ($1.21 in chips)
Seat 6: 9e93707c ($7.51 in chips)
bede2c8c: posts small blind $0.02
Hero: posts big blind $0.05
*** HOLE CARDS ***
Dealt to 114302a1 
Dealt to bede2c8c 
Dealt to Hero [5d Tc]
Dealt to 1cd48777 
Dealt to 1aabe800 
Dealt to 9e93707c 
1cd48777: raises $0.1 to $0.15
1aabe800: folds
9e93707c: folds
114302a1: folds
bede2c8c: folds
Hero: folds
Uncalled bet ($0.1) returned to 1cd48777
*** SHOWDOWN ***
1cd48777 collected $0.12 from pot
*** SUMMARY ***
Total pot $0.12 | Rake $0 | Jackpot $0 | Bingo $0 | Fortune $0
Seat 1: 114302a1 (button) folded before Flop (didn't bet)
Seat 2: bede2c8c (small blind) folded before Flop
Seat 3: Hero (big blind) folded before Flop
Seat 4: 1cd48777 collected ($0.12)
Seat 5: 1aabe800 folded before Flop (didn't bet)
Seat 6: 9e93707c folded before Flop (didn't bet)


Poker Hand #HD1212471595: Hold'em No Limit  ($0.02/$0.05) - 2023/04/21 22:13:55
Table 'NLHBlue37' 6-max Seat #6 is the button
Seat 1: 114302a1 ($5.02 in chips)
Seat 2: bede2c8c ($5.23 in chips)
Seat 3: Hero ($5.6 in chips)
Seat 4: 1cd48777 ($7.88 in chips)
Seat 5: 1aabe800 ($1 in chips)
Seat 6: 9e93707c ($7.51 in chips)
114302a1: posts small blind $0.02
bede2c8c: posts big blind $0.05
*** HOLE CARDS ***
Dealt to 114302a1 
Dealt to bede2c8c 
Dealt to Hero [3h 9s]
Dealt to 1cd48777 
Dealt to 1aabe800 
Dealt to 9e93707c 
Hero: folds
1cd48777: raises $0.1 to $0.15
1aabe800: raises $0.31 to $0.46
9e93707c: folds
114302a1: folds
bede2c8c: folds
1cd48777: folds
Uncalled bet ($0.31) returned to 1aabe800
*** SHOWDOWN ***
1aabe800 collected $0.36 from pot
*** SUMMARY ***
Total pot $0.37 | Rake $0.01 | Jackpot $0 | Bingo $0 | Fortune $0
Seat 1: 114302a1 (small blind) folded before Flop
Seat 2: bede2c8c (big blind) folded before Flop
Seat 3: Hero folded before Flop (didn't bet)
Seat 4: 1cd48777 folded before Flop
Seat 5: 1aabe800 collected ($0.36)
Seat 6: 9e93707c (button) folded before Flop (didn't bet)


Poker Hand #HD1212471569: Hold'em No Limit  ($0.02/$0.05) - 2023/04/21 22:13:40
Table 'NLHBlue37' 6-max Seat #5 is the button
Seat 1: 114302a1 ($5 in chips)
Seat 2: bede2c8c ($5.23 in chips)
Seat 3: Hero ($5.6 in chips)
Seat 4: 1cd48777 ($7.88 in chips)
Seat 5: 1aabe800 ($1 in chips)
Seat 6: 9e93707c ($7.53 in chips)
9e93707c: posts small blind $0.02
114302a1: posts big blind $0.05
*** HOLE CARDS ***
Dealt to 114302a1 
Dealt to bede2c8c 
Dealt to Hero [8d 9c]
Dealt to 1cd48777 
Dealt to 1aabe800 
Dealt to 9e93707c 
bede2c8c: folds
Hero: folds
1cd48777: folds
1aabe800: folds
9e93707c: folds
Uncalled bet ($0.03) returned to 114302a1
*** SHOWDOWN ***
114302a1 collected $0.04 from pot
*** SUMMARY ***
Total pot $0.04 | Rake $0 | Jackpot $0 | Bingo $0 | Fortune $0
Seat 1: 114302a1 (big blind) collected ($0.04)
Seat 2: bede2c8c folded before Flop (didn't bet)
Seat 3: Hero folded before Flop (didn't bet)
Seat 4: 1cd48777 folded before Flop (didn't bet)
Seat 5: 1aabe800 (button) folded before Flop (didn't bet)
Seat 6: 9e93707c (small blind) folded before Flop


Poker Hand #HD1212471526: Hold'em No Limit  ($0.02/$0.05) - 2023/04/21 22:13:18
Table 'NLHBlue37' 6-max Seat #4 is the button
Seat 1: 114302a1 ($5 in chips)
Seat 2: bede2c8c ($5.23 in chips)
Seat 3: Hero ($5.53 in chips)
Seat 4: 1cd48777 ($7.88 in chips)
Seat 5: 1aabe800 ($1.02 in chips)
Seat 6: 9e93707c ($7.58 in chips)
1aabe800: posts small blind $0.02
9e93707c: posts big blind $0.05
*** HOLE CARDS ***
Dealt to 114302a1 
Dealt to bede2c8c 
Dealt to Hero [9c Tc]
Dealt to 1cd48777 
Dealt to 1aabe800 
Dealt to 9e93707c 
114302a1: folds
bede2c8c: folds
Hero: raises $0.07 to $0.12
1cd48777: folds
1aabe800: folds
9e93707c: folds
Uncalled bet ($0.07) returned to Hero
*** SHOWDOWN ***
Hero collected $0.12 from pot
*** SUMMARY ***
Total pot $0.12 | Rake $0 | Jackpot $0 | Bingo $0 | Fortune $0
Seat 1: 114302a1 folded before Flop (didn't bet)
Seat 2: bede2c8c folded before Flop (didn't bet)
Seat 3: Hero collected ($0.12)
Seat 4: 1cd48777 (button) folded before Flop (didn't bet)
Seat 5: 1aabe800 (small blind) folded before Flop
Seat 6: 9e93707c (big blind) folded before Flop


Poker Hand #HD1212471504: Hold'em No Limit  ($0.02/$0.05) - 2023/04/21 22:13:07
Table 'NLHBlue37' 6-max Seat #3 is the button
Seat 1: 114302a1 ($5 in chips)
Seat 2: bede2c8c ($5.23 in chips)
Seat 3: Hero ($5.53 in chips)
Seat 4: 1cd48777 ($7.9 in chips)
Seat 5: 1aabe800 ($1 in chips)
Seat 6: 9e93707c ($7.58 in chips)
1cd48777: posts small blind $0.02
1aabe800: posts big blind $0.05
*** HOLE CARDS ***
Dealt to 114302a1 
Dealt to bede2c8c 
Dealt to Hero [4d 9c]
Dealt to 1cd48777 
Dealt to 1aabe800 
Dealt to 9e93707c 
9e93707c: folds
114302a1: folds
bede2c8c: folds
Hero: folds
1cd48777: folds
Uncalled bet ($0.03) returned to 1aabe800
*** SHOWDOWN ***
1aabe800 collected $0.04 from pot
*** SUMMARY ***
Total pot $0.04 | Rake $0 | Jackpot $0 | Bingo $0 | Fortune $0
Seat 1: 114302a1 folded before Flop (didn't bet)
Seat 2: bede2c8c folded before Flop (didn't bet)
Seat 3: Hero (button) folded before Flop (didn't bet)
Seat 4: 1cd48777 (small blind) folded before Flop
Seat 5: 1aabe800 (big blind) collected ($0.04)
Seat 6: 9e93707c folded before Flop (didn't bet)


Poker Hand #HD1212471386: Hold'em No Limit  ($0.02/$0.05) - 2023/04/21 22:12:07
Table 'NLHBlue37' 6-max Seat #2 is the button
Seat 1: 114302a1 ($5 in chips)
Seat 2: bede2c8c ($5.23 in chips)
Seat 3: Hero ($5.55 in chips)
Seat 4: 1cd48777 ($8.43 in chips)
Seat 6: 9e93707c ($7.08 in chips)
Hero: posts small blind $0.02
1cd48777: posts big blind $0.05
*** HOLE CARDS ***
Dealt to 114302a1 
Dealt to bede2c8c 
Dealt to Hero [Qh 2s]
Dealt to 1cd48777 
Dealt to 9e93707c 
9e93707c: raises $0.08 to $0.13
114302a1: folds
bede2c8c: folds
Hero: folds
1cd48777: calls $0.08
*** FLOP *** [9d Ah 4h]
1cd48777: checks
9e93707c: checks
*** TURN *** [9d Ah 4h] [Ac]
1cd48777: bets $0.15
9e93707c: calls $0.15
*** RIVER *** [9d Ah 4h Ac] [4c]
1cd48777: bets $0.25
9e93707c: calls $0.25
1cd48777: shows [7s 7h] (Pair of Aces and Pair of Sevens)
9e93707c: shows [8c 8d] (Pair of Aces and Pair of Eights)
*** SHOWDOWN ***
9e93707c collected $1.03 from pot
*** SUMMARY ***
Total pot $1.08 | Rake $0.05 | Jackpot $0 | Bingo $0 | Fortune $0
Board [9d Ah 4h Ac 4c]
Seat 1: 114302a1 folded before Flop (didn't bet)
Seat 2: bede2c8c (button) folded before Flop (didn't bet)
Seat 3: Hero (small blind) folded before Flop
Seat 4: 1cd48777 (big blind) showed [7s 7h] and lost with Pair of Aces and Pair of Sevens
Seat 6: 9e93707c showed [8c 8d] and won ($1.03) with Pair of Aces and Pair of Eights


Poker Hand #HD1212471362: Hold'em No Limit  ($0.02/$0.05) - 2023/04/21 22:11:55
Table 'NLHBlue37' 6-max Seat #1 is the button
Seat 1: 114302a1 ($5 in chips)
Seat 2: bede2c8c ($5.25 in chips)
Seat 3: Hero ($5.6 in chips)
Seat 4: 1cd48777 ($8.36 in chips)
Seat 5: cc5ed315 ($5 in chips)
Seat 6: 9e93707c ($7.08 in chips)
bede2c8c: posts small blind $0.02
Hero: posts big blind $0.05
*** HOLE CARDS ***
Dealt to 114302a1 
Dealt to bede2c8c 
Dealt to Hero [2d 4d]
Dealt to 1cd48777 
Dealt to cc5ed315 
Dealt to 9e93707c 
1cd48777: raises $0.05 to $0.1
cc5ed315: folds
9e93707c: folds
114302a1: folds
bede2c8c: folds
Hero: folds
Uncalled bet ($0.05) returned to 1cd48777
*** SHOWDOWN ***
1cd48777 collected $0.12 from pot
*** SUMMARY ***
Total pot $0.12 | Rake $0 | Jackpot $0 | Bingo $0 | Fortune $0
Seat 1: 114302a1 (button) folded before Flop (didn't bet)
Seat 2: bede2c8c (small blind) folded before Flop
Seat 3: Hero (big blind) folded before Flop
Seat 4: 1cd48777 collected ($0.12)
Seat 5: cc5ed315 folded before Flop (didn't bet)
Seat 6: 9e93707c folded before Flop (didn't bet)


Poker Hand #HD1212471289: Hold'em No Limit  ($0.02/$0.05) - 2023/04/21 22:11:14
Table 'NLHBlue37' 6-max Seat #6 is the button
Seat 1: 114302a1 ($5 in chips)
Seat 2: bede2c8c ($5.14 in chips)
Seat 3: Hero ($5.6 in chips)
Seat 4: 1cd48777 ($8.46 in chips)
Seat 5: cc5ed315 ($5 in chips)
Seat 6: 9e93707c ($7.08 in chips)
114302a1: posts small blind $0.02
bede2c8c: posts big blind $0.05
*** HOLE CARDS ***
Dealt to 114302a1 
Dealt to bede2c8c 
Dealt to Hero [9c 8s]
Dealt to 1cd48777 
Dealt to cc5ed315 
Dealt to 9e93707c 
Hero: folds
1cd48777: raises $0.05 to $0.1
cc5ed315: folds
9e93707c: folds
114302a1: folds
bede2c8c: raises $0.46 to $0.56
1cd48777: folds
Uncalled bet ($0.46) returned to bede2c8c
*** SHOWDOWN ***
bede2c8c collected $0.21 from pot
*** SUMMARY ***
Total pot $0.22 | Rake $0.01 | Jackpot $0 | Bingo $0 | Fortune $0
Seat 1: 114302a1 (small blind) folded before Flop
Seat 2: bede2c8c (big blind) collected ($0.21)
Seat 3: Hero folded before Flop (didn't bet)
Seat 4: 1cd48777 folded before Flop
Seat 5: cc5ed315 folded before Flop (didn't bet)
Seat 6: 9e93707c (button) folded before Flop (didn't bet)


Poker Hand #HD1212471179: Hold'em No Limit  ($0.02/$0.05) - 2023/04/21 22:10:11
Table 'NLHBlue37' 6-max Seat #5 is the button
Seat 1: 114302a1 ($5 in chips)
Seat 2: bede2c8c ($5.14 in chips)
Seat 3: Hero ($5.6 in chips)
Seat 4: 1cd48777 ($8.46 in chips)
Seat 5: cc5ed315 ($5 in chips)
Seat 6: 9e93707c ($6.12 in chips)
9e93707c: posts small blind $0.02
114302a1: posts big blind $0.05
*** HOLE CARDS ***
Dealt to 114302a1 
Dealt to bede2c8c 
Dealt to Hero [5c 8h]
Dealt to 1cd48777 
Dealt to cc5ed315 
Dealt to 9e93707c 
bede2c8c: folds
Hero: folds
1cd48777: folds
cc5ed315: folds
9e93707c: calls $0.03
114302a1: checks
*** FLOP *** [6s Jc Tc]
9e93707c: bets $0.1
114302a1: calls $0.1
*** TURN *** [6s Jc Tc] [7h]
9e93707c: bets $0.15
114302a1: calls $0.15
*** RIVER *** [6s Jc Tc 7h] [5h]
9e93707c: bets $0.81
114302a1: calls $0.81
9e93707c: shows [9d 8d] (Jacks-High Straight)
114302a1: shows [8c 4c] (Eights-High Straight)
*** SHOWDOWN ***
9e93707c collected $2.07 from pot
*** SUMMARY ***
Total pot $2.22 | Rake $0.1 | Jackpot $0.05 | Bingo $0 | Fortune $0
Board [6s Jc Tc 7h 5h]
Seat 1: 114302a1 (big blind) showed [8c 4c] and lost with Eights-High Straight
Seat 2: bede2c8c folded before Flop (didn't bet)
Seat 3: Hero folded before Flop (didn't bet)
Seat 4: 1cd48777 folded before Flop (didn't bet)
Seat 5: cc5ed315 (button) folded before Flop (didn't bet)
Seat 6: 9e93707c (small blind) showed [9d 8d] and won ($2.07) with Jacks-High Straight


Poker Hand #HD1212471154: Hold'em No Limit  ($0.02/$0.05) - 2023/04/21 22:10:00
Table 'NLHBlue37' 6-max Seat #4 is the button
Seat 2: bede2c8c ($5.14 in chips)
Seat 3: Hero ($5.6 in chips)
Seat 4: 1cd48777 ($8.46 in chips)
Seat 5: cc5ed315 ($5 in chips)
Seat 6: 9e93707c ($6.1 in chips)
cc5ed315: posts small blind $0.02
9e93707c: posts big blind $0.05
*** HOLE CARDS ***
Dealt to bede2c8c 
Dealt to Hero [Qh 6s]
Dealt to 1cd48777 
Dealt to cc5ed315 
Dealt to 9e93707c 
bede2c8c: folds
Hero: folds
1cd48777: folds
cc5ed315: folds
Uncalled bet ($0.03) returned to 9e93707c
*** SHOWDOWN ***
9e93707c collected $0.04 from pot
*** SUMMARY ***
Total pot $0.04 | Rake $0 | Jackpot $0 | Bingo $0 | Fortune $0
Seat 2: bede2c8c folded before Flop (didn't bet)
Seat 3: Hero folded before Flop (didn't bet)
Seat 4: 1cd48777 (button) folded before Flop (didn't bet)
Seat 5: cc5ed315 (small blind) folded before Flop
Seat 6: 9e93707c (big blind) collected ($0.04)


Poker Hand #HD1212471125: Hold'em No Limit  ($0.02/$0.05) - 2023/04/21 22:09:43
Table 'NLHBlue37' 6-max Seat #3 is the button
Seat 2: bede2c8c ($5.14 in chips)
Seat 3: Hero ($5.6 in chips)
Seat 4: 1cd48777 ($8.41 in chips)
Seat 5: cc5ed315 ($5 in chips)
Seat 6: 9e93707c ($6.1 in chips)
1cd48777: posts small blind $0.02
cc5ed315: posts big blind $0.05
*** HOLE CARDS ***
Dealt to bede2c8c 
Dealt to Hero [8c 7h]
Dealt to 1cd48777 
Dealt to cc5ed315 
Dealt to 9e93707c 
9e93707c: folds
bede2c8c: folds
Hero: folds
1cd48777: raises $0.1 to $0.15
cc5ed315: folds
Uncalled bet ($0.1) returned to 1cd48777
*** SHOWDOWN ***
1cd48777 collected $0.1 from pot
*** SUMMARY ***
Total pot $0.1 | Rake $0 | Jackpot $0 | Bingo $0 | Fortune $0
Seat 2: bede2c8c folded before Flop (didn't bet)
Seat 3: Hero (button) folded before Flop (didn't bet)
Seat 4: 1cd48777 (small blind) collected ($0.1)
Seat 5: cc5ed315 (big blind) folded before Flop
Seat 6: 9e93707c folded before Flop (didn't bet)


Poker Hand #HD1212471041: Hold'em No Limit  ($0.02/$0.05) - 2023/04/21 22:08:50
Table 'NLHBlue37' 6-max Seat #2 is the button
Seat 2: bede2c8c ($5.14 in chips)
Seat 3: Hero ($5.62 in chips)
Seat 4: 1cd48777 ($8.54 in chips)
Seat 5: cc5ed315 ($5 in chips)
Seat 6: 9e93707c ($5.96 in chips)
Hero: posts small blind $0.02
1cd48777: posts big blind $0.05
*** HOLE CARDS ***
Dealt to bede2c8c 
Dealt to Hero [9d Th]
Dealt to 1cd48777 
Dealt to cc5ed315 
Dealt to 9e93707c 
cc5ed315: folds
9e93707c: raises $0.08 to $0.13
bede2c8c: folds
Hero: folds
1cd48777: calls $0.08
*** FLOP *** [Jc Td 5c]
1cd48777: checks
9e93707c: checks
*** TURN *** [Jc Td 5c] [Js]
1cd48777: checks
9e93707c: checks
*** RIVER *** [Jc Td 5c Js] [Kh]
1cd48777: checks
9e93707c: checks
1cd48777: shows [6h Qs] (Pair of Jacks)
9e93707c: shows [Ad Qc] (Aces-High Straight)
*** SHOWDOWN ***
9e93707c collected $0.27 from pot
*** SUMMARY ***
Total pot $0.28 | Rake $0.01 | Jackpot $0 | Bingo $0 | Fortune $0
Board [Jc Td 5c Js Kh]
Seat 2: bede2c8c (button) folded before Flop (didn't bet)
Seat 3: Hero (small blind) folded before Flop
Seat 4: 1cd48777 (big blind) showed [6h Qs] and lost with Pair of Jacks
Seat 5: cc5ed315 folded before Flop (didn't bet)
Seat 6: 9e93707c showed [Ad Qc] and won ($0.27) with Aces-High Straight


Poker Hand #HD1212470997: Hold'em No Limit  ($0.02/$0.05) - 2023/04/21 22:08:24
Table 'NLHBlue37' 6-max Seat #6 is the button
Seat 2: bede2c8c ($5 in chips)
Seat 3: Hero ($5.77 in chips)
Seat 4: 1cd48777 ($8.54 in chips)
Seat 5: cc5ed315 ($5 in chips)
Seat 6: 9e93707c ($5.96 in chips)
bede2c8c: posts small blind $0.02
Hero: posts big blind $0.05
*** HOLE CARDS ***
Dealt to bede2c8c 
Dealt to Hero [Th Js]
Dealt to 1cd48777 
Dealt to cc5ed315 
Dealt to 9e93707c 
1cd48777: folds
cc5ed315: folds
9e93707c: folds
bede2c8c: raises $0.1 to $0.15
Hero: calls $0.1
*** FLOP *** [3d 8h Ac]
bede2c8c: bets $0.1
Hero: folds
Uncalled bet ($0.1) returned to bede2c8c
*** SHOWDOWN ***
bede2c8c collected $0.29 from pot
*** SUMMARY ***
Total pot $0.3 | Rake $0.01 | Jackpot $0 | Bingo $0 | Fortune $0
Board [3d 8h Ac]
Seat 2: bede2c8c (small blind) won ($0.29)
Seat 3: Hero (big blind) folded on the Flop
Seat 4: 1cd48777 folded before Flop (didn't bet)
Seat 5: cc5ed315 folded before Flop (didn't bet)
Seat 6: 9e93707c (button) folded before Flop (didn't bet)


Poker Hand #HD1212470869: Hold'em No Limit  ($0.02/$0.05) - 2023/04/21 22:07:17
Table 'NLHBlue37' 6-max Seat #5 is the button
Seat 2: bede2c8c ($5 in chips)
Seat 3: Hero ($5.77 in chips)
Seat 4: 1cd48777 ($8.08 in chips)
Seat 5: cc5ed315 ($5 in chips)
Seat 6: 9e93707c ($6.21 in chips)
9e93707c: posts small blind $0.02
bede2c8c: posts big blind $0.05
*** HOLE CARDS ***
Dealt to bede2c8c 
Dealt to Hero [Th 3h]
Dealt to 1cd48777 
Dealt to cc5ed315 
Dealt to 9e93707c 
Hero: folds
1cd48777: raises $0.05 to $0.1
cc5ed315: folds
9e93707c: calls $0.08
bede2c8c: calls $0.05
*** FLOP *** [2h 4d 9c]
9e93707c: checks
bede2c8c: checks
1cd48777: checks
*** TURN *** [2h 4d 9c] [Jd]
9e93707c: checks
bede2c8c: checks
1cd48777: bets $0.15
9e93707c: calls $0.15
bede2c8c: calls $0.15
*** RIVER *** [2h 4d 9c Jd] [6s]
9e93707c: checks
bede2c8c: checks
1cd48777: checks
9e93707c: shows [Ac 3c] (Ace-High)
bede2c8c: shows [Ad 5c] (Ace-High)
1cd48777: shows [6d Ah] (Pair of Sixes)
*** SHOWDOWN ***
1cd48777 collected $0.71 from pot
*** SUMMARY ***
Total pot $0.75 | Rake $0.04 | Jackpot $0 | Bingo $0 | Fortune $0
Board [2h 4d 9c Jd 6s]
Seat 2: bede2c8c (big blind) showed [Ad 5c] and lost with Ace-High
Seat 3: Hero folded before Flop (didn't bet)
Seat 4: 1cd48777 showed [6d Ah] and won ($0.71) with Pair of Sixes
Seat 5: cc5ed315 (button) folded before Flop (didn't bet)
Seat 6: 9e93707c (small blind) showed [Ac 3c] and lost with Ace-High


Poker Hand #HD1212470845: Hold'em No Limit  ($0.02/$0.05) - 2023/04/21 22:07:04
Table 'NLHBlue37' 6-max Seat #4 is the button
Seat 2: bede2c8c ($5 in chips)
Seat 3: Hero ($5.77 in chips)
Seat 4: 1cd48777 ($8.08 in chips)
Seat 5: cc5ed315 ($5 in chips)
Seat 6: 9e93707c ($6.19 in chips)
cc5ed315: posts small blind $0.02
9e93707c: posts big blind $0.05
*** HOLE CARDS ***
Dealt to bede2c8c 
Dealt to Hero [5d Ac]
Dealt to 1cd48777 
Dealt to cc5ed315 
Dealt to 9e93707c 
bede2c8c: folds
Hero: folds
1cd48777: folds
cc5ed315: folds
Uncalled bet ($0.03) returned to 9e93707c
*** SHOWDOWN ***
9e93707c collected $0.04 from pot
*** SUMMARY ***
Total pot $0.04 | Rake $0 | Jackpot $0 | Bingo $0 | Fortune $0
Seat 2: bede2c8c folded before Flop (didn't bet)
Seat 3: Hero folded before Flop (didn't bet)
Seat 4: 1cd48777 (button) folded before Flop (didn't bet)
Seat 5: cc5ed315 (small blind) folded before Flop
Seat 6: 9e93707c (big blind) collected ($0.04)


Poker Hand #HD1212470741: Hold'em No Limit  ($0.02/$0.05) - 2023/04/21 22:06:08
Table 'NLHBlue37' 6-max Seat #3 is the button
Seat 2: bede2c8c ($5 in chips)
Seat 3: Hero ($5.9 in chips)
Seat 4: 1cd48777 ($8.1 in chips)
Seat 5: cc5ed315 ($5 in chips)
Seat 6: 9e93707c ($6 in chips)
1cd48777: posts small blind $0.02
cc5ed315: posts big blind $0.05
*** HOLE CARDS ***
Dealt to bede2c8c 
Dealt to Hero [9h Ah]
Dealt to 1cd48777 
Dealt to cc5ed315 
Dealt to 9e93707c 
9e93707c: raises $0.08 to $0.13
bede2c8c: folds
Hero: calls $0.13
1cd48777: folds
cc5ed315: folds
*** FLOP *** [4d Ks 5s]
9e93707c: checks
Hero: checks
*** TURN *** [4d Ks 5s] [2s]
9e93707c: checks
Hero: checks
*** RIVER *** [4d Ks 5s 2s] [Ts]
9e93707c: checks
Hero: checks
9e93707c: shows [Th Ac] (Pair of Tens)
Hero: shows [9h Ah] (Ace-High)
*** SHOWDOWN ***
9e93707c collected $0.32 from pot
*** SUMMARY ***
Total pot $0.33 | Rake $0.01 | Jackpot $0 | Bingo $0 | Fortune $0
Board [4d Ks 5s 2s Ts]
Seat 2: bede2c8c folded before Flop (didn't bet)
Seat 3: Hero (button) showed [9h Ah] and lost with Ace-High
Seat 4: 1cd48777 (small blind) folded before Flop
Seat 5: cc5ed315 (big blind) folded before Flop
Seat 6: 9e93707c showed [Th Ac] and won ($0.32) with Pair of Tens


Poker Hand #HD1212470665: Hold'em No Limit  ($0.02/$0.05) - 2023/04/21 22:05:30
Table 'NLHBlue37' 6-max Seat #2 is the button
Seat 2: bede2c8c ($5 in chips)
Seat 3: Hero ($5.92 in chips)
Seat 4: 1cd48777 ($7.68 in chips)
Seat 6: 9e93707c ($6 in chips)
Hero: posts small blind $0.02
1cd48777: posts big blind $0.05
*** HOLE CARDS ***
Dealt to bede2c8c 
Dealt to Hero [Jd Kc]
Dealt to 1cd48777 
Dealt to 9e93707c 
9e93707c: folds
bede2c8c: raises $0.08 to $0.13
Hero: folds
1cd48777: calls $0.08
*** FLOP *** [Tc 5h Qd]
1cd48777: checks
bede2c8c: bets $0.09
1cd48777: calls $0.09
*** TURN *** [Tc 5h Qd] [9h]
1cd48777: checks
bede2c8c: bets $0.23
1cd48777: raises $0.23 to $0.46
bede2c8c: folds
Uncalled bet ($0.23) returned to 1cd48777
*** SHOWDOWN ***
1cd48777 collected $0.87 from pot
*** SUMMARY ***
Total pot $0.92 | Rake $0.05 | Jackpot $0 | Bingo $0 | Fortune $0
Board [Tc 5h Qd 9h]
Seat 2: bede2c8c (button) folded on the Turn
Seat 3: Hero (small blind) folded before Flop
Seat 4: 1cd48777 (big blind) won ($0.87)
Seat 6: 9e93707c folded before Flop (didn't bet)


Poker Hand #HD1212470570: Hold'em No Limit  ($0.02/$0.05) - 2023/04/21 22:04:34
Table 'NLHBlue37' 6-max Seat #6 is the button
Seat 2: bede2c8c ($5 in chips)
Seat 3: Hero ($5.97 in chips)
Seat 4: 1cd48777 ($6.71 in chips)
Seat 6: 9e93707c ($6 in chips)
bede2c8c: posts small blind $0.02
Hero: posts big blind $0.05
*** HOLE CARDS ***
Dealt to bede2c8c 
Dealt to Hero [6c Ad]
Dealt to 1cd48777 
Dealt to 9e93707c 
1cd48777: raises $0.1 to $0.15
9e93707c: folds
bede2c8c: raises $0.41 to $0.56
Hero: folds
1cd48777: calls $0.41
*** FLOP *** [9h Ks 3d]
bede2c8c: checks
1cd48777: bets $0.54
bede2c8c: calls $0.54
*** TURN *** [9h Ks 3d] [9d]
bede2c8c: checks
1cd48777: bets $1.08
bede2c8c: folds
Uncalled bet ($1.08) returned to 1cd48777
*** SHOWDOWN ***
1cd48777 collected $2.07 from pot
*** SUMMARY ***
Total pot $2.25 | Rake $0.13 | Jackpot $0.05 | Bingo $0 | Fortune $0
Board [9h Ks 3d 9d]
Seat 2: bede2c8c (small blind) folded on the Turn
Seat 3: Hero (big blind) folded before Flop
Seat 4: 1cd48777 won ($2.07)
Seat 6: 9e93707c (button) folded before Flop (didn't bet)


Poker Hand #HD1212470456: Hold'em No Limit  ($0.02/$0.05) - 2023/04/21 22:03:17
Table 'NLHBlue37' 6-max Seat #4 is the button
Seat 1: 2a2722f ($4.85 in chips)
Seat 2: bede2c8c ($5 in chips)
Seat 3: Hero ($5.97 in chips)
Seat 4: 1cd48777 ($6.56 in chips)
Seat 6: 9e93707c ($6.02 in chips)
9e93707c: posts small blind $0.02
2a2722f: posts big blind $0.05
*** HOLE CARDS ***
Dealt to 2a2722f 
Dealt to bede2c8c 
Dealt to Hero [8h Kh]
Dealt to 1cd48777 
Dealt to 9e93707c 
bede2c8c: folds
Hero: folds
1cd48777: raises $0.1 to $0.15
9e93707c: folds
2a2722f: calls $0.1
*** FLOP *** [3d Jh 9h]
2a2722f: checks
1cd48777: bets $0.16
2a2722f: folds
Uncalled bet ($0.16) returned to 1cd48777
*** SHOWDOWN ***
1cd48777 collected $0.3 from pot
*** SUMMARY ***
Total pot $0.32 | Rake $0.02 | Jackpot $0 | Bingo $0 | Fortune $0
Board [3d Jh 9h]
Seat 1: 2a2722f (big blind) folded on the Flop
Seat 2: bede2c8c folded before Flop (didn't bet)
Seat 3: Hero folded before Flop (didn't bet)
Seat 4: 1cd48777 (button) won ($0.3)
Seat 6: 9e93707c (small blind) folded before Flop


Poker Hand #HD1212470348: Hold'em No Limit  ($0.02/$0.05) - 2023/04/21 22:02:20
Table 'NLHBlue37' 6-max Seat #3 is the button
Seat 1: 2a2722f ($4.85 in chips)
Seat 2: bede2c8c ($5 in chips)
Seat 3: Hero ($5 in chips)
Seat 4: 1cd48777 ($6.58 in chips)
Seat 6: 9e93707c ($7.13 in chips)
1cd48777: posts small blind $0.02
9e93707c: posts big blind $0.05
*** HOLE CARDS ***
Dealt to 2a2722f 
Dealt to bede2c8c 
Dealt to Hero [7c 7h]
Dealt to 1cd48777 
Dealt to 9e93707c 
2a2722f: folds
bede2c8c: folds
Hero: raises $0.07 to $0.12
1cd48777: folds
9e93707c: calls $0.07
*** FLOP *** [Qc 6d 4d]
9e93707c: checks
Hero: bets $0.13
9e93707c: calls $0.13
*** TURN *** [Qc 6d 4d] [Kd]
9e93707c: checks
Hero: bets $0.26
9e93707c: calls $0.26
*** RIVER *** [Qc 6d 4d Kd] [7s]
9e93707c: checks
Hero: bets $0.6
9e93707c: calls $0.6
Hero: shows [7c 7h] (Three Sevens)
9e93707c: shows [Qd Ts] (Pair of Queens)
*** SHOWDOWN ***
Hero collected $2.08 from pot
*** SUMMARY ***
Total pot $2.24 | Rake $0.11 | Jackpot $0.05 | Bingo $0 | Fortune $0
Board [Qc 6d 4d Kd 7s]
Seat 1: 2a2722f folded before Flop (didn't bet)
Seat 2: bede2c8c folded before Flop (didn't bet)
Seat 3: Hero (button) showed [7c 7h] and won ($2.08) with Three Sevens
Seat 4: 1cd48777 (small blind) folded before Flop
Seat 6: 9e93707c (big blind) showed [Qd Ts] and lost with Pair of Queens


Poker Hand #HD1212470266: Hold'em No Limit  ($0.02/$0.05) - 2023/04/21 22:01:28
Table 'NLHBlue37' 6-max Seat #2 is the button
Seat 1: 2a2722f ($4.64 in chips)
Seat 2: bede2c8c ($5 in chips)
Seat 3: Hero ($5.02 in chips)
Seat 4: 1cd48777 ($6.79 in chips)
Seat 5: 4a6998dc ($5 in chips)
Seat 6: 9e93707c ($7.13 in chips)
Hero: posts small blind $0.02
1cd48777: posts big blind $0.05
*** HOLE CARDS ***
Dealt to 2a2722f 
Dealt to bede2c8c 
Dealt to Hero [2c 4h]
Dealt to 1cd48777 
Dealt to 4a6998dc 
Dealt to 9e93707c 
4a6998dc: folds
9e93707c: folds
2a2722f: raises $0.05 to $0.1
bede2c8c: folds
Hero: folds
1cd48777: calls $0.05
*** FLOP *** [5s As 8h]
1cd48777: checks
2a2722f: bets $0.11
1cd48777: calls $0.11
*** TURN *** [5s As 8h] [Td]
1cd48777: checks
2a2722f: checks
*** RIVER *** [5s As 8h Td] [Qh]
1cd48777: checks
2a2722f: checks
1cd48777: shows [3d Ks] (Ace-High)
2a2722f: shows [Qd 6d] (Pair of Queens)
*** SHOWDOWN ***
2a2722f collected $0.42 from pot
*** SUMMARY ***
Total pot $0.44 | Rake $0.02 | Jackpot $0 | Bingo $0 | Fortune $0
Board [5s As 8h Td Qh]
Seat 1: 2a2722f showed [Qd 6d] and won ($0.42) with Pair of Queens
Seat 2: bede2c8c (button) folded before Flop (didn't bet)
Seat 3: Hero (small blind) folded before Flop
Seat 4: 1cd48777 (big blind) showed [3d Ks] and lost with Ace-High
Seat 5: 4a6998dc folded before Flop (didn't bet)
Seat 6: 9e93707c folded before Flop (didn't bet)


Poker Hand #HD1212470236: Hold'em No Limit  ($0.02/$0.05) - 2023/04/21 22:01:11
Table 'NLHBlue37' 6-max Seat #1 is the button
Seat 1: 2a2722f ($4.57 in chips)
Seat 2: bede2c8c ($5 in chips)
Seat 3: Hero ($5.07 in chips)
Seat 4: 1cd48777 ($6.79 in chips)
Seat 5: 4a6998dc ($5 in chips)
Seat 6: 9e93707c ($7.13 in chips)
bede2c8c: posts small blind $0.02
Hero: posts big blind $0.05
*** HOLE CARDS ***
Dealt to 2a2722f 
Dealt to bede2c8c 
Dealt to Hero [5h 8s]
Dealt to 1cd48777 
Dealt to 4a6998dc 
Dealt to 9e93707c 
1cd48777: folds
4a6998dc: folds
9e93707c: folds
2a2722f: raises $0.05 to $0.1
bede2c8c: folds
Hero: folds
Uncalled bet ($0.05) returned to 2a2722f
*** SHOWDOWN ***
2a2722f collected $0.12 from pot
*** SUMMARY ***
Total pot $0.12 | Rake $0 | Jackpot $0 | Bingo $0 | Fortune $0
Seat 1: 2a2722f (button) collected ($0.12)
Seat 2: bede2c8c (small blind) folded before Flop
Seat 3: Hero (big blind) folded before Flop
Seat 4: 1cd48777 folded before Flop (didn't bet)
Seat 5: 4a6998dc folded before Flop (didn't bet)
Seat 6: 9e93707c folded before Flop (didn't bet)


Poker Hand #HD1212470171: Hold'em No Limit  ($0.02/$0.05) - 2023/04/21 22:00:30
Table 'NLHBlue37' 6-max Seat #6 is the button
Seat 1: 2a2722f ($4.4 in chips)
Seat 2: bede2c8c ($5 in chips)
Seat 3: Hero ($5.07 in chips)
Seat 4: 1cd48777 ($6.79 in chips)
Seat 5: 4a6998dc ($5 in chips)
Seat 6: 9e93707c ($7.26 in chips)
2a2722f: posts small blind $0.02
bede2c8c: posts big blind $0.05
*** HOLE CARDS ***
Dealt to 2a2722f 
Dealt to bede2c8c 
Dealt to Hero [2c 2d]
Dealt to 1cd48777 
Dealt to 4a6998dc 
Dealt to 9e93707c 
Hero: folds
1cd48777: folds
4a6998dc: folds
9e93707c: raises $0.08 to $0.13
2a2722f: calls $0.11
bede2c8c: folds
*** FLOP *** [4c 3c Ks]
2a2722f: checks
9e93707c: checks
*** TURN *** [4c 3c Ks] [6s]
2a2722f: bets $0.24
9e93707c: folds
Uncalled bet ($0.24) returned to 2a2722f
*** SHOWDOWN ***
2a2722f collected $0.3 from pot
*** SUMMARY ***
Total pot $0.31 | Rake $0.01 | Jackpot $0 | Bingo $0 | Fortune $0
Board [4c 3c Ks 6s]
Seat 1: 2a2722f (small blind) won ($0.3)
Seat 2: bede2c8c (big blind) folded before Flop
Seat 3: Hero folded before Flop (didn't bet)
Seat 4: 1cd48777 folded before Flop (didn't bet)
Seat 5: 4a6998dc folded before Flop (didn't bet)
Seat 6: 9e93707c (button) folded on the Turn


Poker Hand #HD1212470136: Hold'em No Limit  ($0.02/$0.05) - 2023/04/21 22:00:13
Table 'NLHBlue37' 6-max Seat #5 is the button
Seat 1: 2a2722f ($4.45 in chips)
Seat 3: Hero ($5 in chips)
Seat 4: 1cd48777 ($6.79 in chips)
Seat 5: 4a6998dc ($5 in chips)
Seat 6: 9e93707c ($7.28 in chips)
9e93707c: posts small blind $0.02
2a2722f: posts big blind $0.05
*** HOLE CARDS ***
Dealt to 2a2722f 
Dealt to Hero [3s As]
Dealt to 1cd48777 
Dealt to 4a6998dc 
Dealt to 9e93707c 
Hero: raises $0.07 to $0.12
1cd48777: folds
4a6998dc: folds
9e93707c: folds
2a2722f: folds
Uncalled bet ($0.07) returned to Hero
*** SHOWDOWN ***
Hero collected $0.12 from pot
*** SUMMARY ***
Total pot $0.12 | Rake $0 | Jackpot $0 | Bingo $0 | Fortune $0
Seat 1: 2a2722f (big blind) folded before Flop
Seat 3: Hero collected ($0.12)
Seat 4: 1cd48777 folded before Flop (didn't bet)
Seat 5: 4a6998dc (button) folded before Flop (didn't bet)
Seat 6: 9e93707c (small blind) folded before Flop


Poker Hand #HD1212470029: Hold'em No Limit  ($0.02/$0.05) - 2023/04/21 21:59:13
Table 'NLHBlue37' 6-max Seat #4 is the button
Seat 1: 2a2722f ($4.94 in chips)
Seat 3: Hero ($5 in chips)
Seat 4: 1cd48777 ($6.29 in chips)
Seat 5: 4a6998dc ($5 in chips)
Seat 6: 9e93707c ($7.33 in chips)
4a6998dc: posts small blind $0.02
9e93707c: posts big blind $0.05
*** HOLE CARDS ***
Dealt to 2a2722f 
Dealt to Hero [8s 3h]
Dealt to 1cd48777 
Dealt to 4a6998dc 
Dealt to 9e93707c 
2a2722f: raises $0.15 to $0.2
Hero: folds
1cd48777: raises $0.29 to $0.49
4a6998dc: folds
9e93707c: folds
2a2722f: calls $0.29
*** FLOP *** [5h 4s 4d]
2a2722f: checks
1cd48777: bets $0.63
2a2722f: folds
Uncalled bet ($0.63) returned to 1cd48777
*** SHOWDOWN ***
1cd48777 collected $0.99 from pot
*** SUMMARY ***
Total pot $1.05 | Rake $0.06 | Jackpot $0 | Bingo $0 | Fortune $0
Board [5h 4s 4d]
Seat 1: 2a2722f folded on the Flop
Seat 3: Hero folded before Flop (didn't bet)
Seat 4: 1cd48777 (button) won ($0.99)
Seat 5: 4a6998dc (small blind) folded before Flop
Seat 6: 9e93707c (big blind) folded before Flop


Poker Hand #HD1212469952: Hold'em No Limit  ($0.02/$0.05) - 2023/04/21 21:58:24
Table 'NLHBlue37' 6-max Seat #3 is the button
Seat 1: 2a2722f ($5.42 in chips)
Seat 3: Hero ($5 in chips)
Seat 4: 1cd48777 ($6.31 in chips)
Seat 5: 4a6998dc ($5 in chips)
Seat 6: 9e93707c ($6.83 in chips)
1cd48777: posts small blind $0.02
4a6998dc: posts big blind $0.05
*** HOLE CARDS ***
Dealt to 2a2722f 
Dealt to Hero [Ad 9c]
Dealt to 1cd48777 
Dealt to 4a6998dc 
Dealt to 9e93707c 
9e93707c: raises $0.08 to $0.13
2a2722f: calls $0.13
Hero: folds
1cd48777: folds
4a6998dc: folds
*** FLOP *** [7s Td Th]
9e93707c: bets $0.1
2a2722f: calls $0.1
*** TURN *** [7s Td Th] [8h]
9e93707c: bets $0.25
2a2722f: calls $0.25
*** RIVER *** [7s Td Th 8h] [Jd]
9e93707c: bets $0.78
2a2722f: folds
Uncalled bet ($0.78) returned to 9e93707c
*** SHOWDOWN ***
9e93707c collected $0.98 from pot
*** SUMMARY ***
Total pot $1.03 | Rake $0.05 | Jackpot $0 | Bingo $0 | Fortune $0
Board [7s Td Th 8h Jd]
Seat 1: 2a2722f folded on the River
Seat 3: Hero (button) folded before Flop (didn't bet)
Seat 4: 1cd48777 (small blind) folded before Flop
Seat 5: 4a6998dc (big blind) folded before Flop
Seat 6: 9e93707c won ($0.98)


Poker Hand #HD1212469871: Hold'em No Limit  ($0.02/$0.05) - 2023/04/21 21:57:42
Table 'NLHBlue37' 6-max Seat #1 is the button
Seat 1: 2a2722f ($5.42 in chips)
Seat 3: Hero ($5.19 in chips)
Seat 4: 1cd48777 ($6.02 in chips)
Seat 5: 4a6998dc ($5 in chips)
Seat 6: 9e93707c ($6.83 in chips)
Hero: posts small blind $0.02
1cd48777: posts big blind $0.05
*** HOLE CARDS ***
Dealt to 2a2722f 
Dealt to Hero [3d 3s]
Dealt to 1cd48777 
Dealt to 4a6998dc 
Dealt to 9e93707c 
4a6998dc: folds
9e93707c: folds
2a2722f: folds
Hero: raises $0.09 to $0.14
1cd48777: raises $0.19 to $0.33
Hero: calls $0.19
*** FLOP *** [4s Kd Jc]
Hero: checks
1cd48777: bets $0.38
Hero: folds
Uncalled bet ($0.38) returned to 1cd48777
*** SHOWDOWN ***
1cd48777 collected $0.62 from pot
*** SUMMARY ***
Total pot $0.66 | Rake $0.04 | Jackpot $0 | Bingo $0 | Fortune $0
Board [4s Kd Jc]
Seat 1: 2a2722f (button) folded before Flop (didn't bet)
Seat 3: Hero (small blind) folded on the Flop
Seat 4: 1cd48777 (big blind) won ($0.62)
Seat 5: 4a6998dc folded before Flop (didn't bet)
Seat 6: 9e93707c folded before Flop (didn't bet)


Poker Hand #HD1212469687: Hold'em No Limit  ($0.02/$0.05) - 2023/04/21 21:55:53
Table 'NLHBlue37' 6-max Seat #6 is the button
Seat 1: 2a2722f ($2.65 in chips)
Seat 2: 36dc06ae ($5.48 in chips)
Seat 3: Hero ($5.19 in chips)
Seat 4: 1cd48777 ($6.02 in chips)
Seat 5: 4a6998dc ($5 in chips)
Seat 6: 9e93707c ($6.83 in chips)
2a2722f: posts small blind $0.02
36dc06ae: posts big blind $0.05
*** HOLE CARDS ***
Dealt to 2a2722f 
Dealt to 36dc06ae 
Dealt to Hero [Jh Ts]
Dealt to 1cd48777 
Dealt to 4a6998dc 
Dealt to 9e93707c 
Hero: folds
1cd48777: folds
4a6998dc: raises $0.1 to $0.15
9e93707c: folds
2a2722f: calls $0.13
36dc06ae: calls $0.1
*** FLOP *** [3s 4c 9h]
2a2722f: checks
36dc06ae: checks
4a6998dc: bets $0.3
2a2722f: calls $0.3
36dc06ae: calls $0.3
*** TURN *** [3s 4c 9h] [Td]
2a2722f: checks
36dc06ae: checks
4a6998dc: bets $0.73
2a2722f: calls $0.73
36dc06ae: folds
*** RIVER *** [3s 4c 9h Td] [Ks]
2a2722f: bets $1.47 and is all-in
4a6998dc: calls $1.47
2a2722f: shows [4d Kh] (Pair of Kings and Pair of Fours)
4a6998dc: shows [Ah Ac] (Pair of Aces)
*** SHOWDOWN ***
2a2722f collected $5.42 from pot
*** SUMMARY ***
Total pot $5.75 | Rake $0.28 | Jackpot $0.05 | Bingo $0 | Fortune $0
Board [3s 4c 9h Td Ks]
Seat 1: 2a2722f (small blind) showed [4d Kh] and won ($5.42) with Pair of Kings and Pair of Fours
Seat 2: 36dc06ae (big blind) folded on the Turn
Seat 3: Hero folded before Flop (didn't bet)
Seat 4: 1cd48777 folded before Flop (didn't bet)
Seat 5: 4a6998dc showed [Ah Ac] and lost with Pair of Aces
Seat 6: 9e93707c (button) folded before Flop (didn't bet)


Poker Hand #HD1212469555: Hold'em No Limit  ($0.02/$0.05) - 2023/04/21 21:54:41
Table 'NLHBlue37' 6-max Seat #5 is the button
Seat 1: 2a2722f ($2.7 in chips)
Seat 2: 36dc06ae ($5.48 in chips)
Seat 3: Hero ($6.63 in chips)
Seat 4: 1cd48777 ($4.73 in chips)
Seat 5: 4a6998dc ($5 in chips)
Seat 6: 9e93707c ($6.85 in chips)
9e93707c: posts small blind $0.02
2a2722f: posts big blind $0.05
*** HOLE CARDS ***
Dealt to 2a2722f 
Dealt to 36dc06ae 
Dealt to Hero [9d 9h]
Dealt to 1cd48777 
Dealt to 4a6998dc 
Dealt to 9e93707c 
36dc06ae: folds
Hero: raises $0.07 to $0.12
1cd48777: raises $0.21 to $0.33
4a6998dc: folds
9e93707c: folds
2a2722f: folds
Hero: calls $0.21
*** FLOP *** [Kd 4s 5s]
Hero: checks
1cd48777: bets $0.37
Hero: calls $0.37
*** TURN *** [Kd 4s 5s] [8s]
Hero: checks
1cd48777: bets $0.74
Hero: calls $0.74
*** RIVER *** [Kd 4s 5s 8s] [3c]
Hero: checks
1cd48777: checks
Hero: shows [9d 9h] (Pair of Nines)
1cd48777: shows [Kc Ad] (Pair of Kings)
*** SHOWDOWN ***
1cd48777 collected $2.73 from pot
*** SUMMARY ***
Total pot $2.95 | Rake $0.17 | Jackpot $0.05 | Bingo $0 | Fortune $0
Board [Kd 4s 5s 8s 3c]
Seat 1: 2a2722f (big blind) folded before Flop
Seat 2: 36dc06ae folded before Flop (didn't bet)
Seat 3: Hero showed [9d 9h] and lost with Pair of Nines
Seat 4: 1cd48777 showed [Kc Ad] and won ($2.73) with Pair of Kings
Seat 5: 4a6998dc (button) folded before Flop (didn't bet)
Seat 6: 9e93707c (small blind) folded before Flop


Poker Hand #HD1212469454: Hold'em No Limit  ($0.02/$0.05) - 2023/04/21 21:53:43
Table 'NLHBlue37' 6-max Seat #4 is the button
Seat 1: 2a2722f ($2.7 in chips)
Seat 2: 36dc06ae ($5.48 in chips)
Seat 3: Hero ($6.36 in chips)
Seat 4: 1cd48777 ($4.95 in chips)
Seat 5: 4a6998dc ($5 in chips)
Seat 6: 9e93707c ($6.9 in chips)
4a6998dc: posts small blind $0.02
9e93707c: posts big blind $0.05
*** HOLE CARDS ***
Dealt to 2a2722f 
Dealt to 36dc06ae 
Dealt to Hero [8s 9s]
Dealt to 1cd48777 
Dealt to 4a6998dc 
Dealt to 9e93707c 
2a2722f: folds
36dc06ae: folds
Hero: raises $0.07 to $0.12
1cd48777: calls $0.12
4a6998dc: folds
9e93707c: folds
*** FLOP *** [8d Qd Ad]
Hero: bets $0.1
1cd48777: calls $0.1
*** TURN *** [8d Qd Ad] [7d]
Hero: checks
1cd48777: checks
*** RIVER *** [8d Qd Ad 7d] [9c]
Hero: bets $0.19
1cd48777: folds
Uncalled bet ($0.19) returned to Hero
*** SHOWDOWN ***
Hero collected $0.49 from pot
*** SUMMARY ***
Total pot $0.51 | Rake $0.02 | Jackpot $0 | Bingo $0 | Fortune $0
Board [8d Qd Ad 7d 9c]
Seat 1: 2a2722f folded before Flop (didn't bet)
Seat 2: 36dc06ae folded before Flop (didn't bet)
Seat 3: Hero won ($0.49)
Seat 4: 1cd48777 (button) folded on the River
Seat 5: 4a6998dc (small blind) folded before Flop
Seat 6: 9e93707c (big blind) folded before Flop


Poker Hand #HD1212469316: Hold'em No Limit  ($0.02/$0.05) - 2023/04/21 21:52:24
Table 'NLHBlue37' 6-max Seat #3 is the button
Seat 1: 2a2722f ($2.16 in chips)
Seat 2: 36dc06ae ($5.76 in chips)
Seat 3: Hero ($6.36 in chips)
Seat 4: 1cd48777 ($4.97 in chips)
Seat 5: 4a6998dc ($5 in chips)
Seat 6: 9e93707c ($6.9 in chips)
1cd48777: posts small blind $0.02
4a6998dc: posts big blind $0.05
*** HOLE CARDS ***
Dealt to 2a2722f 
Dealt to 36dc06ae 
Dealt to Hero [Kc 9c]
Dealt to 1cd48777 
Dealt to 4a6998dc 
Dealt to 9e93707c 
9e93707c: folds
2a2722f: raises $0.05 to $0.1
36dc06ae: calls $0.1
Hero: folds
1cd48777: folds
4a6998dc: calls $0.05
*** FLOP *** [4h 7d 9d]
4a6998dc: checks
2a2722f: checks
36dc06ae: checks
*** TURN *** [4h 7d 9d] [9h]
4a6998dc: bets $0.18
2a2722f: calls $0.18
36dc06ae: calls $0.18
*** RIVER *** [4h 7d 9d 9h] [5c]
4a6998dc: checks
2a2722f: bets $0.29
36dc06ae: folds
4a6998dc: folds
Uncalled bet ($0.29) returned to 2a2722f
*** SHOWDOWN ***
2a2722f collected $0.82 from pot
*** SUMMARY ***
Total pot $0.86 | Rake $0.04 | Jackpot $0 | Bingo $0 | Fortune $0
Board [4h 7d 9d 9h 5c]
Seat 1: 2a2722f won ($0.82)
Seat 2: 36dc06ae folded on the River
Seat 3: Hero (button) folded before Flop (didn't bet)
Seat 4: 1cd48777 (small blind) folded before Flop
Seat 5: 4a6998dc (big blind) folded on the River
Seat 6: 9e93707c folded before Flop (didn't bet)


Poker Hand #HD1212469208: Hold'em No Limit  ($0.02/$0.05) - 2023/04/21 21:51:20
Table 'NLHBlue37' 6-max Seat #2 is the button
Seat 1: 2a2722f ($2.42 in chips)
Seat 2: 36dc06ae ($5.86 in chips)
Seat 3: Hero ($6.38 in chips)
Seat 4: 1cd48777 ($4.62 in chips)
Seat 5: 4a6998dc ($5 in chips)
Seat 6: 9e93707c ($6.9 in chips)
Hero: posts small blind $0.02
1cd48777: posts big blind $0.05
*** HOLE CARDS ***
Dealt to 2a2722f 
Dealt to 36dc06ae 
Dealt to Hero [9c Kh]
Dealt to 1cd48777 
Dealt to 4a6998dc 
Dealt to 9e93707c 
4a6998dc: folds
9e93707c: folds
2a2722f: raises $0.05 to $0.1
36dc06ae: calls $0.1
Hero: folds
1cd48777: calls $0.05
*** FLOP *** [Ac 7h 3h]
1cd48777: checks
2a2722f: checks
36dc06ae: checks
*** TURN *** [Ac 7h 3h] [Th]
1cd48777: bets $0.16
2a2722f: calls $0.16
36dc06ae: folds
*** RIVER *** [Ac 7h 3h Th] [9s]
1cd48777: bets $0.32
2a2722f: folds
Uncalled bet ($0.32) returned to 1cd48777
*** SHOWDOWN ***
1cd48777 collected $0.61 from pot
*** SUMMARY ***
Total pot $0.64 | Rake $0.03 | Jackpot $0 | Bingo $0 | Fortune $0
Board [Ac 7h 3h Th 9s]
Seat 1: 2a2722f folded on the River
Seat 2: 36dc06ae (button) folded on the Turn
Seat 3: Hero (small blind) folded before Flop
Seat 4: 1cd48777 (big blind) won ($0.61)
Seat 5: 4a6998dc folded before Flop (didn't bet)
Seat 6: 9e93707c folded before Flop (didn't bet)


Poker Hand #HD1212469106: Hold'em No Limit  ($0.02/$0.05) - 2023/04/21 21:50:27
Table 'NLHBlue37' 6-max Seat #1 is the button
Seat 1: 2a2722f ($2.55 in chips)
Seat 2: 36dc06ae ($5.88 in chips)
Seat 3: Hero ($6.43 in chips)
Seat 4: 1cd48777 ($4.62 in chips)
Seat 5: 4a6998dc ($5 in chips)
Seat 6: 9e93707c ($6.71 in chips)
36dc06ae: posts small blind $0.02
Hero: posts big blind $0.05
*** HOLE CARDS ***
Dealt to 2a2722f 
Dealt to 36dc06ae 
Dealt to Hero [8d 3c]
Dealt to 1cd48777 
Dealt to 4a6998dc 
Dealt to 9e93707c 
1cd48777: folds
4a6998dc: folds
9e93707c: raises $0.08 to $0.13
2a2722f: calls $0.13
36dc06ae: folds
Hero: folds
*** FLOP *** [4c Ad 9c]
9e93707c: checks
2a2722f: checks
*** TURN *** [4c Ad 9c] [2s]
9e93707c: checks
2a2722f: checks
*** RIVER *** [4c Ad 9c 2s] [9d]
9e93707c: checks
2a2722f: checks
9e93707c: shows [Js Qc] (Pair of Nines)
2a2722f: shows [7h 5h] (Pair of Nines)
*** SHOWDOWN ***
9e93707c collected $0.32 from pot
*** SUMMARY ***
Total pot $0.33 | Rake $0.01 | Jackpot $0 | Bingo $0 | Fortune $0
Board [4c Ad 9c 2s 9d]
Seat 1: 2a2722f (button) showed [7h 5h] and lost with Pair of Nines
Seat 2: 36dc06ae (small blind) folded before Flop
Seat 3: Hero (big blind) folded before Flop
Seat 4: 1cd48777 folded before Flop (didn't bet)
Seat 5: 4a6998dc folded before Flop (didn't bet)
Seat 6: 9e93707c showed [Js Qc] and won ($0.32) with Pair of Nines


Poker Hand #HD1212468961: Hold'em No Limit  ($0.02/$0.05) - 2023/04/21 21:49:07
Table 'NLHBlue37' 6-max Seat #6 is the button
Seat 1: 2a2722f ($2.68 in chips)
Seat 2: 36dc06ae ($5.05 in chips)
Seat 3: Hero ($6.43 in chips)
Seat 4: 1cd48777 ($4.62 in chips)
Seat 5: 4a6998dc ($5 in chips)
Seat 6: 9e93707c ($6.71 in chips)
2a2722f: posts small blind $0.02
36dc06ae: posts big blind $0.05
*** HOLE CARDS ***
Dealt to 2a2722f 
Dealt to 36dc06ae 
Dealt to Hero [7s Qs]
Dealt to 1cd48777 
Dealt to 4a6998dc 
Dealt to 9e93707c 
Hero: folds
1cd48777: folds
4a6998dc: raises $0.08 to $0.13
9e93707c: folds
2a2722f: calls $0.11
36dc06ae: calls $0.08
*** FLOP *** [Ad 7h 6h]
2a2722f: checks
36dc06ae: checks
4a6998dc: bets $0.2
2a2722f: folds
36dc06ae: calls $0.2
*** TURN *** [Ad 7h 6h] [4c]
36dc06ae: checks
4a6998dc: checks
*** RIVER *** [Ad 7h 6h 4c] [8s]
36dc06ae: checks
4a6998dc: bets $0.5
36dc06ae: calls $0.5
4a6998dc: shows [9c As] (Pair of Aces)
36dc06ae: shows [Tc Ac] (Pair of Aces)
*** SHOWDOWN ***
36dc06ae collected $1.66 from pot
*** SUMMARY ***
Total pot $1.79 | Rake $0.08 | Jackpot $0.05 | Bingo $0 | Fortune $0
Board [Ad 7h 6h 4c 8s]
Seat 1: 2a2722f (small blind) folded on the Flop
Seat 2: 36dc06ae (big blind) showed [Tc Ac] and won ($1.66) with Pair of Aces
Seat 3: Hero folded before Flop (didn't bet)
Seat 4: 1cd48777 folded before Flop (didn't bet)
Seat 5: 4a6998dc showed [9c As] and lost with Pair of Aces
Seat 6: 9e93707c (button) folded before Flop (didn't bet)


Poker Hand #HD1212468719: Hold'em No Limit  ($0.02/$0.05) - 2023/04/21 21:47:04
Table 'NLHBlue37' 6-max Seat #5 is the button
Seat 1: 2a2722f ($1.94 in chips)
Seat 2: 36dc06ae ($5.05 in chips)
Seat 3: Hero ($6.43 in chips)
Seat 4: 1cd48777 ($5.02 in chips)
Seat 5: 4a6998dc ($5 in chips)
Seat 6: 9e93707c ($7.11 in chips)
9e93707c: posts small blind $0.02
2a2722f: posts big blind $0.05
*** HOLE CARDS ***
Dealt to 2a2722f 
Dealt to 36dc06ae 
Dealt to Hero [7s Qs]
Dealt to 1cd48777 
Dealt to 4a6998dc 
Dealt to 9e93707c 
36dc06ae: folds
Hero: folds
1cd48777: raises $0.05 to $0.1
4a6998dc: folds
9e93707c: calls $0.08
2a2722f: calls $0.05
*** FLOP *** [9h 6d 7h]
9e93707c: checks
2a2722f: bets $0.1
1cd48777: calls $0.1
9e93707c: calls $0.1
*** TURN *** [9h 6d 7h] [7d]
9e93707c: checks
2a2722f: bets $0.2
1cd48777: calls $0.2
9e93707c: calls $0.2
*** RIVER *** [9h 6d 7h 7d] [2c]
9e93707c: checks
2a2722f: bets $0.9
1cd48777: folds
9e93707c: folds
Uncalled bet ($0.9) returned to 2a2722f
*** SHOWDOWN ***
2a2722f collected $1.14 from pot
*** SUMMARY ***
Total pot $1.2 | Rake $0.06 | Jackpot $0 | Bingo $0 | Fortune $0
Board [9h 6d 7h 7d 2c]
Seat 1: 2a2722f (big blind) won ($1.14)
Seat 2: 36dc06ae folded before Flop (didn't bet)
Seat 3: Hero folded before Flop (didn't bet)
Seat 4: 1cd48777 folded on the River
Seat 5: 4a6998dc (button) folded before Flop (didn't bet)
Seat 6: 9e93707c (small blind) folded on the River


Poker Hand #HD1212468547: Hold'em No Limit  ($0.02/$0.05) - 2023/04/21 21:45:32
Table 'NLHBlue37' 6-max Seat #4 is the button
Seat 1: 2a2722f ($1.01 in chips)
Seat 2: 36dc06ae ($6.06 in chips)
Seat 3: Hero ($6.43 in chips)
Seat 4: 1cd48777 ($5.02 in chips)
Seat 5: 4a6998dc ($5 in chips)
Seat 6: 9e93707c ($7.16 in chips)
4a6998dc: posts small blind $0.02
9e93707c: posts big blind $0.05
*** HOLE CARDS ***
Dealt to 2a2722f 
Dealt to 36dc06ae 
Dealt to Hero [5c Kd]
Dealt to 1cd48777 
Dealt to 4a6998dc 
Dealt to 9e93707c 
2a2722f: raises $0.05 to $0.1
36dc06ae: raises $0.2 to $0.3
Hero: folds
1cd48777: folds
4a6998dc: folds
9e93707c: folds
2a2722f: calls $0.2
*** FLOP *** [4d 4s 7d]
2a2722f: bets $0.23
36dc06ae: raises $0.57 to $0.8
2a2722f: calls $0.48 and is all-in
Uncalled bet ($0.09) returned to 36dc06ae
36dc06ae: shows [Ad Kh] (Pair of Fours)
2a2722f: shows [Qd Jh] (Pair of Fours)
*** TURN *** [4d 4s 7d] [3c]
*** RIVER *** [4d 4s 7d 3c] [Qc]
*** SHOWDOWN ***
2a2722f collected $1.94 from pot
*** SUMMARY ***
Total pot $2.09 | Rake $0.1 | Jackpot $0.05 | Bingo $0 | Fortune $0
Board [4d 4s 7d 3c Qc]
Seat 1: 2a2722f showed [Qd Jh] and won ($1.94) with Pair of Queens and Pair of Fours
Seat 2: 36dc06ae showed [Ad Kh] and lost with Pair of Fours
Seat 3: Hero folded before Flop (didn't bet)
Seat 4: 1cd48777 (button) folded before Flop (didn't bet)
Seat 5: 4a6998dc (small blind) folded before Flop
Seat 6: 9e93707c (big blind) folded before Flop


Poker Hand #HD1212468444: Hold'em No Limit  ($0.02/$0.05) - 2023/04/21 21:44:36
Table 'NLHBlue37' 6-max Seat #3 is the button
Seat 1: 2a2722f ($1.01 in chips)
Seat 2: 36dc06ae ($5.83 in chips)
Seat 3: Hero ($6.43 in chips)
Seat 4: 1cd48777 ($5.14 in chips)
Seat 5: 4a6998dc ($5 in chips)
Seat 6: 9e93707c ($7.16 in chips)
1cd48777: posts small blind $0.02
4a6998dc: posts big blind $0.05
*** HOLE CARDS ***
Dealt to 2a2722f 
Dealt to 36dc06ae 
Dealt to Hero [As 2s]
Dealt to 1cd48777 
Dealt to 4a6998dc 
Dealt to 9e93707c 
9e93707c: folds
2a2722f: folds
36dc06ae: raises $0.07 to $0.12
Hero: folds
1cd48777: calls $0.1
4a6998dc: calls $0.07
*** FLOP *** [3c 7h Ad]
1cd48777: checks
4a6998dc: checks
36dc06ae: bets $0.18
1cd48777: folds
4a6998dc: folds
Uncalled bet ($0.18) returned to 36dc06ae
*** SHOWDOWN ***
36dc06ae collected $0.35 from pot
*** SUMMARY ***
Total pot $0.36 | Rake $0.01 | Jackpot $0 | Bingo $0 | Fortune $0
Board [3c 7h Ad]
Seat 1: 2a2722f folded before Flop (didn't bet)
Seat 2: 36dc06ae won ($0.35)
Seat 3: Hero (button) folded before Flop (didn't bet)
Seat 4: 1cd48777 (small blind) folded on the Flop
Seat 5: 4a6998dc (big blind) folded on the Flop
Seat 6: 9e93707c folded before Flop (didn't bet)


Poker Hand #HD1212468374: Hold'em No Limit  ($0.02/$0.05) - 2023/04/21 21:44:00
Table 'NLHBlue37' 6-max Seat #2 is the button
Seat 1: 2a2722f ($1.01 in chips)
Seat 2: 36dc06ae ($5.83 in chips)
Seat 3: Hero ($6.45 in chips)
Seat 4: 1cd48777 ($5 in chips)
Seat 5: 4a6998dc ($5 in chips)
Seat 6: 9e93707c ($7.29 in chips)
Hero: posts small blind $0.02
1cd48777: posts big blind $0.05
*** HOLE CARDS ***
Dealt to 2a2722f 
Dealt to 36dc06ae 
Dealt to Hero [9s Js]
Dealt to 1cd48777 
Dealt to 4a6998dc 
Dealt to 9e93707c 
4a6998dc: folds
9e93707c: raises $0.08 to $0.13
2a2722f: folds
36dc06ae: folds
Hero: folds
1cd48777: raises $0.33 to $0.46
9e93707c: folds
Uncalled bet ($0.33) returned to 1cd48777
*** SHOWDOWN ***
1cd48777 collected $0.27 from pot
*** SUMMARY ***
Total pot $0.28 | Rake $0.01 | Jackpot $0 | Bingo $0 | Fortune $0
Seat 1: 2a2722f folded before Flop (didn't bet)
Seat 2: 36dc06ae (button) folded before Flop (didn't bet)
Seat 3: Hero (small blind) folded before Flop
Seat 4: 1cd48777 (big blind) collected ($0.27)
Seat 5: 4a6998dc folded before Flop (didn't bet)
Seat 6: 9e93707c folded before Flop


Poker Hand #HD1212468320: Hold'em No Limit  ($0.02/$0.05) - 2023/04/21 21:43:34
Table 'NLHBlue37' 6-max Seat #1 is the button
Seat 1: 2a2722f ($0.94 in chips)
Seat 2: 36dc06ae ($5.85 in chips)
Seat 3: Hero ($6.5 in chips)
Seat 5: 4a6998dc ($5 in chips)
Seat 6: 9e93707c ($7.29 in chips)
36dc06ae: posts small blind $0.02
Hero: posts big blind $0.05
*** HOLE CARDS ***
Dealt to 2a2722f 
Dealt to 36dc06ae 
Dealt to Hero [9c 4s]
Dealt to 4a6998dc 
Dealt to 9e93707c 
4a6998dc: folds
9e93707c: folds
2a2722f: raises $0.05 to $0.1
36dc06ae: folds
Hero: folds
Uncalled bet ($0.05) returned to 2a2722f
*** SHOWDOWN ***
2a2722f collected $0.12 from pot
*** SUMMARY ***
Total pot $0.12 | Rake $0 | Jackpot $0 | Bingo $0 | Fortune $0
Seat 1: 2a2722f (button) collected ($0.12)
Seat 2: 36dc06ae (small blind) folded before Flop
Seat 3: Hero (big blind) folded before Flop
Seat 5: 4a6998dc folded before Flop (didn't bet)
Seat 6: 9e93707c folded before Flop (didn't bet)


Poker Hand #HD1212468157: Hold'em No Limit  ($0.02/$0.05) - 2023/04/21 21:42:09
Table 'NLHBlue37' 6-max Seat #6 is the button
Seat 1: 2a2722f ($1.2 in chips)
Seat 2: 36dc06ae ($5.06 in chips)
Seat 3: Hero ($6.5 in chips)
Seat 5: 4a6998dc ($5 in chips)
Seat 6: 9e93707c ($7.94 in chips)
2a2722f: posts small blind $0.02
36dc06ae: posts big blind $0.05
*** HOLE CARDS ***
Dealt to 2a2722f 
Dealt to 36dc06ae 
Dealt to Hero [5s Jd]
Dealt to 4a6998dc 
Dealt to 9e93707c 
Hero: folds
4a6998dc: folds
9e93707c: raises $0.08 to $0.13
2a2722f: calls $0.11
36dc06ae: calls $0.08
*** FLOP *** [Qc 2c 5d]
2a2722f: bets $0.13
36dc06ae: calls $0.13
9e93707c: calls $0.13
*** TURN *** [Qc 2c 5d] [5c]
2a2722f: checks
36dc06ae: checks
9e93707c: checks
*** RIVER *** [Qc 2c 5d 5c] [4d]
2a2722f: checks
36dc06ae: checks
9e93707c: bets $0.39
2a2722f: folds
36dc06ae: calls $0.39
9e93707c: shows [Qd 7d] (Pair of Queens and Pair of Fives)
36dc06ae: shows [Js Qh] (Pair of Queens and Pair of Fives)
*** SHOWDOWN ***
36dc06ae collected $1.44 from pot
*** SUMMARY ***
Total pot $1.56 | Rake $0.07 | Jackpot $0.05 | Bingo $0 | Fortune $0
Board [Qc 2c 5d 5c 4d]
Seat 1: 2a2722f (small blind) folded on the River
Seat 2: 36dc06ae (big blind) showed [Js Qh] and won ($1.44) with Pair of Queens and Pair of Fives
Seat 3: Hero folded before Flop (didn't bet)
Seat 5: 4a6998dc folded before Flop (didn't bet)
Seat 6: 9e93707c (button) showed [Qd 7d] and lost with Pair of Queens and Pair of Fives


Poker Hand #HD1212468097: Hold'em No Limit  ($0.02/$0.05) - 2023/04/21 21:41:36
Table 'NLHBlue37' 6-max Seat #5 is the button
Seat 1: 2a2722f ($1.32 in chips)
Seat 2: 36dc06ae ($5.06 in chips)
Seat 3: Hero ($6.37 in chips)
Seat 5: 4a6998dc ($5 in chips)
Seat 6: 9e93707c ($7.96 in chips)
9e93707c: posts small blind $0.02
2a2722f: posts big blind $0.05
*** HOLE CARDS ***
Dealt to 2a2722f 
Dealt to 36dc06ae 
Dealt to Hero [2d 2c]
Dealt to 4a6998dc 
Dealt to 9e93707c 
36dc06ae: folds
Hero: raises $0.07 to $0.12
4a6998dc: folds
9e93707c: folds
2a2722f: calls $0.07
*** FLOP *** [Jd 8h Jc]
2a2722f: checks
Hero: bets $0.1
2a2722f: folds
Uncalled bet ($0.1) returned to Hero
*** SHOWDOWN ***
Hero collected $0.25 from pot
*** SUMMARY ***
Total pot $0.26 | Rake $0.01 | Jackpot $0 | Bingo $0 | Fortune $0
Board [Jd 8h Jc]
Seat 1: 2a2722f (big blind) folded on the Flop
Seat 2: 36dc06ae folded before Flop (didn't bet)
Seat 3: Hero won ($0.25)
Seat 5: 4a6998dc (button) folded before Flop (didn't bet)
Seat 6: 9e93707c (small blind) folded before Flop


Poker Hand #HD1212467969: Hold'em No Limit  ($0.02/$0.05) - 2023/04/21 21:40:35
Table 'NLHBlue37' 6-max Seat #3 is the button
Seat 1: 770444cd ($6.03 in chips)
Seat 2: 36dc06ae ($4.71 in chips)
Seat 3: Hero ($6.37 in chips)
Seat 5: 4a6998dc ($5 in chips)
Seat 6: 9e93707c ($8.32 in chips)
4a6998dc: posts small blind $0.02
9e93707c: posts big blind $0.05
*** HOLE CARDS ***
Dealt to 770444cd 
Dealt to 36dc06ae 
Dealt to Hero [8s 5c]
Dealt to 4a6998dc 
Dealt to 9e93707c 
770444cd: folds
36dc06ae: raises $0.07 to $0.12
Hero: folds
4a6998dc: folds
9e93707c: calls $0.07
*** FLOP *** [8d 8c 9h]
9e93707c: checks
36dc06ae: bets $0.09
9e93707c: calls $0.09
*** TURN *** [8d 8c 9h] [4c]
9e93707c: checks
36dc06ae: checks
*** RIVER *** [8d 8c 9h 4c] [2s]
9e93707c: checks
36dc06ae: bets $0.15
9e93707c: calls $0.15
36dc06ae: shows [6d 6c] (Pair of Eights and Pair of Sixes)
9e93707c: shows [Kh Ah] (Pair of Eights)
*** SHOWDOWN ***
36dc06ae collected $0.71 from pot
*** SUMMARY ***
Total pot $0.74 | Rake $0.03 | Jackpot $0 | Bingo $0 | Fortune $0
Board [8d 8c 9h 4c 2s]
Seat 1: 770444cd folded before Flop (didn't bet)
Seat 2: 36dc06ae showed [6d 6c] and won ($0.71) with Pair of Eights and Pair of Sixes
Seat 3: Hero (button) folded before Flop (didn't bet)
Seat 5: 4a6998dc (small blind) folded before Flop
Seat 6: 9e93707c (big blind) showed [Kh Ah] and lost with Pair of Eights


Poker Hand #HD1212467936: Hold'em No Limit  ($0.02/$0.05) - 2023/04/21 21:40:18
Table 'NLHBlue37' 6-max Seat #2 is the button
Seat 1: 770444cd ($5.96 in chips)
Seat 2: 36dc06ae ($4.71 in chips)
Seat 3: Hero ($6.39 in chips)
Seat 5: 4a6998dc ($5 in chips)
Seat 6: 9e93707c ($8.32 in chips)
Hero: posts small blind $0.02
4a6998dc: posts big blind $0.05
*** HOLE CARDS ***
Dealt to 770444cd 
Dealt to 36dc06ae 
Dealt to Hero [3c Ad]
Dealt to 4a6998dc 
Dealt to 9e93707c 
9e93707c: folds
770444cd: raises $0.05 to $0.1
36dc06ae: folds
Hero: folds
4a6998dc: folds
Uncalled bet ($0.05) returned to 770444cd
*** SHOWDOWN ***
770444cd collected $0.12 from pot
*** SUMMARY ***
Total pot $0.12 | Rake $0 | Jackpot $0 | Bingo $0 | Fortune $0
Seat 1: 770444cd collected ($0.12)
Seat 2: 36dc06ae (button) folded before Flop (didn't bet)
Seat 3: Hero (small blind) folded before Flop
Seat 5: 4a6998dc (big blind) folded before Flop
Seat 6: 9e93707c folded before Flop (didn't bet)


Poker Hand #HD1212467792: Hold'em No Limit  ($0.02/$0.05) - 2023/04/21 21:38:56
Table 'NLHBlue37' 6-max Seat #1 is the button
Seat 1: 770444cd ($5.96 in chips)
Seat 2: 36dc06ae ($5.04 in chips)
Seat 3: Hero ($6.54 in chips)
Seat 4: 19fffd37 ($5.05 in chips)
Seat 5: 4a6998dc ($5 in chips)
Seat 6: 9e93707c ($7.88 in chips)
36dc06ae: posts small blind $0.02
Hero: posts big blind $0.05
*** HOLE CARDS ***
Dealt to 770444cd 
Dealt to 36dc06ae 
Dealt to Hero [6d 6s]
Dealt to 19fffd37 
Dealt to 4a6998dc 
Dealt to 9e93707c 
19fffd37: folds
4a6998dc: folds
9e93707c: raises $0.1 to $0.15
770444cd: folds
36dc06ae: calls $0.13
Hero: calls $0.1
*** FLOP *** [9c 5s 9d]
36dc06ae: checks
Hero: checks
9e93707c: checks
*** TURN *** [9c 5s 9d] [Qc]
36dc06ae: checks
Hero: checks
9e93707c: bets $0.18
36dc06ae: calls $0.18
Hero: folds
*** RIVER *** [9c 5s 9d Qc] [7c]
36dc06ae: checks
9e93707c: bets $1.1
36dc06ae: folds
Uncalled bet ($1.1) returned to 9e93707c
*** SHOWDOWN ***
9e93707c collected $0.77 from pot
*** SUMMARY ***
Total pot $0.81 | Rake $0.04 | Jackpot $0 | Bingo $0 | Fortune $0
Board [9c 5s 9d Qc 7c]
Seat 1: 770444cd (button) folded before Flop (didn't bet)
Seat 2: 36dc06ae (small blind) folded on the River
Seat 3: Hero (big blind) folded on the Turn
Seat 4: 19fffd37 folded before Flop (didn't bet)
Seat 5: 4a6998dc folded before Flop (didn't bet)
Seat 6: 9e93707c won ($0.77)


Poker Hand #HD1212467747: Hold'em No Limit  ($0.02/$0.05) - 2023/04/21 21:38:33
Table 'NLHBlue37' 6-max Seat #6 is the button
Seat 1: 770444cd ($5.98 in chips)
Seat 2: 36dc06ae ($5.02 in chips)
Seat 3: Hero ($6.54 in chips)
Seat 4: 19fffd37 ($5.05 in chips)
Seat 5: 4a6998dc ($5 in chips)
Seat 6: 9e93707c ($7.88 in chips)
770444cd: posts small blind $0.02
36dc06ae: posts big blind $0.05
*** HOLE CARDS ***
Dealt to 770444cd 
Dealt to 36dc06ae 
Dealt to Hero [Jh 9d]
Dealt to 19fffd37 
Dealt to 4a6998dc 
Dealt to 9e93707c 
Hero: folds
19fffd37: folds
4a6998dc: folds
9e93707c: folds
770444cd: folds
Uncalled bet ($0.03) returned to 36dc06ae
*** SHOWDOWN ***
36dc06ae collected $0.04 from pot
*** SUMMARY ***
Total pot $0.04 | Rake $0 | Jackpot $0 | Bingo $0 | Fortune $0
Seat 1: 770444cd (small blind) folded before Flop
Seat 2: 36dc06ae (big blind) collected ($0.04)
Seat 3: Hero folded before Flop (didn't bet)
Seat 4: 19fffd37 folded before Flop (didn't bet)
Seat 5: 4a6998dc folded before Flop (didn't bet)
Seat 6: 9e93707c (button) folded before Flop (didn't bet)


Poker Hand #HD1212467705: Hold'em No Limit  ($0.02/$0.05) - 2023/04/21 21:38:08
Table 'NLHBlue37' 6-max Seat #5 is the button
Seat 1: 770444cd ($6.03 in chips)
Seat 2: 36dc06ae ($4.95 in chips)
Seat 3: Hero ($6.54 in chips)
Seat 4: 19fffd37 ($5.05 in chips)
Seat 5: 4a6998dc ($5 in chips)
Seat 6: 9e93707c ($7.9 in chips)
9e93707c: posts small blind $0.02
770444cd: posts big blind $0.05
*** HOLE CARDS ***
Dealt to 770444cd 
Dealt to 36dc06ae 
Dealt to Hero [8h 7s]
Dealt to 19fffd37 
Dealt to 4a6998dc 
Dealt to 9e93707c 
36dc06ae: raises $0.07 to $0.12
Hero: folds
19fffd37: folds
4a6998dc: folds
9e93707c: folds
770444cd: folds
Uncalled bet ($0.07) returned to 36dc06ae
*** SHOWDOWN ***
36dc06ae collected $0.12 from pot
*** SUMMARY ***
Total pot $0.12 | Rake $0 | Jackpot $0 | Bingo $0 | Fortune $0
Seat 1: 770444cd (big blind) folded before Flop
Seat 2: 36dc06ae collected ($0.12)
Seat 3: Hero folded before Flop (didn't bet)
Seat 4: 19fffd37 folded before Flop (didn't bet)
Seat 5: 4a6998dc (button) folded before Flop (didn't bet)
Seat 6: 9e93707c (small blind) folded before Flop


Poker Hand #HD1212467671: Hold'em No Limit  ($0.02/$0.05) - 2023/04/21 21:37:51
Table 'NLHBlue37' 6-max Seat #4 is the button
Seat 1: 770444cd ($6.03 in chips)
Seat 2: 36dc06ae ($4.95 in chips)
Seat 3: Hero ($6.47 in chips)
Seat 4: 19fffd37 ($5.05 in chips)
Seat 5: 4a6998dc ($5 in chips)
Seat 6: 9e93707c ($7.95 in chips)
4a6998dc: posts small blind $0.02
9e93707c: posts big blind $0.05
*** HOLE CARDS ***
Dealt to 770444cd 
Dealt to 36dc06ae 
Dealt to Hero [Tc Ah]
Dealt to 19fffd37 
Dealt to 4a6998dc 
Dealt to 9e93707c 
770444cd: folds
36dc06ae: folds
Hero: raises $0.07 to $0.12
19fffd37: folds
4a6998dc: folds
9e93707c: folds
Uncalled bet ($0.07) returned to Hero
*** SHOWDOWN ***
Hero collected $0.12 from pot
*** SUMMARY ***
Total pot $0.12 | Rake $0 | Jackpot $0 | Bingo $0 | Fortune $0
Seat 1: 770444cd folded before Flop (didn't bet)
Seat 2: 36dc06ae folded before Flop (didn't bet)
Seat 3: Hero collected ($0.12)
Seat 4: 19fffd37 (button) folded before Flop (didn't bet)
Seat 5: 4a6998dc (small blind) folded before Flop
Seat 6: 9e93707c (big blind) folded before Flop


Poker Hand #HD1212467647: Hold'em No Limit  ($0.02/$0.05) - 2023/04/21 21:37:35
Table 'NLHBlue37' 6-max Seat #3 is the button
Seat 1: 770444cd ($6.03 in chips)
Seat 2: 36dc06ae ($4.95 in chips)
Seat 3: Hero ($6.4 in chips)
Seat 4: 19fffd37 ($5.07 in chips)
Seat 5: 4a6998dc ($5 in chips)
Seat 6: 9e93707c ($7.95 in chips)
19fffd37: posts small blind $0.02
4a6998dc: posts big blind $0.05
*** HOLE CARDS ***
Dealt to 770444cd 
Dealt to 36dc06ae 
Dealt to Hero [8s Qs]
Dealt to 19fffd37 
Dealt to 4a6998dc 
Dealt to 9e93707c 
9e93707c: folds
770444cd: folds
36dc06ae: folds
Hero: raises $0.07 to $0.12
19fffd37: folds
4a6998dc: folds
Uncalled bet ($0.07) returned to Hero
*** SHOWDOWN ***
Hero collected $0.12 from pot
*** SUMMARY ***
Total pot $0.12 | Rake $0 | Jackpot $0 | Bingo $0 | Fortune $0
Seat 1: 770444cd folded before Flop (didn't bet)
Seat 2: 36dc06ae folded before Flop (didn't bet)
Seat 3: Hero (button) collected ($0.12)
Seat 4: 19fffd37 (small blind) folded before Flop
Seat 5: 4a6998dc (big blind) folded before Flop
Seat 6: 9e93707c folded before Flop (didn't bet)


Poker Hand #HD1212467617: Hold'em No Limit  ($0.02/$0.05) - 2023/04/21 21:37:21
Table 'NLHBlue37' 6-max Seat #2 is the button
Seat 1: 770444cd ($6.03 in chips)
Seat 2: 36dc06ae ($4.88 in chips)
Seat 3: Hero ($6.42 in chips)
Seat 4: 19fffd37 ($5.12 in chips)
Seat 6: 9e93707c ($7.95 in chips)
Hero: posts small blind $0.02
19fffd37: posts big blind $0.05
*** HOLE CARDS ***
Dealt to 770444cd 
Dealt to 36dc06ae 
Dealt to Hero [Ks 9d]
Dealt to 19fffd37 
Dealt to 9e93707c 
9e93707c: folds
770444cd: folds
36dc06ae: raises $0.07 to $0.12
Hero: folds
19fffd37: folds
Uncalled bet ($0.07) returned to 36dc06ae
*** SHOWDOWN ***
36dc06ae collected $0.12 from pot
*** SUMMARY ***
Total pot $0.12 | Rake $0 | Jackpot $0 | Bingo $0 | Fortune $0
Seat 1: 770444cd folded before Flop (didn't bet)
Seat 2: 36dc06ae (button) collected ($0.12)
Seat 3: Hero (small blind) folded before Flop
Seat 4: 19fffd37 (big blind) folded before Flop
Seat 6: 9e93707c folded before Flop (didn't bet)


Poker Hand #HD1212467552: Hold'em No Limit  ($0.02/$0.05) - 2023/04/21 21:36:49
Table 'NLHBlue37' 6-max Seat #1 is the button
Seat 1: 770444cd ($6.16 in chips)
Seat 2: 36dc06ae ($4.9 in chips)
Seat 3: Hero ($6.47 in chips)
Seat 4: 19fffd37 ($5.12 in chips)
Seat 6: 9e93707c ($7.76 in chips)
36dc06ae: posts small blind $0.02
Hero: posts big blind $0.05
*** HOLE CARDS ***
Dealt to 770444cd 
Dealt to 36dc06ae 
Dealt to Hero [8h 5d]
Dealt to 19fffd37 
Dealt to 9e93707c 
19fffd37: folds
9e93707c: raises $0.08 to $0.13
770444cd: calls $0.13
36dc06ae: folds
Hero: folds
*** FLOP *** [6c 8s Jh]
9e93707c: bets $0.13
770444cd: folds
Uncalled bet ($0.13) returned to 9e93707c
*** SHOWDOWN ***
9e93707c collected $0.32 from pot
*** SUMMARY ***
Total pot $0.33 | Rake $0.01 | Jackpot $0 | Bingo $0 | Fortune $0
Board [6c 8s Jh]
Seat 1: 770444cd (button) folded on the Flop
Seat 2: 36dc06ae (small blind) folded before Flop
Seat 3: Hero (big blind) folded before Flop
Seat 4: 19fffd37 folded before Flop (didn't bet)
Seat 6: 9e93707c won ($0.32)


Poker Hand #HD1212467517: Hold'em No Limit  ($0.02/$0.05) - 2023/04/21 21:36:30
Table 'NLHBlue37' 6-max Seat #6 is the button
Seat 1: 770444cd ($6.18 in chips)
Seat 2: 36dc06ae ($4.95 in chips)
Seat 3: Hero ($6.4 in chips)
Seat 4: 19fffd37 ($5.12 in chips)
Seat 6: 9e93707c ($7.76 in chips)
770444cd: posts small blind $0.02
36dc06ae: posts big blind $0.05
*** HOLE CARDS ***
Dealt to 770444cd 
Dealt to 36dc06ae 
Dealt to Hero [Kd Kh]
Dealt to 19fffd37 
Dealt to 9e93707c 
Hero: raises $0.07 to $0.12
19fffd37: folds
9e93707c: folds
770444cd: folds
36dc06ae: folds
Uncalled bet ($0.07) returned to Hero
*** SHOWDOWN ***
Hero collected $0.12 from pot
*** SUMMARY ***
Total pot $0.12 | Rake $0 | Jackpot $0 | Bingo $0 | Fortune $0
Seat 1: 770444cd (small blind) folded before Flop
Seat 2: 36dc06ae (big blind) folded before Flop
Seat 3: Hero collected ($0.12)
Seat 4: 19fffd37 folded before Flop (didn't bet)
Seat 6: 9e93707c (button) folded before Flop (didn't bet)


Poker Hand #HD1212467403: Hold'em No Limit  ($0.02/$0.05) - 2023/04/21 21:35:28
Table 'NLHBlue37' 6-max Seat #5 is the button
Seat 1: 770444cd ($6.23 in chips)
Seat 2: 36dc06ae ($4.95 in chips)
Seat 3: Hero ($6.4 in chips)
Seat 4: 19fffd37 ($5.12 in chips)
Seat 5: a08ee987 ($1.75 in chips)
Seat 6: 9e93707c ($6.18 in chips)
9e93707c: posts small blind $0.02
770444cd: posts big blind $0.05
*** HOLE CARDS ***
Dealt to 770444cd 
Dealt to 36dc06ae 
Dealt to Hero [8h As]
Dealt to 19fffd37 
Dealt to a08ee987 
Dealt to 9e93707c 
36dc06ae: folds
Hero: folds
19fffd37: folds
a08ee987: raises $0.1 to $0.15
9e93707c: raises $0.3 to $0.45
770444cd: folds
a08ee987: raises $1.3 to $1.75 and is all-in
9e93707c: calls $1.3
a08ee987: shows [3d 3s]
9e93707c: shows [Jc Jh]
*** FLOP *** [9h 8c Qs]
*** TURN *** [9h 8c Qs] [5h]
*** RIVER *** [9h 8c Qs 5h] [Ac]
770444cd: shows [Ah] (Pair of Aces)
*** SHOWDOWN ***
9e93707c collected $3.33 from pot
*** SUMMARY ***
Total pot $3.55 | Rake $0.17 | Jackpot $0.05 | Bingo $0 | Fortune $0
Board [9h 8c Qs 5h Ac]
Seat 1: 770444cd (big blind) folded before Flop
Seat 2: 36dc06ae folded before Flop (didn't bet)
Seat 3: Hero folded before Flop (didn't bet)
Seat 4: 19fffd37 folded before Flop (didn't bet)
Seat 5: a08ee987 (button) showed [3d 3s] and lost with Pair of Treys
Seat 6: 9e93707c (small blind) showed [Jc Jh] and won ($3.33) with Pair of Jacks


Poker Hand #HD1212467313: Hold'em No Limit  ($0.02/$0.05) - 2023/04/21 21:34:38
Table 'NLHBlue37' 6-max Seat #4 is the button
Seat 1: 770444cd ($6.23 in chips)
Seat 2: 36dc06ae ($4.95 in chips)
Seat 3: Hero ($6.4 in chips)
Seat 4: 19fffd37 ($5.12 in chips)
Seat 5: a08ee987 ($1.82 in chips)
Seat 6: 9e93707c ($6.26 in chips)
a08ee987: posts small blind $0.02
9e93707c: posts big blind $0.05
*** HOLE CARDS ***
Dealt to 770444cd 
Dealt to 36dc06ae 
Dealt to Hero [Ts 6h]
Dealt to 19fffd37 
Dealt to a08ee987 
Dealt to 9e93707c 
770444cd: folds
36dc06ae: folds
Hero: folds
19fffd37: folds
a08ee987: raises $0.1 to $0.15
9e93707c: calls $0.1
*** FLOP *** [8d Td 8c]
a08ee987: bets $0.15
9e93707c: calls $0.15
*** TURN *** [8d Td 8c] [Jd]
a08ee987: bets $0.3
9e93707c: calls $0.3
*** RIVER *** [8d Td 8c Jd] [Ks]
a08ee987: bets $0.6
9e93707c: calls $0.6
a08ee987: shows [Qs Jc] (Pair of Jacks and Pair of Eights)
9e93707c: shows [9s Jh] (Pair of Jacks and Pair of Eights)
*** SHOWDOWN ***
a08ee987 collected $1.13 from pot
9e93707c collected $1.12 from pot
*** SUMMARY ***
Total pot $2.4 | Rake $0.1 | Jackpot $0.05 | Bingo $0 | Fortune $0
Board [8d Td 8c Jd Ks]
Seat 1: 770444cd folded before Flop (didn't bet)
Seat 2: 36dc06ae folded before Flop (didn't bet)
Seat 3: Hero folded before Flop (didn't bet)
Seat 4: 19fffd37 (button) folded before Flop (didn't bet)
Seat 5: a08ee987 (small blind) showed [Qs Jc] and won ($1.13) with Pair of Jacks and Pair of Eights
Seat 6: 9e93707c (big blind) showed [9s Jh] and won ($1.12) with Pair of Jacks and Pair of Eights


Poker Hand #HD1212467276: Hold'em No Limit  ($0.02/$0.05) - 2023/04/21 21:34:18
Table 'NLHBlue37' 6-max Seat #3 is the button
Seat 1: 770444cd ($6.23 in chips)
Seat 2: 36dc06ae ($5 in chips)
Seat 3: Hero ($6.4 in chips)
Seat 4: 19fffd37 ($5.02 in chips)
Seat 5: a08ee987 ($1.87 in chips)
Seat 6: 9e93707c ($6.26 in chips)
19fffd37: posts small blind $0.02
a08ee987: posts big blind $0.05
36dc06ae: posts big blind $0.05
*** HOLE CARDS ***
Dealt to 770444cd 
Dealt to 36dc06ae 
Dealt to Hero [2c 7d]
Dealt to 19fffd37 
Dealt to a08ee987 
Dealt to 9e93707c 
9e93707c: folds
770444cd: folds
36dc06ae: checks
Hero: folds
19fffd37: raises $0.2 to $0.25
a08ee987: folds
36dc06ae: folds
Uncalled bet ($0.2) returned to 19fffd37
*** SHOWDOWN ***
19fffd37 collected $0.15 from pot
*** SUMMARY ***
Total pot $0.15 | Rake $0 | Jackpot $0 | Bingo $0 | Fortune $0
Seat 1: 770444cd folded before Flop (didn't bet)
Seat 2: 36dc06ae folded before Flop
Seat 3: Hero (button) folded before Flop (didn't bet)
Seat 4: 19fffd37 (small blind) collected ($0.15)
Seat 5: a08ee987 (big blind) folded before Flop
Seat 6: 9e93707c folded before Flop (didn't bet)


Poker Hand #HD1212467259: Hold'em No Limit  ($0.02/$0.05) - 2023/04/21 21:34:09
Table 'NLHBlue37' 6-max Seat #1 is the button
Seat 1: 770444cd ($6.23 in chips)
Seat 3: Hero ($6.42 in chips)
Seat 4: 19fffd37 ($5 in chips)
Seat 5: a08ee987 ($1.87 in chips)
Seat 6: 9e93707c ($6.26 in chips)
Hero: posts small blind $0.02
19fffd37: posts big blind $0.05
*** HOLE CARDS ***
Dealt to 770444cd 
Dealt to Hero [9c 4c]
Dealt to 19fffd37 
Dealt to a08ee987 
Dealt to 9e93707c 
a08ee987: folds
9e93707c: folds
770444cd: folds
Hero: folds
Uncalled bet ($0.03) returned to 19fffd37
*** SHOWDOWN ***
19fffd37 collected $0.04 from pot
*** SUMMARY ***
Total pot $0.04 | Rake $0 | Jackpot $0 | Bingo $0 | Fortune $0
Seat 1: 770444cd (button) folded before Flop (didn't bet)
Seat 3: Hero (small blind) folded before Flop
Seat 4: 19fffd37 (big blind) collected ($0.04)
Seat 5: a08ee987 folded before Flop (didn't bet)
Seat 6: 9e93707c folded before Flop (didn't bet)


Poker Hand #HD1212467169: Hold'em No Limit  ($0.02/$0.05) - 2023/04/21 21:33:22
Table 'NLHBlue37' 6-max Seat #6 is the button
Seat 1: 770444cd ($5.56 in chips)
Seat 3: Hero ($6.47 in chips)
Seat 4: 19fffd37 ($5 in chips)
Seat 5: a08ee987 ($2.56 in chips)
Seat 6: 9e93707c ($6.26 in chips)
770444cd: posts small blind $0.02
Hero: posts big blind $0.05
*** HOLE CARDS ***
Dealt to 770444cd 
Dealt to Hero [Kd 3s]
Dealt to 19fffd37 
Dealt to a08ee987 
Dealt to 9e93707c 
19fffd37: folds
a08ee987: raises $0.1 to $0.15
9e93707c: folds
770444cd: calls $0.13
Hero: folds
*** FLOP *** [Ks Td 9h]
770444cd: checks
a08ee987: bets $0.18
770444cd: raises $0.36 to $0.54
a08ee987: calls $0.36
*** TURN *** [Ks Td 9h] [Js]
770444cd: bets $1.08
a08ee987: folds
Uncalled bet ($1.08) returned to 770444cd
*** SHOWDOWN ***
770444cd collected $1.36 from pot
*** SUMMARY ***
Total pot $1.43 | Rake $0.07 | Jackpot $0 | Bingo $0 | Fortune $0
Board [Ks Td 9h Js]
Seat 1: 770444cd (small blind) won ($1.36)
Seat 3: Hero (big blind) folded before Flop
Seat 4: 19fffd37 folded before Flop (didn't bet)
Seat 5: a08ee987 folded on the Turn
Seat 6: 9e93707c (button) folded before Flop (didn't bet)


Poker Hand #HD1212467116: Hold'em No Limit  ($0.02/$0.05) - 2023/04/21 21:32:56
Table 'NLHBlue37' 6-max Seat #5 is the button
Seat 1: 770444cd ($5.66 in chips)
Seat 3: Hero ($6.47 in chips)
Seat 4: 19fffd37 ($5 in chips)
Seat 5: a08ee987 ($2.45 in chips)
Seat 6: 9e93707c ($6.28 in chips)
9e93707c: posts small blind $0.02
770444cd: posts big blind $0.05
*** HOLE CARDS ***
Dealt to 770444cd 
Dealt to Hero [5d 2d]
Dealt to 19fffd37 
Dealt to a08ee987 
Dealt to 9e93707c 
Hero: folds
19fffd37: folds
a08ee987: raises $0.05 to $0.1
9e93707c: folds
770444cd: calls $0.05
*** FLOP *** [7s 6d 9d]
770444cd: checks
a08ee987: bets $0.11
770444cd: folds
Uncalled bet ($0.11) returned to a08ee987
*** SHOWDOWN ***
a08ee987 collected $0.21 from pot
*** SUMMARY ***
Total pot $0.22 | Rake $0.01 | Jackpot $0 | Bingo $0 | Fortune $0
Board [7s 6d 9d]
Seat 1: 770444cd (big blind) folded on the Flop
Seat 3: Hero folded before Flop (didn't bet)
Seat 4: 19fffd37 folded before Flop (didn't bet)
Seat 5: a08ee987 (button) won ($0.21)
Seat 6: 9e93707c (small blind) folded before Flop


Poker Hand #HD1212467026: Hold'em No Limit  ($0.02/$0.05) - 2023/04/21 21:32:05
Table 'NLHBlue37' 6-max Seat #4 is the button
Seat 1: 770444cd ($5.29 in chips)
Seat 3: Hero ($6.47 in chips)
Seat 4: 19fffd37 ($5 in chips)
Seat 5: a08ee987 ($2.6 in chips)
Seat 6: 9e93707c ($6.53 in chips)
a08ee987: posts small blind $0.02
9e93707c: posts big blind $0.05
*** HOLE CARDS ***
Dealt to 770444cd 
Dealt to Hero [Jh Qc]
Dealt to 19fffd37 
Dealt to a08ee987 
Dealt to 9e93707c 
770444cd: raises $0.05 to $0.1
Hero: folds
19fffd37: folds
a08ee987: raises $0.05 to $0.15
9e93707c: calls $0.1
770444cd: calls $0.05
*** FLOP *** [5c As 7s]
a08ee987: checks
9e93707c: bets $0.1
770444cd: calls $0.1
a08ee987: folds
*** TURN *** [5c As 7s] [6s]
9e93707c: checks
770444cd: checks
*** RIVER *** [5c As 7s 6s] [8s]
9e93707c: checks
770444cd: checks
9e93707c: shows [7c Tc] (Pair of Sevens)
770444cd: shows [Ah 8h] (Pair of Aces and Pair of Eights)
*** SHOWDOWN ***
770444cd collected $0.62 from pot
*** SUMMARY ***
Total pot $0.65 | Rake $0.03 | Jackpot $0 | Bingo $0 | Fortune $0
Board [5c As 7s 6s 8s]
Seat 1: 770444cd showed [Ah 8h] and won ($0.62) with Pair of Aces and Pair of Eights
Seat 3: Hero folded before Flop (didn't bet)
Seat 4: 19fffd37 (button) folded before Flop (didn't bet)
Seat 5: a08ee987 (small blind) folded on the Flop
Seat 6: 9e93707c (big blind) showed [7c Tc] and lost with Pair of Sevens


Poker Hand #HD1212466996: Hold'em No Limit  ($0.02/$0.05) - 2023/04/21 21:31:52
Table 'NLHBlue37' 6-max Seat #3 is the button
Seat 1: 770444cd ($5.22 in chips)
Seat 3: Hero ($6.47 in chips)
Seat 4: 19fffd37 ($5 in chips)
Seat 5: a08ee987 ($2.65 in chips)
Seat 6: 9e93707c ($6.53 in chips)
19fffd37: posts small blind $0.02
a08ee987: posts big blind $0.05
*** HOLE CARDS ***
Dealt to 770444cd 
Dealt to Hero [4c 7d]
Dealt to 19fffd37 
Dealt to a08ee987 
Dealt to 9e93707c 
9e93707c: folds
770444cd: raises $0.05 to $0.1
Hero: folds
19fffd37: folds
a08ee987: folds
Uncalled bet ($0.05) returned to 770444cd
*** SHOWDOWN ***
770444cd collected $0.12 from pot
*** SUMMARY ***
Total pot $0.12 | Rake $0 | Jackpot $0 | Bingo $0 | Fortune $0
Seat 1: 770444cd collected ($0.12)
Seat 3: Hero (button) folded before Flop (didn't bet)
Seat 4: 19fffd37 (small blind) folded before Flop
Seat 5: a08ee987 (big blind) folded before Flop
Seat 6: 9e93707c folded before Flop (didn't bet)


Poker Hand #HD1212466915: Hold'em No Limit  ($0.02/$0.05) - 2023/04/21 21:31:11
Table 'NLHBlue37' 6-max Seat #1 is the button
Seat 1: 770444cd ($5.02 in chips)
Seat 3: Hero ($6.49 in chips)
Seat 4: 19fffd37 ($5 in chips)
Seat 5: a08ee987 ($2.65 in chips)
Seat 6: 9e93707c ($6.53 in chips)
Hero: posts small blind $0.02
19fffd37: posts big blind $0.05
*** HOLE CARDS ***
Dealt to 770444cd 
Dealt to Hero [Jh 8c]
Dealt to 19fffd37 
Dealt to a08ee987 
Dealt to 9e93707c 
a08ee987: folds
9e93707c: folds
770444cd: raises $0.05 to $0.1
Hero: folds
19fffd37: calls $0.05
*** FLOP *** [4h 8h 4d]
19fffd37: checks
770444cd: checks
*** TURN *** [4h 8h 4d] [2h]
19fffd37: bets $0.1
770444cd: calls $0.1
*** RIVER *** [4h 8h 4d 2h] [Jc]
19fffd37: checks
770444cd: checks
19fffd37: shows [Kh Qs] (Pair of Fours)
770444cd: shows [5h As] (Pair of Fours)
*** SHOWDOWN ***
770444cd collected $0.4 from pot
*** SUMMARY ***
Total pot $0.42 | Rake $0.02 | Jackpot $0 | Bingo $0 | Fortune $0
Board [4h 8h 4d 2h Jc]
Seat 1: 770444cd (button) showed [5h As] and won ($0.4) with Pair of Fours
Seat 3: Hero (small blind) folded before Flop
Seat 4: 19fffd37 (big blind) showed [Kh Qs] and lost with Pair of Fours
Seat 5: a08ee987 folded before Flop (didn't bet)
Seat 6: 9e93707c folded before Flop (didn't bet)


Poker Hand #HD1212466844: Hold'em No Limit  ($0.02/$0.05) - 2023/04/21 21:30:34
Table 'NLHBlue37' 6-max Seat #6 is the button
Seat 1: 770444cd ($5.04 in chips)
Seat 3: Hero ($6.62 in chips)
Seat 4: 19fffd37 ($5 in chips)
Seat 5: a08ee987 ($2.65 in chips)
Seat 6: 9e93707c ($6.39 in chips)
770444cd: posts small blind $0.02
Hero: posts big blind $0.05
*** HOLE CARDS ***
Dealt to 770444cd 
Dealt to Hero [Kh Jc]
Dealt to 19fffd37 
Dealt to a08ee987 
Dealt to 9e93707c 
19fffd37: folds
a08ee987: folds
9e93707c: raises $0.08 to $0.13
770444cd: folds
Hero: calls $0.08
*** FLOP *** [4s Ts 4d]
Hero: checks
9e93707c: checks
*** TURN *** [4s Ts 4d] [5h]
Hero: checks
9e93707c: bets $0.15
Hero: folds
Uncalled bet ($0.15) returned to 9e93707c
*** SHOWDOWN ***
9e93707c collected $0.27 from pot
*** SUMMARY ***
Total pot $0.28 | Rake $0.01 | Jackpot $0 | Bingo $0 | Fortune $0
Board [4s Ts 4d 5h]
Seat 1: 770444cd (small blind) folded before Flop
Seat 3: Hero (big blind) folded on the Turn
Seat 4: 19fffd37 folded before Flop (didn't bet)
Seat 5: a08ee987 folded before Flop (didn't bet)
Seat 6: 9e93707c (button) won ($0.27)


Poker Hand #HD1212466783: Hold'em No Limit  ($0.02/$0.05) - 2023/04/21 21:30:03
Table 'NLHBlue37' 6-max Seat #5 is the button
Seat 1: 770444cd ($4.77 in chips)
Seat 3: Hero ($6.62 in chips)
Seat 4: 19fffd37 ($5 in chips)
Seat 5: a08ee987 ($2.92 in chips)
Seat 6: 9e93707c ($6.41 in chips)
9e93707c: posts small blind $0.02
770444cd: posts big blind $0.05
*** HOLE CARDS ***
Dealt to 770444cd 
Dealt to Hero [9s Tc]
Dealt to 19fffd37 
Dealt to a08ee987 
Dealt to 9e93707c 
Hero: folds
19fffd37: folds
a08ee987: raises $0.05 to $0.1
9e93707c: folds
770444cd: raises $0.17 to $0.27
a08ee987: calls $0.17
*** FLOP *** [Jh 5s 5c]
770444cd: bets $0.28
a08ee987: folds
Uncalled bet ($0.28) returned to 770444cd
*** SHOWDOWN ***
770444cd collected $0.54 from pot
*** SUMMARY ***
Total pot $0.56 | Rake $0.02 | Jackpot $0 | Bingo $0 | Fortune $0
Board [Jh 5s 5c]
Seat 1: 770444cd (big blind) won ($0.54)
Seat 3: Hero folded before Flop (didn't bet)
Seat 4: 19fffd37 folded before Flop (didn't bet)
Seat 5: a08ee987 (button) folded on the Flop
Seat 6: 9e93707c (small blind) folded before Flop


Poker Hand #HD1212466758: Hold'em No Limit  ($0.02/$0.05) - 2023/04/21 21:29:49
Table 'NLHBlue37' 6-max Seat #4 is the button
Seat 1: 770444cd ($4.77 in chips)
Seat 3: Hero ($6.62 in chips)
Seat 4: 19fffd37 ($5 in chips)
Seat 5: a08ee987 ($2.87 in chips)
Seat 6: 9e93707c ($6.46 in chips)
a08ee987: posts small blind $0.02
9e93707c: posts big blind $0.05
*** HOLE CARDS ***
Dealt to 770444cd 
Dealt to Hero [9d Kc]
Dealt to 19fffd37 
Dealt to a08ee987 
Dealt to 9e93707c 
770444cd: folds
Hero: folds
19fffd37: folds
a08ee987: raises $0.1 to $0.15
9e93707c: folds
Uncalled bet ($0.1) returned to a08ee987
*** SHOWDOWN ***
a08ee987 collected $0.1 from pot
*** SUMMARY ***
Total pot $0.1 | Rake $0 | Jackpot $0 | Bingo $0 | Fortune $0
Seat 1: 770444cd folded before Flop (didn't bet)
Seat 3: Hero folded before Flop (didn't bet)
Seat 4: 19fffd37 (button) folded before Flop (didn't bet)
Seat 5: a08ee987 (small blind) collected ($0.1)
Seat 6: 9e93707c (big blind) folded before Flop


Poker Hand #HD1212466701: Hold'em No Limit  ($0.02/$0.05) - 2023/04/21 21:29:16
Table 'NLHBlue37' 6-max Seat #3 is the button
Seat 1: 770444cd ($4.9 in chips)
Seat 3: Hero ($6.62 in chips)
Seat 4: 19fffd37 ($5 in chips)
Seat 5: a08ee987 ($3 in chips)
Seat 6: 9e93707c ($6.2 in chips)
19fffd37: posts small blind $0.02
a08ee987: posts big blind $0.05
*** HOLE CARDS ***
Dealt to 770444cd 
Dealt to Hero [8c 4d]
Dealt to 19fffd37 
Dealt to a08ee987 
Dealt to 9e93707c 
9e93707c: raises $0.08 to $0.13
770444cd: calls $0.13
Hero: folds
19fffd37: folds
a08ee987: calls $0.08
*** FLOP *** [5d 8d 2h]
a08ee987: checks
9e93707c: bets $0.1
770444cd: folds
a08ee987: folds
Uncalled bet ($0.1) returned to 9e93707c
*** SHOWDOWN ***
9e93707c collected $0.39 from pot
*** SUMMARY ***
Total pot $0.41 | Rake $0.02 | Jackpot $0 | Bingo $0 | Fortune $0
Board [5d 8d 2h]
Seat 1: 770444cd folded on the Flop
Seat 3: Hero (button) folded before Flop (didn't bet)
Seat 4: 19fffd37 (small blind) folded before Flop
Seat 5: a08ee987 (big blind) folded on the Flop
Seat 6: 9e93707c won ($0.39)


Poker Hand #HD1212466599: Hold'em No Limit  ($0.02/$0.05) - 2023/04/21 21:28:20
Table 'NLHBlue37' 6-max Seat #2 is the button
Seat 1: 770444cd ($4.9 in chips)
Seat 2: 6c3bef06 ($5.02 in chips)
Seat 3: Hero ($5 in chips)
Seat 4: 19fffd37 ($5 in chips)
Seat 6: 9e93707c ($6.2 in chips)
Hero: posts small blind $0.02
19fffd37: posts big blind $0.05
*** HOLE CARDS ***
Dealt to 770444cd 
Dealt to 6c3bef06 
Dealt to Hero [As Ad]
Dealt to 19fffd37 
Dealt to 9e93707c 
9e93707c: folds
770444cd: folds
6c3bef06: calls $0.05
Hero: raises $0.17 to $0.22
19fffd37: folds
6c3bef06: calls $0.17
*** FLOP *** [5s 4h Kc]
Hero: bets $0.25
6c3bef06: calls $0.25
*** TURN *** [5s 4h Kc] [3d]
Hero: bets $0.5
6c3bef06: raises $4.05 to $4.55 and is all-in
Hero: calls $4.03 and is all-in
Uncalled bet ($0.02) returned to 6c3bef06
6c3bef06: shows [4d 6s] (Pair of Fours)
Hero: shows [As Ad] (Pair of Aces)
Hero: Chooses to EV Cashout 
*** RIVER *** [5s 4h Kc 3d] [Ts]
Hero: Pays Cashout Risk ($2.88)
*** SHOWDOWN ***
Hero collected $9.5 from pot
*** SUMMARY ***
Total pot $10.05 | Rake $0.5 | Jackpot $0.05 | Bingo $0 | Fortune $0
Board [5s 4h Kc 3d Ts]
Seat 1: 770444cd folded before Flop (didn't bet)
Seat 2: 6c3bef06 (button) showed [4d 6s] and lost with Pair of Fours
Seat 3: Hero (small blind) showed [As Ad] and won ($9.5) with Pair of Aces, Cashout Risk ($2.88)
Seat 4: 19fffd37 (big blind) folded before Flop
Seat 6: 9e93707c folded before Flop (didn't bet)


Poker Hand #HD1212466515: Hold'em No Limit  ($0.02/$0.05) - 2023/04/21 21:27:39
Table 'NLHBlue37' 6-max Seat #1 is the button
Seat 1: 770444cd ($4.9 in chips)
Seat 2: 6c3bef06 ($4.75 in chips)
Seat 3: Hero ($5 in chips)
Seat 6: 9e93707c ($6.2 in chips)
6c3bef06: posts small blind $0.02
Hero: posts big blind $0.05
*** HOLE CARDS ***
Dealt to 770444cd 
Dealt to 6c3bef06 
Dealt to Hero [Qh Jd]
Dealt to 9e93707c 
9e93707c: folds
770444cd: folds
6c3bef06: calls $0.03
Hero: checks
*** FLOP *** [Qs 6d Kh]
6c3bef06: checks
Hero: bets $0.05
6c3bef06: calls $0.05
*** TURN *** [Qs 6d Kh] [6h]
6c3bef06: checks
Hero: checks
*** RIVER *** [Qs 6d Kh 6h] [Ts]
6c3bef06: bets $0.2
Hero: calls $0.2
6c3bef06: shows [6c 5c] (Three Sixes)
Hero: shows [Qh Jd] (Pair of Queens and Pair of Sixes)
*** SHOWDOWN ***
6c3bef06 collected $0.57 from pot
*** SUMMARY ***
Total pot $0.6 | Rake $0.03 | Jackpot $0 | Bingo $0 | Fortune $0
Board [Qs 6d Kh 6h Ts]
Seat 1: 770444cd (button) folded before Flop (didn't bet)
Seat 2: 6c3bef06 (small blind) showed [6c 5c] and won ($0.57) with Three Sixes
Seat 3: Hero (big blind) showed [Qh Jd] and lost with Pair of Queens and Pair of Sixes
Seat 6: 9e93707c folded before Flop (didn't bet)


Poker Hand #HD1212466440: Hold'em No Limit  ($0.02/$0.05) - 2023/04/21 21:27:03
Table 'NLHBlue37' 6-max Seat #6 is the button
Seat 1: 770444cd ($4.95 in chips)
Seat 2: 6c3bef06 ($4.7 in chips)
Seat 3: Hero ($5 in chips)
Seat 6: 9e93707c ($6.2 in chips)
770444cd: posts small blind $0.02
6c3bef06: posts big blind $0.05
*** HOLE CARDS ***
Dealt to 770444cd 
Dealt to 6c3bef06 
Dealt to Hero [3s Kh]
Dealt to 9e93707c 
Hero: folds
9e93707c: folds
770444cd: calls $0.03
6c3bef06: checks
*** FLOP *** [Jh 9c Ad]
770444cd: checks
6c3bef06: checks
*** TURN *** [Jh 9c Ad] [6h]
770444cd: checks
6c3bef06: checks
*** RIVER *** [Jh 9c Ad 6h] [5s]
770444cd: checks
6c3bef06: bets $0.05
770444cd: folds
Uncalled bet ($0.05) returned to 6c3bef06
*** SHOWDOWN ***
6c3bef06 collected $0.1 from pot
*** SUMMARY ***
Total pot $0.1 | Rake $0 | Jackpot $0 | Bingo $0 | Fortune $0
Board [Jh 9c Ad 6h 5s]
Seat 1: 770444cd (small blind) folded on the River
Seat 2: 6c3bef06 (big blind) won ($0.1)
Seat 3: Hero folded before Flop (didn't bet)
Seat 6: 9e93707c (button) folded before Flop (didn't bet)


Poker Hand #HD1212466390: Hold'em No Limit  ($0.02/$0.05) - 2023/04/21 21:26:36
Table 'NLHBlue37' 6-max Seat #3 is the button
Seat 1: 770444cd ($5 in chips)
Seat 2: 6c3bef06 ($4.63 in chips)
Seat 3: Hero ($5 in chips)
Seat 6: 9e93707c ($6.22 in chips)
9e93707c: posts small blind $0.02
770444cd: posts big blind $0.05
*** HOLE CARDS ***
Dealt to 770444cd 
Dealt to 6c3bef06 
Dealt to Hero [Kc 2h]
Dealt to 9e93707c 
6c3bef06: calls $0.05
Hero: folds
9e93707c: folds
770444cd: checks
*** FLOP *** [2c Jh Qh]
770444cd: checks
6c3bef06: checks
*** TURN *** [2c Jh Qh] [9d]
770444cd: checks
6c3bef06: bets $0.15
770444cd: folds
Uncalled bet ($0.15) returned to 6c3bef06
*** SHOWDOWN ***
6c3bef06 collected $0.12 from pot
*** SUMMARY ***
Total pot $0.12 | Rake $0 | Jackpot $0 | Bingo $0 | Fortune $0
Board [2c Jh Qh 9d]
Seat 1: 770444cd (big blind) folded on the Turn
Seat 2: 6c3bef06 won ($0.12)
Seat 3: Hero (button) folded before Flop (didn't bet)
Seat 6: 9e93707c (small blind) folded before Flop


Poker Hand #HD1212466321: Hold'em No Limit  ($0.02/$0.05) - 2023/04/21 21:25:57
Table 'NLHBlue37' 6-max Seat #2 is the button
Seat 2: 6c3bef06 ($4.52 in chips)
Seat 3: Hero ($5 in chips)
Seat 6: 9e93707c ($6.32 in chips)
Hero: posts small blind $0.02
9e93707c: posts big blind $0.05
*** HOLE CARDS ***
Dealt to 6c3bef06 
Dealt to Hero [4h 6d]
Dealt to 9e93707c 
6c3bef06: calls $0.05
Hero: folds
9e93707c: checks
*** FLOP *** [Ad 3c 2c]
9e93707c: checks
6c3bef06: bets $0.05
9e93707c: calls $0.05
*** TURN *** [Ad 3c 2c] [5h]
9e93707c: checks
6c3bef06: bets $0.1
9e93707c: folds
Uncalled bet ($0.1) returned to 6c3bef06
*** SHOWDOWN ***
6c3bef06 collected $0.21 from pot
*** SUMMARY ***
Total pot $0.22 | Rake $0.01 | Jackpot $0 | Bingo $0 | Fortune $0
Board [Ad 3c 2c 5h]
Seat 2: 6c3bef06 (button) won ($0.21)
Seat 3: Hero (small blind) folded before Flop
Seat 6: 9e93707c (big blind) folded on the Turn


Poker Hand #HD1212466286: Hold'em No Limit  ($0.02/$0.05) - 2023/04/21 21:25:35
Table 'NLHBlue37' 6-max Seat #6 is the button
Seat 2: 6c3bef06 ($4.54 in chips)
Seat 3: Hero ($5 in chips)
Seat 6: 9e93707c ($6.16 in chips)
6c3bef06: posts small blind $0.02
Hero: posts big blind $0.05
*** HOLE CARDS ***
Dealt to 6c3bef06 
Dealt to Hero [3d 3s]
Dealt to 9e93707c 
9e93707c: raises $0.1 to $0.15
6c3bef06: folds
Hero: calls $0.1
*** FLOP *** [Ad Kd Tc]
Hero: checks
9e93707c: bets $0.16
Hero: folds
Uncalled bet ($0.16) returned to 9e93707c
*** SHOWDOWN ***
9e93707c collected $0.31 from pot
*** SUMMARY ***
Total pot $0.32 | Rake $0.01 | Jackpot $0 | Bingo $0 | Fortune $0
Board [Ad Kd Tc]
Seat 2: 6c3bef06 (small blind) folded before Flop
Seat 3: Hero (big blind) folded on the Flop
Seat 6: 9e93707c (button) won ($0.31)


