Poker Hand #HD1144691019: Hold'em No Limit  ($0.02/$0.05) - 2023/03/03 21:22:15
Table 'NLHBlue116' 6-max Seat #5 is the button
Seat 1: Hero ($7.73 in chips)
Seat 4: 713370ec ($9.47 in chips)
Seat 5: a2d31939 ($12.88 in chips)
Seat 6: 5b1dc166 ($6.3 in chips)
5b1dc166: posts small blind $0.02
Hero: posts big blind $0.05
*** HOLE CARDS ***
Dealt to Hero [2d 4d]
Dealt to 713370ec 
Dealt to a2d31939 
Dealt to 5b1dc166 
713370ec: folds
a2d31939: folds
5b1dc166: folds
Uncalled bet ($0.03) returned to Hero
*** SHOWDOWN ***
Hero collected $0.04 from pot
*** SUMMARY ***
Total pot $0.04 | Rake $0 | Jackpot $0 | Bingo $0 | Fortune $0
Seat 1: Hero (big blind) collected ($0.04)
Seat 4: 713370ec folded before Flop (didn't bet)
Seat 5: a2d31939 (button) folded before Flop (didn't bet)
Seat 6: 5b1dc166 (small blind) folded before Flop


Poker Hand #HD1144690996: Hold'em No Limit  ($0.02/$0.05) - 2023/03/03 21:22:05
Table 'NLHBlue116' 6-max Seat #4 is the button
Seat 1: Hero ($7.73 in chips)
Seat 4: 713370ec ($9.47 in chips)
Seat 5: a2d31939 ($12.9 in chips)
Seat 6: 5b1dc166 ($6.28 in chips)
a2d31939: posts small blind $0.02
5b1dc166: posts big blind $0.05
*** HOLE CARDS ***
Dealt to Hero [5c 6h]
Dealt to 713370ec 
Dealt to a2d31939 
Dealt to 5b1dc166 
Hero: folds
713370ec: folds
a2d31939: folds
Uncalled bet ($0.03) returned to 5b1dc166
*** SHOWDOWN ***
5b1dc166 collected $0.04 from pot
*** SUMMARY ***
Total pot $0.04 | Rake $0 | Jackpot $0 | Bingo $0 | Fortune $0
Seat 1: Hero folded before Flop (didn't bet)
Seat 4: 713370ec (button) folded before Flop (didn't bet)
Seat 5: a2d31939 (small blind) folded before Flop
Seat 6: 5b1dc166 (big blind) collected ($0.04)


Poker Hand #HD1144690957: Hold'em No Limit  ($0.02/$0.05) - 2023/03/03 21:21:51
Table 'NLHBlue116' 6-max Seat #1 is the button
Seat 1: Hero ($7.73 in chips)
Seat 4: 713370ec ($9.49 in chips)
Seat 5: a2d31939 ($12.88 in chips)
Seat 6: 5b1dc166 ($6.28 in chips)
713370ec: posts small blind $0.02
a2d31939: posts big blind $0.05
*** HOLE CARDS ***
Dealt to Hero [Td Qc]
Dealt to 713370ec 
Dealt to a2d31939 
Dealt to 5b1dc166 
5b1dc166: folds
Hero: folds
713370ec: folds
Uncalled bet ($0.03) returned to a2d31939
*** SHOWDOWN ***
a2d31939 collected $0.04 from pot
*** SUMMARY ***
Total pot $0.04 | Rake $0 | Jackpot $0 | Bingo $0 | Fortune $0
Seat 1: Hero (button) folded before Flop (didn't bet)
Seat 4: 713370ec (small blind) folded before Flop
Seat 5: a2d31939 (big blind) collected ($0.04)
Seat 6: 5b1dc166 folded before Flop (didn't bet)


Poker Hand #HD1144690877: Hold'em No Limit  ($0.02/$0.05) - 2023/03/03 21:21:19
Table 'NLHBlue116' 6-max Seat #6 is the button
Seat 1: Hero ($7.75 in chips)
Seat 4: 713370ec ($9.35 in chips)
Seat 5: a2d31939 ($12.88 in chips)
Seat 6: 5b1dc166 ($6.41 in chips)
Hero: posts small blind $0.02
713370ec: posts big blind $0.05
*** HOLE CARDS ***
Dealt to Hero [2c 7s]
Dealt to 713370ec 
Dealt to a2d31939 
Dealt to 5b1dc166 
a2d31939: folds
5b1dc166: raises $0.08 to $0.13
Hero: folds
713370ec: raises $0.37 to $0.5
5b1dc166: folds
Uncalled bet ($0.37) returned to 713370ec
*** SHOWDOWN ***
713370ec collected $0.27 from pot
*** SUMMARY ***
Total pot $0.28 | Rake $0.01 | Jackpot $0 | Bingo $0 | Fortune $0
Seat 1: Hero (small blind) folded before Flop
Seat 4: 713370ec (big blind) collected ($0.27)
Seat 5: a2d31939 folded before Flop (didn't bet)
Seat 6: 5b1dc166 (button) folded before Flop


Poker Hand #HD1144690818: Hold'em No Limit  ($0.02/$0.05) - 2023/03/03 21:21:00
Table 'NLHBlue116' 6-max Seat #5 is the button
Seat 1: Hero ($7.8 in chips)
Seat 2: 1d0da3a7 ($5 in chips)
Seat 3: a592735e ($5.07 in chips)
Seat 4: 713370ec ($9.35 in chips)
Seat 5: a2d31939 ($12.88 in chips)
Seat 6: 5b1dc166 ($6.43 in chips)
5b1dc166: posts small blind $0.02
Hero: posts big blind $0.05
*** HOLE CARDS ***
Dealt to Hero [2d Ts]
Dealt to 1d0da3a7 
Dealt to a592735e 
Dealt to 713370ec 
Dealt to a2d31939 
Dealt to 5b1dc166 
1d0da3a7: raises $0.08 to $0.13
a592735e: folds
713370ec: folds
a2d31939: folds
5b1dc166: folds
Hero: folds
Uncalled bet ($0.08) returned to 1d0da3a7
*** SHOWDOWN ***
1d0da3a7 collected $0.12 from pot
*** SUMMARY ***
Total pot $0.12 | Rake $0 | Jackpot $0 | Bingo $0 | Fortune $0
Seat 1: Hero (big blind) folded before Flop
Seat 2: 1d0da3a7 collected ($0.12)
Seat 3: a592735e folded before Flop (didn't bet)
Seat 4: 713370ec folded before Flop (didn't bet)
Seat 5: a2d31939 (button) folded before Flop (didn't bet)
Seat 6: 5b1dc166 (small blind) folded before Flop


Poker Hand #HD1144690773: Hold'em No Limit  ($0.02/$0.05) - 2023/03/03 21:20:41
Table 'NLHBlue116' 6-max Seat #4 is the button
Seat 1: Hero ($7.8 in chips)
Seat 2: 1d0da3a7 ($5 in chips)
Seat 3: a592735e ($5 in chips)
Seat 4: 713370ec ($9.35 in chips)
Seat 5: a2d31939 ($12.9 in chips)
Seat 6: 5b1dc166 ($6.48 in chips)
a2d31939: posts small blind $0.02
5b1dc166: posts big blind $0.05
*** HOLE CARDS ***
Dealt to Hero [3s Js]
Dealt to 1d0da3a7 
Dealt to a592735e 
Dealt to 713370ec 
Dealt to a2d31939 
Dealt to 5b1dc166 
Hero: folds
1d0da3a7: folds
a592735e: raises $0.08 to $0.13
713370ec: folds
a2d31939: folds
5b1dc166: folds
Uncalled bet ($0.08) returned to a592735e
*** SHOWDOWN ***
a592735e collected $0.12 from pot
*** SUMMARY ***
Total pot $0.12 | Rake $0 | Jackpot $0 | Bingo $0 | Fortune $0
Seat 1: Hero folded before Flop (didn't bet)
Seat 2: 1d0da3a7 folded before Flop (didn't bet)
Seat 3: a592735e collected ($0.12)
Seat 4: 713370ec (button) folded before Flop (didn't bet)
Seat 5: a2d31939 (small blind) folded before Flop
Seat 6: 5b1dc166 (big blind) folded before Flop


Poker Hand #HD1144690711: Hold'em No Limit  ($0.02/$0.05) - 2023/03/03 21:20:21
Table 'NLHBlue116' 6-max Seat #3 is the button
Seat 1: Hero ($7.8 in chips)
Seat 2: 1d0da3a7 ($5 in chips)
Seat 3: a592735e ($5 in chips)
Seat 4: 713370ec ($9.37 in chips)
Seat 5: a2d31939 ($12.88 in chips)
Seat 6: 5b1dc166 ($6.48 in chips)
713370ec: posts small blind $0.02
a2d31939: posts big blind $0.05
*** HOLE CARDS ***
Dealt to Hero [4s Td]
Dealt to 1d0da3a7 
Dealt to a592735e 
Dealt to 713370ec 
Dealt to a2d31939 
Dealt to 5b1dc166 
5b1dc166: folds
Hero: folds
1d0da3a7: folds
a592735e: folds
713370ec: folds
Uncalled bet ($0.03) returned to a2d31939
*** SHOWDOWN ***
a2d31939 collected $0.04 from pot
*** SUMMARY ***
Total pot $0.04 | Rake $0 | Jackpot $0 | Bingo $0 | Fortune $0
Seat 1: Hero folded before Flop (didn't bet)
Seat 2: 1d0da3a7 folded before Flop (didn't bet)
Seat 3: a592735e (button) folded before Flop (didn't bet)
Seat 4: 713370ec (small blind) folded before Flop
Seat 5: a2d31939 (big blind) collected ($0.04)
Seat 6: 5b1dc166 folded before Flop (didn't bet)


Poker Hand #HD1144690667: Hold'em No Limit  ($0.02/$0.05) - 2023/03/03 21:20:07
Table 'NLHBlue116' 6-max Seat #2 is the button
Seat 1: Hero ($7.8 in chips)
Seat 2: 1d0da3a7 ($5 in chips)
Seat 3: a592735e ($5 in chips)
Seat 4: 713370ec ($9.35 in chips)
Seat 5: a2d31939 ($12.88 in chips)
Seat 6: 5b1dc166 ($6.48 in chips)
a592735e: posts small blind $0.02
713370ec: posts big blind $0.05
*** HOLE CARDS ***
Dealt to Hero [9s Qh]
Dealt to 1d0da3a7 
Dealt to a592735e 
Dealt to 713370ec 
Dealt to a2d31939 
Dealt to 5b1dc166 
a2d31939: folds
5b1dc166: folds
Hero: folds
1d0da3a7: folds
a592735e: folds
Uncalled bet ($0.03) returned to 713370ec
*** SHOWDOWN ***
713370ec collected $0.04 from pot
*** SUMMARY ***
Total pot $0.04 | Rake $0 | Jackpot $0 | Bingo $0 | Fortune $0
Seat 1: Hero folded before Flop (didn't bet)
Seat 2: 1d0da3a7 (button) folded before Flop (didn't bet)
Seat 3: a592735e (small blind) folded before Flop
Seat 4: 713370ec (big blind) collected ($0.04)
Seat 5: a2d31939 folded before Flop (didn't bet)
Seat 6: 5b1dc166 folded before Flop (didn't bet)


Poker Hand #HD1144690479: Hold'em No Limit  ($0.02/$0.05) - 2023/03/03 21:18:49
Table 'NLHBlue116' 6-max Seat #1 is the button
Seat 1: Hero ($7.8 in chips)
Seat 2: 1d0da3a7 ($5.16 in chips)
Seat 3: a592735e ($5 in chips)
Seat 4: 713370ec ($9.35 in chips)
Seat 5: a2d31939 ($11.45 in chips)
Seat 6: 5b1dc166 ($6.48 in chips)
1d0da3a7: posts small blind $0.02
a592735e: posts big blind $0.05
*** HOLE CARDS ***
Dealt to Hero [3c 2h]
Dealt to 1d0da3a7 
Dealt to a592735e 
Dealt to 713370ec 
Dealt to a2d31939 
Dealt to 5b1dc166 
713370ec: folds
a2d31939: raises $0.08 to $0.13
5b1dc166: folds
Hero: folds
1d0da3a7: raises $0.29 to $0.42
a592735e: folds
a2d31939: calls $0.29
*** FLOP *** [7s Qc 3s]
1d0da3a7: bets $0.3
a2d31939: calls $0.3
*** TURN *** [7s Qc 3s] [Qh]
1d0da3a7: bets $0.86
a2d31939: calls $0.86
*** RIVER *** [7s Qc 3s Qh] [4d]
1d0da3a7: checks
a2d31939: checks
1d0da3a7: shows [Js Ks] (Pair of Queens)
a2d31939: shows [Th Td] (Pair of Queens and Pair of Tens)
*** SHOWDOWN ***
a2d31939 collected $3.01 from pot
*** SUMMARY ***
Total pot $3.21 | Rake $0.15 | Jackpot $0.05 | Bingo $0 | Fortune $0
Board [7s Qc 3s Qh 4d]
Seat 1: Hero (button) folded before Flop (didn't bet)
Seat 2: 1d0da3a7 (small blind) showed [Js Ks] and lost with Pair of Queens
Seat 3: a592735e (big blind) folded before Flop
Seat 4: 713370ec folded before Flop (didn't bet)
Seat 5: a2d31939 showed [Th Td] and won ($3.01) with Pair of Queens and Pair of Tens
Seat 6: 5b1dc166 folded before Flop (didn't bet)


Poker Hand #HD1144690354: Hold'em No Limit  ($0.02/$0.05) - 2023/03/03 21:18:01
Table 'NLHBlue116' 6-max Seat #6 is the button
Seat 1: Hero ($7.82 in chips)
Seat 2: 1d0da3a7 ($5 in chips)
Seat 3: a592735e ($5.14 in chips)
Seat 4: 713370ec ($9.35 in chips)
Seat 5: a2d31939 ($11.45 in chips)
Seat 6: 5b1dc166 ($6.48 in chips)
Hero: posts small blind $0.02
1d0da3a7: posts big blind $0.05
*** HOLE CARDS ***
Dealt to Hero [9c 7d]
Dealt to 1d0da3a7 
Dealt to a592735e 
Dealt to 713370ec 
Dealt to a2d31939 
Dealt to 5b1dc166 
a592735e: raises $0.1 to $0.15
713370ec: folds
a2d31939: folds
5b1dc166: folds
Hero: folds
1d0da3a7: calls $0.1
*** FLOP *** [9h Td 8d]
1d0da3a7: checks
a592735e: checks
*** TURN *** [9h Td 8d] [3c]
1d0da3a7: bets $0.27
a592735e: folds
Uncalled bet ($0.27) returned to 1d0da3a7
*** SHOWDOWN ***
1d0da3a7 collected $0.31 from pot
*** SUMMARY ***
Total pot $0.32 | Rake $0.01 | Jackpot $0 | Bingo $0 | Fortune $0
Board [9h Td 8d 3c]
Seat 1: Hero (small blind) folded before Flop
Seat 2: 1d0da3a7 (big blind) won ($0.31)
Seat 3: a592735e folded on the Turn
Seat 4: 713370ec folded before Flop (didn't bet)
Seat 5: a2d31939 folded before Flop (didn't bet)
Seat 6: 5b1dc166 (button) folded before Flop (didn't bet)


Poker Hand #HD1144690313: Hold'em No Limit  ($0.02/$0.05) - 2023/03/03 21:17:45
Table 'NLHBlue116' 6-max Seat #5 is the button
Seat 1: Hero ($7.87 in chips)
Seat 2: 1d0da3a7 ($5 in chips)
Seat 3: a592735e ($5.14 in chips)
Seat 4: 713370ec ($9.35 in chips)
Seat 5: a2d31939 ($11.45 in chips)
Seat 6: 5b1dc166 ($6.43 in chips)
5b1dc166: posts small blind $0.02
Hero: posts big blind $0.05
*** HOLE CARDS ***
Dealt to Hero [Kh 6c]
Dealt to 1d0da3a7 
Dealt to a592735e 
Dealt to 713370ec 
Dealt to a2d31939 
Dealt to 5b1dc166 
1d0da3a7: folds
a592735e: folds
713370ec: folds
a2d31939: folds
5b1dc166: raises $0.08 to $0.13
Hero: folds
Uncalled bet ($0.08) returned to 5b1dc166
*** SHOWDOWN ***
5b1dc166 collected $0.1 from pot
*** SUMMARY ***
Total pot $0.1 | Rake $0 | Jackpot $0 | Bingo $0 | Fortune $0
Seat 1: Hero (big blind) folded before Flop
Seat 2: 1d0da3a7 folded before Flop (didn't bet)
Seat 3: a592735e folded before Flop (didn't bet)
Seat 4: 713370ec folded before Flop (didn't bet)
Seat 5: a2d31939 (button) folded before Flop (didn't bet)
Seat 6: 5b1dc166 (small blind) collected ($0.1)


Poker Hand #HD1144690283: Hold'em No Limit  ($0.02/$0.05) - 2023/03/03 21:17:36
Table 'NLHBlue116' 6-max Seat #4 is the button
Seat 1: Hero ($7.87 in chips)
Seat 2: 1d0da3a7 ($5 in chips)
Seat 3: a592735e ($5.14 in chips)
Seat 4: 713370ec ($9.35 in chips)
Seat 5: a2d31939 ($11.47 in chips)
Seat 6: 5b1dc166 ($6.41 in chips)
a2d31939: posts small blind $0.02
5b1dc166: posts big blind $0.05
*** HOLE CARDS ***
Dealt to Hero [Ts 5h]
Dealt to 1d0da3a7 
Dealt to a592735e 
Dealt to 713370ec 
Dealt to a2d31939 
Dealt to 5b1dc166 
Hero: folds
1d0da3a7: folds
a592735e: folds
713370ec: folds
a2d31939: folds
Uncalled bet ($0.03) returned to 5b1dc166
*** SHOWDOWN ***
5b1dc166 collected $0.04 from pot
*** SUMMARY ***
Total pot $0.04 | Rake $0 | Jackpot $0 | Bingo $0 | Fortune $0
Seat 1: Hero folded before Flop (didn't bet)
Seat 2: 1d0da3a7 folded before Flop (didn't bet)
Seat 3: a592735e folded before Flop (didn't bet)
Seat 4: 713370ec (button) folded before Flop (didn't bet)
Seat 5: a2d31939 (small blind) folded before Flop
Seat 6: 5b1dc166 (big blind) collected ($0.04)


Poker Hand #HD1144690253: Hold'em No Limit  ($0.02/$0.05) - 2023/03/03 21:17:24
Table 'NLHBlue116' 6-max Seat #3 is the button
Seat 1: Hero ($7.87 in chips)
Seat 2: 1d0da3a7 ($5 in chips)
Seat 3: a592735e ($5.14 in chips)
Seat 4: 713370ec ($9.37 in chips)
Seat 5: a2d31939 ($11.45 in chips)
Seat 6: 5b1dc166 ($6.41 in chips)
713370ec: posts small blind $0.02
a2d31939: posts big blind $0.05
*** HOLE CARDS ***
Dealt to Hero [2s 7h]
Dealt to 1d0da3a7 
Dealt to a592735e 
Dealt to 713370ec 
Dealt to a2d31939 
Dealt to 5b1dc166 
5b1dc166: folds
Hero: folds
1d0da3a7: folds
a592735e: folds
713370ec: folds
Uncalled bet ($0.03) returned to a2d31939
*** SHOWDOWN ***
a2d31939 collected $0.04 from pot
*** SUMMARY ***
Total pot $0.04 | Rake $0 | Jackpot $0 | Bingo $0 | Fortune $0
Seat 1: Hero folded before Flop (didn't bet)
Seat 2: 1d0da3a7 folded before Flop (didn't bet)
Seat 3: a592735e (button) folded before Flop (didn't bet)
Seat 4: 713370ec (small blind) folded before Flop
Seat 5: a2d31939 (big blind) collected ($0.04)
Seat 6: 5b1dc166 folded before Flop (didn't bet)


Poker Hand #HD1144690200: Hold'em No Limit  ($0.02/$0.05) - 2023/03/03 21:17:06
Table 'NLHBlue116' 6-max Seat #2 is the button
Seat 1: Hero ($7.8 in chips)
Seat 2: 1d0da3a7 ($5 in chips)
Seat 3: a592735e ($5.16 in chips)
Seat 4: 713370ec ($9.42 in chips)
Seat 5: a2d31939 ($11.45 in chips)
Seat 6: 5b1dc166 ($6.41 in chips)
a592735e: posts small blind $0.02
713370ec: posts big blind $0.05
*** HOLE CARDS ***
Dealt to Hero [7h 9h]
Dealt to 1d0da3a7 
Dealt to a592735e 
Dealt to 713370ec 
Dealt to a2d31939 
Dealt to 5b1dc166 
a2d31939: folds
5b1dc166: folds
Hero: raises $0.07 to $0.12
1d0da3a7: folds
a592735e: folds
713370ec: folds
Uncalled bet ($0.07) returned to Hero
*** SHOWDOWN ***
Hero collected $0.12 from pot
*** SUMMARY ***
Total pot $0.12 | Rake $0 | Jackpot $0 | Bingo $0 | Fortune $0
Seat 1: Hero collected ($0.12)
Seat 2: 1d0da3a7 (button) folded before Flop (didn't bet)
Seat 3: a592735e (small blind) folded before Flop
Seat 4: 713370ec (big blind) folded before Flop
Seat 5: a2d31939 folded before Flop (didn't bet)
Seat 6: 5b1dc166 folded before Flop (didn't bet)


Poker Hand #HD1144690168: Hold'em No Limit  ($0.02/$0.05) - 2023/03/03 21:16:54
Table 'NLHBlue116' 6-max Seat #1 is the button
Seat 1: Hero ($7.8 in chips)
Seat 2: 1d0da3a7 ($5.02 in chips)
Seat 3: a592735e ($5.21 in chips)
Seat 4: 713370ec ($9.42 in chips)
Seat 5: a2d31939 ($11.45 in chips)
Seat 6: 5b1dc166 ($6.34 in chips)
1d0da3a7: posts small blind $0.02
a592735e: posts big blind $0.05
*** HOLE CARDS ***
Dealt to Hero [8c 7d]
Dealt to 1d0da3a7 
Dealt to a592735e 
Dealt to 713370ec 
Dealt to a2d31939 
Dealt to 5b1dc166 
713370ec: folds
a2d31939: folds
5b1dc166: raises $0.08 to $0.13
Hero: folds
1d0da3a7: folds
a592735e: folds
Uncalled bet ($0.08) returned to 5b1dc166
*** SHOWDOWN ***
5b1dc166 collected $0.12 from pot
*** SUMMARY ***
Total pot $0.12 | Rake $0 | Jackpot $0 | Bingo $0 | Fortune $0
Seat 1: Hero (button) folded before Flop (didn't bet)
Seat 2: 1d0da3a7 (small blind) folded before Flop
Seat 3: a592735e (big blind) folded before Flop
Seat 4: 713370ec folded before Flop (didn't bet)
Seat 5: a2d31939 folded before Flop (didn't bet)
Seat 6: 5b1dc166 collected ($0.12)


Poker Hand #HD1144690138: Hold'em No Limit  ($0.02/$0.05) - 2023/03/03 21:16:42
Table 'NLHBlue116' 6-max Seat #6 is the button
Seat 1: Hero ($7.82 in chips)
Seat 2: 1d0da3a7 ($5 in chips)
Seat 3: a592735e ($5.21 in chips)
Seat 4: 713370ec ($9.42 in chips)
Seat 5: a2d31939 ($11.45 in chips)
Seat 6: 5b1dc166 ($6.34 in chips)
Hero: posts small blind $0.02
1d0da3a7: posts big blind $0.05
*** HOLE CARDS ***
Dealt to Hero [4s Kh]
Dealt to 1d0da3a7 
Dealt to a592735e 
Dealt to 713370ec 
Dealt to a2d31939 
Dealt to 5b1dc166 
a592735e: folds
713370ec: folds
a2d31939: folds
5b1dc166: folds
Hero: folds
Uncalled bet ($0.03) returned to 1d0da3a7
*** SHOWDOWN ***
1d0da3a7 collected $0.04 from pot
*** SUMMARY ***
Total pot $0.04 | Rake $0 | Jackpot $0 | Bingo $0 | Fortune $0
Seat 1: Hero (small blind) folded before Flop
Seat 2: 1d0da3a7 (big blind) collected ($0.04)
Seat 3: a592735e folded before Flop (didn't bet)
Seat 4: 713370ec folded before Flop (didn't bet)
Seat 5: a2d31939 folded before Flop (didn't bet)
Seat 6: 5b1dc166 (button) folded before Flop (didn't bet)


Poker Hand #HD1144690104: Hold'em No Limit  ($0.02/$0.05) - 2023/03/03 21:16:27
Table 'NLHBlue116' 6-max Seat #5 is the button
Seat 1: Hero ($7.8 in chips)
Seat 2: 1d0da3a7 ($5 in chips)
Seat 3: a592735e ($5.21 in chips)
Seat 4: 713370ec ($9.42 in chips)
Seat 5: a2d31939 ($11.45 in chips)
Seat 6: 5b1dc166 ($6.36 in chips)
5b1dc166: posts small blind $0.02
Hero: posts big blind $0.05
*** HOLE CARDS ***
Dealt to Hero [Qc 3c]
Dealt to 1d0da3a7 
Dealt to a592735e 
Dealt to 713370ec 
Dealt to a2d31939 
Dealt to 5b1dc166 
1d0da3a7: folds
a592735e: folds
713370ec: folds
a2d31939: folds
5b1dc166: folds
Uncalled bet ($0.03) returned to Hero
*** SHOWDOWN ***
Hero collected $0.04 from pot
*** SUMMARY ***
Total pot $0.04 | Rake $0 | Jackpot $0 | Bingo $0 | Fortune $0
Seat 1: Hero (big blind) collected ($0.04)
Seat 2: 1d0da3a7 folded before Flop (didn't bet)
Seat 3: a592735e folded before Flop (didn't bet)
Seat 4: 713370ec folded before Flop (didn't bet)
Seat 5: a2d31939 (button) folded before Flop (didn't bet)
Seat 6: 5b1dc166 (small blind) folded before Flop


Poker Hand #HD1144690041: Hold'em No Limit  ($0.02/$0.05) - 2023/03/03 21:16:06
Table 'NLHBlue116' 6-max Seat #4 is the button
Seat 1: Hero ($7.8 in chips)
Seat 2: 1d0da3a7 ($5 in chips)
Seat 3: a592735e ($5.14 in chips)
Seat 4: 713370ec ($9.42 in chips)
Seat 5: a2d31939 ($11.47 in chips)
Seat 6: 5b1dc166 ($6.41 in chips)
a2d31939: posts small blind $0.02
5b1dc166: posts big blind $0.05
*** HOLE CARDS ***
Dealt to Hero [Jh 6d]
Dealt to 1d0da3a7 
Dealt to a592735e 
Dealt to 713370ec 
Dealt to a2d31939 
Dealt to 5b1dc166 
Hero: folds
1d0da3a7: folds
a592735e: raises $0.08 to $0.13
713370ec: folds
a2d31939: folds
5b1dc166: folds
Uncalled bet ($0.08) returned to a592735e
*** SHOWDOWN ***
a592735e collected $0.12 from pot
*** SUMMARY ***
Total pot $0.12 | Rake $0 | Jackpot $0 | Bingo $0 | Fortune $0
Seat 1: Hero folded before Flop (didn't bet)
Seat 2: 1d0da3a7 folded before Flop (didn't bet)
Seat 3: a592735e collected ($0.12)
Seat 4: 713370ec (button) folded before Flop (didn't bet)
Seat 5: a2d31939 (small blind) folded before Flop
Seat 6: 5b1dc166 (big blind) folded before Flop


Poker Hand #HD1144689819: Hold'em No Limit  ($0.02/$0.05) - 2023/03/03 21:14:43
Table 'NLHBlue116' 6-max Seat #3 is the button
Seat 1: Hero ($8.16 in chips)
Seat 2: 1d0da3a7 ($5 in chips)
Seat 3: a592735e ($5.14 in chips)
Seat 4: 713370ec ($9.44 in chips)
Seat 5: a2d31939 ($11.12 in chips)
Seat 6: 5b1dc166 ($6.41 in chips)
713370ec: posts small blind $0.02
a2d31939: posts big blind $0.05
*** HOLE CARDS ***
Dealt to Hero [7c 7d]
Dealt to 1d0da3a7 
Dealt to a592735e 
Dealt to 713370ec 
Dealt to a2d31939 
Dealt to 5b1dc166 
5b1dc166: folds
Hero: raises $0.05 to $0.1
1d0da3a7: folds
a592735e: folds
713370ec: folds
a2d31939: calls $0.05
*** FLOP *** [Js 2s Ah]
a2d31939: checks
Hero: bets $0.11
a2d31939: calls $0.11
*** TURN *** [Js 2s Ah] [Jc]
a2d31939: checks
Hero: checks
*** RIVER *** [Js 2s Ah Jc] [9s]
a2d31939: bets $0.15
Hero: calls $0.15
a2d31939: shows [Qh Ad] (Pair of Aces and Pair of Jacks)
Hero: shows [7c 7d] (Pair of Jacks and Pair of Sevens)
*** SHOWDOWN ***
a2d31939 collected $0.71 from pot
*** SUMMARY ***
Total pot $0.74 | Rake $0.03 | Jackpot $0 | Bingo $0 | Fortune $0
Board [Js 2s Ah Jc 9s]
Seat 1: Hero showed [7c 7d] and lost with Pair of Jacks and Pair of Sevens
Seat 2: 1d0da3a7 folded before Flop (didn't bet)
Seat 3: a592735e (button) folded before Flop (didn't bet)
Seat 4: 713370ec (small blind) folded before Flop
Seat 5: a2d31939 (big blind) showed [Qh Ad] and won ($0.71) with Pair of Aces and Pair of Jacks
Seat 6: 5b1dc166 folded before Flop (didn't bet)


Poker Hand #HD1144689743: Hold'em No Limit  ($0.02/$0.05) - 2023/03/03 21:14:16
Table 'NLHBlue116' 6-max Seat #2 is the button
Seat 1: Hero ($8.16 in chips)
Seat 2: 1d0da3a7 ($5 in chips)
Seat 3: a592735e ($5.16 in chips)
Seat 4: 713370ec ($9.49 in chips)
Seat 5: a2d31939 ($11.05 in chips)
Seat 6: 5b1dc166 ($6.41 in chips)
a592735e: posts small blind $0.02
713370ec: posts big blind $0.05
*** HOLE CARDS ***
Dealt to Hero [Kc 8h]
Dealt to 1d0da3a7 
Dealt to a592735e 
Dealt to 713370ec 
Dealt to a2d31939 
Dealt to 5b1dc166 
a2d31939: raises $0.08 to $0.13
5b1dc166: folds
Hero: folds
1d0da3a7: folds
a592735e: folds
713370ec: folds
Uncalled bet ($0.08) returned to a2d31939
*** SHOWDOWN ***
a2d31939 collected $0.12 from pot
*** SUMMARY ***
Total pot $0.12 | Rake $0 | Jackpot $0 | Bingo $0 | Fortune $0
Seat 1: Hero folded before Flop (didn't bet)
Seat 2: 1d0da3a7 (button) folded before Flop (didn't bet)
Seat 3: a592735e (small blind) folded before Flop
Seat 4: 713370ec (big blind) folded before Flop
Seat 5: a2d31939 collected ($0.12)
Seat 6: 5b1dc166 folded before Flop (didn't bet)


Poker Hand #HD1144689638: Hold'em No Limit  ($0.02/$0.05) - 2023/03/03 21:13:37
Table 'NLHBlue116' 6-max Seat #1 is the button
Seat 1: Hero ($7.95 in chips)
Seat 2: 1d0da3a7 ($5 in chips)
Seat 3: a592735e ($5.21 in chips)
Seat 4: 713370ec ($9.64 in chips)
Seat 5: a2d31939 ($11.05 in chips)
Seat 6: 5b1dc166 ($6.41 in chips)
1d0da3a7: posts small blind $0.02
a592735e: posts big blind $0.05
*** HOLE CARDS ***
Dealt to Hero [Qd Ad]
Dealt to 1d0da3a7 
Dealt to a592735e 
Dealt to 713370ec 
Dealt to a2d31939 
Dealt to 5b1dc166 
713370ec: raises $0.1 to $0.15
a2d31939: folds
5b1dc166: folds
Hero: raises $0.27 to $0.42
1d0da3a7: folds
a592735e: folds
713370ec: folds
Uncalled bet ($0.27) returned to Hero
*** SHOWDOWN ***
Hero collected $0.36 from pot
*** SUMMARY ***
Total pot $0.37 | Rake $0.01 | Jackpot $0 | Bingo $0 | Fortune $0
Seat 1: Hero (button) collected ($0.36)
Seat 2: 1d0da3a7 (small blind) folded before Flop
Seat 3: a592735e (big blind) folded before Flop
Seat 4: 713370ec folded before Flop
Seat 5: a2d31939 folded before Flop (didn't bet)
Seat 6: 5b1dc166 folded before Flop (didn't bet)


Poker Hand #HD1144689486: Hold'em No Limit  ($0.02/$0.05) - 2023/03/03 21:12:38
Table 'NLHBlue116' 6-max Seat #6 is the button
Seat 1: Hero ($7.97 in chips)
Seat 2: 1d0da3a7 ($5.05 in chips)
Seat 3: a592735e ($5 in chips)
Seat 4: 713370ec ($9.79 in chips)
Seat 5: a2d31939 ($11.05 in chips)
Seat 6: 5b1dc166 ($6.41 in chips)
Hero: posts small blind $0.02
1d0da3a7: posts big blind $0.05
*** HOLE CARDS ***
Dealt to Hero [As 2d]
Dealt to 1d0da3a7 
Dealt to a592735e 
Dealt to 713370ec 
Dealt to a2d31939 
Dealt to 5b1dc166 
a592735e: raises $0.1 to $0.15
713370ec: calls $0.15
a2d31939: folds
5b1dc166: folds
Hero: folds
1d0da3a7: folds
*** FLOP *** [7s Jd Kc]
a592735e: bets $0.14
713370ec: folds
Uncalled bet ($0.14) returned to a592735e
*** SHOWDOWN ***
a592735e collected $0.36 from pot
*** SUMMARY ***
Total pot $0.37 | Rake $0.01 | Jackpot $0 | Bingo $0 | Fortune $0
Board [7s Jd Kc]
Seat 1: Hero (small blind) folded before Flop
Seat 2: 1d0da3a7 (big blind) folded before Flop
Seat 3: a592735e won ($0.36)
Seat 4: 713370ec folded on the Flop
Seat 5: a2d31939 folded before Flop (didn't bet)
Seat 6: 5b1dc166 (button) folded before Flop (didn't bet)


Poker Hand #HD1144689384: Hold'em No Limit  ($0.02/$0.05) - 2023/03/03 21:12:02
Table 'NLHBlue116' 6-max Seat #5 is the button
Seat 1: Hero ($8.02 in chips)
Seat 2: 1d0da3a7 ($5.05 in chips)
Seat 3: a592735e ($5 in chips)
Seat 4: 713370ec ($10.31 in chips)
Seat 5: a2d31939 ($11.05 in chips)
Seat 6: 5b1dc166 ($5.75 in chips)
5b1dc166: posts small blind $0.02
Hero: posts big blind $0.05
*** HOLE CARDS ***
Dealt to Hero [2h 9h]
Dealt to 1d0da3a7 
Dealt to a592735e 
Dealt to 713370ec 
Dealt to a2d31939 
Dealt to 5b1dc166 
1d0da3a7: folds
a592735e: raises $0.1 to $0.15
713370ec: raises $0.37 to $0.52
a2d31939: folds
5b1dc166: raises $1.24 to $1.76
Hero: folds
a592735e: folds
713370ec: folds
Uncalled bet ($1.24) returned to 5b1dc166
*** SHOWDOWN ***
5b1dc166 collected $1.18 from pot
*** SUMMARY ***
Total pot $1.24 | Rake $0.06 | Jackpot $0 | Bingo $0 | Fortune $0
Seat 1: Hero (big blind) folded before Flop
Seat 2: 1d0da3a7 folded before Flop (didn't bet)
Seat 3: a592735e folded before Flop
Seat 4: 713370ec folded before Flop
Seat 5: a2d31939 (button) folded before Flop (didn't bet)
Seat 6: 5b1dc166 (small blind) collected ($1.18)


Poker Hand #HD1144689156: Hold'em No Limit  ($0.02/$0.05) - 2023/03/03 21:10:36
Table 'NLHBlue116' 6-max Seat #4 is the button
Seat 1: Hero ($8.02 in chips)
Seat 2: 1d0da3a7 ($5.05 in chips)
Seat 3: a592735e ($5.15 in chips)
Seat 4: 713370ec ($10.31 in chips)
Seat 5: a2d31939 ($11.07 in chips)
Seat 6: 5b1dc166 ($6.01 in chips)
a2d31939: posts small blind $0.02
5b1dc166: posts big blind $0.05
*** HOLE CARDS ***
Dealt to Hero [Qc 4s]
Dealt to 1d0da3a7 
Dealt to a592735e 
Dealt to 713370ec 
Dealt to a2d31939 
Dealt to 5b1dc166 
Hero: folds
1d0da3a7: folds
a592735e: raises $0.08 to $0.13
713370ec: folds
a2d31939: folds
5b1dc166: calls $0.08
*** FLOP *** [9h 7s Ts]
5b1dc166: checks
a592735e: bets $0.28
5b1dc166: raises $0.58 to $0.86
a592735e: raises $1.1 to $1.96
5b1dc166: raises $3.92 to $5.88 and is all-in
a592735e: calls $3.06 and is all-in
Uncalled bet ($0.86) returned to 5b1dc166
5b1dc166: shows [8s As] (Ace-High)
a592735e: shows [9d 9s] (Three Nines)
*** FIRST TURN *** [9h 7s Ts] [Kh]
*** FIRST RIVER *** [9h 7s Ts Kh] [Th]
*** SECOND TURN *** [9h 7s Ts] [6c]
*** SECOND RIVER *** [9h 7s Ts 6c] [2s]
*** FIRST SHOWDOWN ***
a592735e collected $4.88 from pot
*** SECOND SHOWDOWN ***
5b1dc166 collected $4.89 from pot
*** SUMMARY ***
Total pot $10.32 | Rake $0.5 | Jackpot $0.05 | Bingo $0 | Fortune $0
Hand was run two times
FIRST Board [9h 7s Ts Kh Th]
SECOND Board [6c 2s]
Seat 1: Hero folded before Flop (didn't bet)
Seat 2: 1d0da3a7 folded before Flop (didn't bet)
Seat 3: a592735e showed [9d 9s] and won ($4.88) with Nines Full over Tens, and lost
Seat 4: 713370ec (button) folded before Flop (didn't bet)
Seat 5: a2d31939 (small blind) folded before Flop
Seat 6: 5b1dc166 (big blind) showed [8s As] and lost with Pair of Tens, and won ($4.89)


Poker Hand #HD1144689100: Hold'em No Limit  ($0.02/$0.05) - 2023/03/03 21:10:15
Table 'NLHBlue116' 6-max Seat #3 is the button
Seat 1: Hero ($8.02 in chips)
Seat 2: 1d0da3a7 ($5.05 in chips)
Seat 3: a592735e ($5.15 in chips)
Seat 4: 713370ec ($10.33 in chips)
Seat 5: a2d31939 ($11.05 in chips)
Seat 6: 5b1dc166 ($6.01 in chips)
713370ec: posts small blind $0.02
a2d31939: posts big blind $0.05
*** HOLE CARDS ***
Dealt to Hero [2s 8c]
Dealt to 1d0da3a7 
Dealt to a592735e 
Dealt to 713370ec 
Dealt to a2d31939 
Dealt to 5b1dc166 
5b1dc166: folds
Hero: folds
1d0da3a7: folds
a592735e: folds
713370ec: folds
Uncalled bet ($0.03) returned to a2d31939
*** SHOWDOWN ***
a2d31939 collected $0.04 from pot
*** SUMMARY ***
Total pot $0.04 | Rake $0 | Jackpot $0 | Bingo $0 | Fortune $0
Seat 1: Hero folded before Flop (didn't bet)
Seat 2: 1d0da3a7 folded before Flop (didn't bet)
Seat 3: a592735e (button) folded before Flop (didn't bet)
Seat 4: 713370ec (small blind) folded before Flop
Seat 5: a2d31939 (big blind) collected ($0.04)
Seat 6: 5b1dc166 folded before Flop (didn't bet)


Poker Hand #HD1144689056: Hold'em No Limit  ($0.02/$0.05) - 2023/03/03 21:09:58
Table 'NLHBlue116' 6-max Seat #2 is the button
Seat 1: Hero ($8.02 in chips)
Seat 2: 1d0da3a7 ($5.05 in chips)
Seat 3: a592735e ($5.17 in chips)
Seat 4: 713370ec ($10.31 in chips)
Seat 5: a2d31939 ($11.05 in chips)
Seat 6: 5b1dc166 ($6.01 in chips)
a592735e: posts small blind $0.02
713370ec: posts big blind $0.05
*** HOLE CARDS ***
Dealt to Hero [Th 2s]
Dealt to 1d0da3a7 
Dealt to a592735e 
Dealt to 713370ec 
Dealt to a2d31939 
Dealt to 5b1dc166 
a2d31939: folds
5b1dc166: folds
Hero: folds
1d0da3a7: folds
a592735e: folds
Uncalled bet ($0.03) returned to 713370ec
*** SHOWDOWN ***
713370ec collected $0.04 from pot
*** SUMMARY ***
Total pot $0.04 | Rake $0 | Jackpot $0 | Bingo $0 | Fortune $0
Seat 1: Hero folded before Flop (didn't bet)
Seat 2: 1d0da3a7 (button) folded before Flop (didn't bet)
Seat 3: a592735e (small blind) folded before Flop
Seat 4: 713370ec (big blind) collected ($0.04)
Seat 5: a2d31939 folded before Flop (didn't bet)
Seat 6: 5b1dc166 folded before Flop (didn't bet)


Poker Hand #HD1144689014: Hold'em No Limit  ($0.02/$0.05) - 2023/03/03 21:09:43
Table 'NLHBlue116' 6-max Seat #1 is the button
Seat 1: Hero ($8.02 in chips)
Seat 2: 1d0da3a7 ($5.07 in chips)
Seat 3: a592735e ($5.15 in chips)
Seat 4: 713370ec ($10.31 in chips)
Seat 5: a2d31939 ($11.05 in chips)
Seat 6: 5b1dc166 ($6.01 in chips)
1d0da3a7: posts small blind $0.02
a592735e: posts big blind $0.05
*** HOLE CARDS ***
Dealt to Hero [8h 3h]
Dealt to 1d0da3a7 
Dealt to a592735e 
Dealt to 713370ec 
Dealt to a2d31939 
Dealt to 5b1dc166 
713370ec: folds
a2d31939: folds
5b1dc166: folds
Hero: folds
1d0da3a7: folds
Uncalled bet ($0.03) returned to a592735e
*** SHOWDOWN ***
a592735e collected $0.04 from pot
*** SUMMARY ***
Total pot $0.04 | Rake $0 | Jackpot $0 | Bingo $0 | Fortune $0
Seat 1: Hero (button) folded before Flop (didn't bet)
Seat 2: 1d0da3a7 (small blind) folded before Flop
Seat 3: a592735e (big blind) collected ($0.04)
Seat 4: 713370ec folded before Flop (didn't bet)
Seat 5: a2d31939 folded before Flop (didn't bet)
Seat 6: 5b1dc166 folded before Flop (didn't bet)


Poker Hand #HD1144688964: Hold'em No Limit  ($0.02/$0.05) - 2023/03/03 21:09:24
Table 'NLHBlue116' 6-max Seat #6 is the button
Seat 1: Hero ($7.85 in chips)
Seat 2: 1d0da3a7 ($5.12 in chips)
Seat 3: a592735e ($5.15 in chips)
Seat 4: 713370ec ($10.31 in chips)
Seat 5: a2d31939 ($11.18 in chips)
Seat 6: 5b1dc166 ($6.01 in chips)
Hero: posts small blind $0.02
1d0da3a7: posts big blind $0.05
*** HOLE CARDS ***
Dealt to Hero [Ad Qh]
Dealt to 1d0da3a7 
Dealt to a592735e 
Dealt to 713370ec 
Dealt to a2d31939 
Dealt to 5b1dc166 
a592735e: folds
713370ec: folds
a2d31939: raises $0.08 to $0.13
5b1dc166: folds
Hero: raises $0.37 to $0.5
1d0da3a7: folds
a2d31939: folds
Uncalled bet ($0.37) returned to Hero
*** SHOWDOWN ***
Hero collected $0.3 from pot
*** SUMMARY ***
Total pot $0.31 | Rake $0.01 | Jackpot $0 | Bingo $0 | Fortune $0
Seat 1: Hero (small blind) collected ($0.3)
Seat 2: 1d0da3a7 (big blind) folded before Flop
Seat 3: a592735e folded before Flop (didn't bet)
Seat 4: 713370ec folded before Flop (didn't bet)
Seat 5: a2d31939 folded before Flop
Seat 6: 5b1dc166 (button) folded before Flop (didn't bet)


Poker Hand #HD1144688949: Hold'em No Limit  ($0.02/$0.05) - 2023/03/03 21:09:17
Table 'NLHBlue116' 6-max Seat #5 is the button
Seat 1: Hero ($7.83 in chips)
Seat 2: 1d0da3a7 ($5.12 in chips)
Seat 3: a592735e ($5.15 in chips)
Seat 4: 713370ec ($10.31 in chips)
Seat 5: a2d31939 ($11.18 in chips)
Seat 6: 5b1dc166 ($6.03 in chips)
5b1dc166: posts small blind $0.02
Hero: posts big blind $0.05
*** HOLE CARDS ***
Dealt to Hero [Tc 5d]
Dealt to 1d0da3a7 
Dealt to a592735e 
Dealt to 713370ec 
Dealt to a2d31939 
Dealt to 5b1dc166 
1d0da3a7: folds
a592735e: folds
713370ec: folds
a2d31939: folds
5b1dc166: folds
Uncalled bet ($0.03) returned to Hero
*** SHOWDOWN ***
Hero collected $0.04 from pot
*** SUMMARY ***
Total pot $0.04 | Rake $0 | Jackpot $0 | Bingo $0 | Fortune $0
Seat 1: Hero (big blind) collected ($0.04)
Seat 2: 1d0da3a7 folded before Flop (didn't bet)
Seat 3: a592735e folded before Flop (didn't bet)
Seat 4: 713370ec folded before Flop (didn't bet)
Seat 5: a2d31939 (button) folded before Flop (didn't bet)
Seat 6: 5b1dc166 (small blind) folded before Flop


Poker Hand #HD1144688825: Hold'em No Limit  ($0.02/$0.05) - 2023/03/03 21:08:31
Table 'NLHBlue116' 6-max Seat #4 is the button
Seat 1: Hero ($7.83 in chips)
Seat 2: 1d0da3a7 ($5.12 in chips)
Seat 3: a592735e ($5.15 in chips)
Seat 4: 713370ec ($10.46 in chips)
Seat 5: a2d31939 ($11.2 in chips)
Seat 6: 5b1dc166 ($5.87 in chips)
a2d31939: posts small blind $0.02
5b1dc166: posts big blind $0.05
*** HOLE CARDS ***
Dealt to Hero [Qc 5c]
Dealt to 1d0da3a7 
Dealt to a592735e 
Dealt to 713370ec 
Dealt to a2d31939 
Dealt to 5b1dc166 
Hero: folds
1d0da3a7: folds
a592735e: folds
713370ec: raises $0.1 to $0.15
a2d31939: folds
5b1dc166: raises $0.35 to $0.5
713370ec: folds
Uncalled bet ($0.35) returned to 5b1dc166
*** SHOWDOWN ***
5b1dc166 collected $0.31 from pot
*** SUMMARY ***
Total pot $0.32 | Rake $0.01 | Jackpot $0 | Bingo $0 | Fortune $0
Seat 1: Hero folded before Flop (didn't bet)
Seat 2: 1d0da3a7 folded before Flop (didn't bet)
Seat 3: a592735e folded before Flop (didn't bet)
Seat 4: 713370ec (button) folded before Flop
Seat 5: a2d31939 (small blind) folded before Flop
Seat 6: 5b1dc166 (big blind) collected ($0.31)


Poker Hand #HD1144688782: Hold'em No Limit  ($0.02/$0.05) - 2023/03/03 21:08:12
Table 'NLHBlue116' 6-max Seat #3 is the button
Seat 1: Hero ($7.83 in chips)
Seat 2: 1d0da3a7 ($5.12 in chips)
Seat 3: a592735e ($5.08 in chips)
Seat 4: 713370ec ($10.48 in chips)
Seat 5: a2d31939 ($11.25 in chips)
Seat 6: 5b1dc166 ($5.87 in chips)
713370ec: posts small blind $0.02
a2d31939: posts big blind $0.05
*** HOLE CARDS ***
Dealt to Hero [7h 4h]
Dealt to 1d0da3a7 
Dealt to a592735e 
Dealt to 713370ec 
Dealt to a2d31939 
Dealt to 5b1dc166 
5b1dc166: folds
Hero: folds
1d0da3a7: folds
a592735e: raises $0.08 to $0.13
713370ec: folds
a2d31939: folds
Uncalled bet ($0.08) returned to a592735e
*** SHOWDOWN ***
a592735e collected $0.12 from pot
*** SUMMARY ***
Total pot $0.12 | Rake $0 | Jackpot $0 | Bingo $0 | Fortune $0
Seat 1: Hero folded before Flop (didn't bet)
Seat 2: 1d0da3a7 folded before Flop (didn't bet)
Seat 3: a592735e (button) collected ($0.12)
Seat 4: 713370ec (small blind) folded before Flop
Seat 5: a2d31939 (big blind) folded before Flop
Seat 6: 5b1dc166 folded before Flop (didn't bet)


Poker Hand #HD1144688743: Hold'em No Limit  ($0.02/$0.05) - 2023/03/03 21:07:57
Table 'NLHBlue116' 6-max Seat #2 is the button
Seat 1: Hero ($7.83 in chips)
Seat 2: 1d0da3a7 ($5.12 in chips)
Seat 3: a592735e ($5.03 in chips)
Seat 4: 713370ec ($10.53 in chips)
Seat 5: a2d31939 ($11.25 in chips)
Seat 6: 5b1dc166 ($5.87 in chips)
a592735e: posts small blind $0.02
713370ec: posts big blind $0.05
*** HOLE CARDS ***
Dealt to Hero [5h 7c]
Dealt to 1d0da3a7 
Dealt to a592735e 
Dealt to 713370ec 
Dealt to a2d31939 
Dealt to 5b1dc166 
a2d31939: folds
5b1dc166: folds
Hero: folds
1d0da3a7: folds
a592735e: raises $0.08 to $0.13
713370ec: folds
Uncalled bet ($0.08) returned to a592735e
*** SHOWDOWN ***
a592735e collected $0.1 from pot
*** SUMMARY ***
Total pot $0.1 | Rake $0 | Jackpot $0 | Bingo $0 | Fortune $0
Seat 1: Hero folded before Flop (didn't bet)
Seat 2: 1d0da3a7 (button) folded before Flop (didn't bet)
Seat 3: a592735e (small blind) collected ($0.1)
Seat 4: 713370ec (big blind) folded before Flop
Seat 5: a2d31939 folded before Flop (didn't bet)
Seat 6: 5b1dc166 folded before Flop (didn't bet)


Poker Hand #HD1144688530: Hold'em No Limit  ($0.02/$0.05) - 2023/03/03 21:06:34
Table 'NLHBlue116' 6-max Seat #1 is the button
Seat 1: Hero ($5.95 in chips)
Seat 2: 1d0da3a7 ($5.14 in chips)
Seat 3: a592735e ($5.08 in chips)
Seat 4: 713370ec ($10.53 in chips)
Seat 5: a2d31939 ($13.31 in chips)
Seat 6: 5b1dc166 ($5.87 in chips)
1d0da3a7: posts small blind $0.02
a592735e: posts big blind $0.05
*** HOLE CARDS ***
Dealt to Hero [Ks Kc]
Dealt to 1d0da3a7 
Dealt to a592735e 
Dealt to 713370ec 
Dealt to a2d31939 
Dealt to 5b1dc166 
713370ec: folds
a2d31939: raises $0.08 to $0.13
5b1dc166: folds
Hero: raises $0.25 to $0.38
1d0da3a7: folds
a592735e: folds
a2d31939: calls $0.25
*** FLOP *** [9s 8c 4s]
a2d31939: checks
Hero: bets $0.42
a2d31939: calls $0.42
*** TURN *** [9s 8c 4s] [9d]
a2d31939: checks
Hero: checks
*** RIVER *** [9s 8c 4s 9d] [Kd]
a2d31939: checks
Hero: bets $1.26
a2d31939: calls $1.26
Hero: shows [Ks Kc] (Kings Full over Nines)
a2d31939: shows [Ad Qs] (Pair of Nines)
*** SHOWDOWN ***
Hero collected $3.94 from pot
*** SUMMARY ***
Total pot $4.19 | Rake $0.2 | Jackpot $0.05 | Bingo $0 | Fortune $0
Board [9s 8c 4s 9d Kd]
Seat 1: Hero (button) showed [Ks Kc] and won ($3.94) with Kings Full over Nines
Seat 2: 1d0da3a7 (small blind) folded before Flop
Seat 3: a592735e (big blind) folded before Flop
Seat 4: 713370ec folded before Flop (didn't bet)
Seat 5: a2d31939 showed [Ad Qs] and lost with Pair of Nines
Seat 6: 5b1dc166 folded before Flop (didn't bet)


Poker Hand #HD1144688398: Hold'em No Limit  ($0.02/$0.05) - 2023/03/03 21:05:47
Table 'NLHBlue116' 6-max Seat #6 is the button
Seat 1: Hero ($5 in chips)
Seat 2: 1d0da3a7 ($5.29 in chips)
Seat 3: a592735e ($6.03 in chips)
Seat 4: 713370ec ($10.53 in chips)
Seat 5: a2d31939 ($13.31 in chips)
Seat 6: 5b1dc166 ($5.87 in chips)
Hero: posts small blind $0.02
1d0da3a7: posts big blind $0.05
*** HOLE CARDS ***
Dealt to Hero [8s 8d]
Dealt to 1d0da3a7 
Dealt to a592735e 
Dealt to 713370ec 
Dealt to a2d31939 
Dealt to 5b1dc166 
a592735e: raises $0.1 to $0.15
713370ec: folds
a2d31939: folds
5b1dc166: folds
Hero: calls $0.13
1d0da3a7: calls $0.1
*** FLOP *** [2s 5h 2d]
Hero: checks
1d0da3a7: checks
a592735e: bets $0.26
Hero: calls $0.26
1d0da3a7: folds
*** TURN *** [2s 5h 2d] [Td]
Hero: checks
a592735e: bets $0.54
Hero: calls $0.54
*** RIVER *** [2s 5h 2d Td] [5d]
Hero: checks
a592735e: checks
Hero: shows [8s 8d] (Pair of Eights and Pair of Fives)
a592735e: shows [6h 6d] (Pair of Sixes and Pair of Fives)
*** SHOWDOWN ***
Hero collected $1.9 from pot
*** SUMMARY ***
Total pot $2.05 | Rake $0.1 | Jackpot $0.05 | Bingo $0 | Fortune $0
Board [2s 5h 2d Td 5d]
Seat 1: Hero (small blind) showed [8s 8d] and won ($1.9) with Pair of Eights and Pair of Fives
Seat 2: 1d0da3a7 (big blind) folded on the Flop
Seat 3: a592735e showed [6h 6d] and lost with Pair of Sixes and Pair of Fives
Seat 4: 713370ec folded before Flop (didn't bet)
Seat 5: a2d31939 folded before Flop (didn't bet)
Seat 6: 5b1dc166 (button) folded before Flop (didn't bet)


Poker Hand #HD1144688354: Hold'em No Limit  ($0.02/$0.05) - 2023/03/03 21:05:31
Table 'NLHBlue116' 6-max Seat #5 is the button
Seat 1: Hero ($5 in chips)
Seat 2: 1d0da3a7 ($5.29 in chips)
Seat 3: a592735e ($6.03 in chips)
Seat 4: 713370ec ($10.53 in chips)
Seat 5: a2d31939 ($13.31 in chips)
Seat 6: 5b1dc166 ($5.82 in chips)
5b1dc166: posts small blind $0.02
Hero: posts big blind $0.05
*** HOLE CARDS ***
Dealt to Hero [4s 9s]
Dealt to 1d0da3a7 
Dealt to a592735e 
Dealt to 713370ec 
Dealt to a2d31939 
Dealt to 5b1dc166 
1d0da3a7: folds
a592735e: folds
713370ec: folds
a2d31939: folds
5b1dc166: raises $0.08 to $0.13
Hero: folds
Uncalled bet ($0.08) returned to 5b1dc166
*** SHOWDOWN ***
5b1dc166 collected $0.1 from pot
*** SUMMARY ***
Total pot $0.1 | Rake $0 | Jackpot $0 | Bingo $0 | Fortune $0
Seat 1: Hero (big blind) folded before Flop
Seat 2: 1d0da3a7 folded before Flop (didn't bet)
Seat 3: a592735e folded before Flop (didn't bet)
Seat 4: 713370ec folded before Flop (didn't bet)
Seat 5: a2d31939 (button) folded before Flop (didn't bet)
Seat 6: 5b1dc166 (small blind) collected ($0.1)


Poker Hand #HD1144688229: Hold'em No Limit  ($0.02/$0.05) - 2023/03/03 21:04:44
Table 'NLHBlue116' 6-max Seat #4 is the button
Seat 1: Hero ($5 in chips)
Seat 2: 1d0da3a7 ($5.29 in chips)
Seat 3: a592735e ($6.16 in chips)
Seat 4: 713370ec ($10.53 in chips)
Seat 5: a2d31939 ($13.14 in chips)
Seat 6: 5b1dc166 ($5.87 in chips)
a2d31939: posts small blind $0.02
5b1dc166: posts big blind $0.05
*** HOLE CARDS ***
Dealt to Hero [2d 5h]
Dealt to 1d0da3a7 
Dealt to a592735e 
Dealt to 713370ec 
Dealt to a2d31939 
Dealt to 5b1dc166 
Hero: folds
1d0da3a7: folds
a592735e: raises $0.08 to $0.13
713370ec: folds
a2d31939: raises $0.4 to $0.53
5b1dc166: folds
a592735e: folds
Uncalled bet ($0.4) returned to a2d31939
*** SHOWDOWN ***
a2d31939 collected $0.3 from pot
*** SUMMARY ***
Total pot $0.31 | Rake $0.01 | Jackpot $0 | Bingo $0 | Fortune $0
Seat 1: Hero folded before Flop (didn't bet)
Seat 2: 1d0da3a7 folded before Flop (didn't bet)
Seat 3: a592735e folded before Flop
Seat 4: 713370ec (button) folded before Flop (didn't bet)
Seat 5: a2d31939 (small blind) collected ($0.3)
Seat 6: 5b1dc166 (big blind) folded before Flop


Poker Hand #HD1144688195: Hold'em No Limit  ($0.02/$0.05) - 2023/03/03 21:04:34
Table 'NLHBlue116' 6-max Seat #3 is the button
Seat 1: Hero ($5 in chips)
Seat 2: 1d0da3a7 ($5.29 in chips)
Seat 3: a592735e ($6.16 in chips)
Seat 4: 713370ec ($10.55 in chips)
Seat 5: a2d31939 ($13.12 in chips)
Seat 6: 5b1dc166 ($5.87 in chips)
713370ec: posts small blind $0.02
a2d31939: posts big blind $0.05
*** HOLE CARDS ***
Dealt to Hero [4s 8c]
Dealt to 1d0da3a7 
Dealt to a592735e 
Dealt to 713370ec 
Dealt to a2d31939 
Dealt to 5b1dc166 
5b1dc166: folds
Hero: folds
1d0da3a7: folds
a592735e: folds
713370ec: folds
Uncalled bet ($0.03) returned to a2d31939
*** SHOWDOWN ***
a2d31939 collected $0.04 from pot
*** SUMMARY ***
Total pot $0.04 | Rake $0 | Jackpot $0 | Bingo $0 | Fortune $0
Seat 1: Hero folded before Flop (didn't bet)
Seat 2: 1d0da3a7 folded before Flop (didn't bet)
Seat 3: a592735e (button) folded before Flop (didn't bet)
Seat 4: 713370ec (small blind) folded before Flop
Seat 5: a2d31939 (big blind) collected ($0.04)
Seat 6: 5b1dc166 folded before Flop (didn't bet)


Poker Hand #HD1144688071: Hold'em No Limit  ($0.02/$0.05) - 2023/03/03 21:03:52
Table 'NLHBlue116' 6-max Seat #2 is the button
Seat 1: Hero ($5 in chips)
Seat 2: 1d0da3a7 ($5.29 in chips)
Seat 3: a592735e ($6.18 in chips)
Seat 4: 713370ec ($10.53 in chips)
Seat 5: a2d31939 ($13.12 in chips)
Seat 6: 5b1dc166 ($5.87 in chips)
a592735e: posts small blind $0.02
713370ec: posts big blind $0.05
*** HOLE CARDS ***
Dealt to Hero [8h Qd]
Dealt to 1d0da3a7 
Dealt to a592735e 
Dealt to 713370ec 
Dealt to a2d31939 
Dealt to 5b1dc166 
a2d31939: folds
5b1dc166: folds
Hero: folds
1d0da3a7: folds
a592735e: folds
Uncalled bet ($0.03) returned to 713370ec
*** SHOWDOWN ***
713370ec collected $0.04 from pot
*** SUMMARY ***
Total pot $0.04 | Rake $0 | Jackpot $0 | Bingo $0 | Fortune $0
Seat 1: Hero folded before Flop (didn't bet)
Seat 2: 1d0da3a7 (button) folded before Flop (didn't bet)
Seat 3: a592735e (small blind) folded before Flop
Seat 4: 713370ec (big blind) collected ($0.04)
Seat 5: a2d31939 folded before Flop (didn't bet)
Seat 6: 5b1dc166 folded before Flop (didn't bet)


Poker Hand #HD1144687920: Hold'em No Limit  ($0.02/$0.05) - 2023/03/03 21:02:58
Table 'NLHBlue116' 6-max Seat #1 is the button
Seat 1: Hero ($5.11 in chips)
Seat 2: 1d0da3a7 ($5.31 in chips)
Seat 3: a592735e ($5.96 in chips)
Seat 4: 713370ec ($10.53 in chips)
Seat 5: a2d31939 ($13.12 in chips)
Seat 6: 5b1dc166 ($5.87 in chips)
1d0da3a7: posts small blind $0.02
a592735e: posts big blind $0.05
*** HOLE CARDS ***
Dealt to Hero [5h 6h]
Dealt to 1d0da3a7 
Dealt to a592735e 
Dealt to 713370ec 
Dealt to a2d31939 
Dealt to 5b1dc166 
713370ec: folds
a2d31939: folds
5b1dc166: folds
Hero: raises $0.07 to $0.12
1d0da3a7: folds
a592735e: calls $0.07
*** FLOP *** [4s Tc 8d]
a592735e: checks
Hero: checks
*** TURN *** [4s Tc 8d] [2h]
a592735e: bets $0.1
Hero: calls $0.1
*** RIVER *** [4s Tc 8d 2h] [Ts]
a592735e: bets $0.26
Hero: folds
Uncalled bet ($0.26) returned to a592735e
*** SHOWDOWN ***
a592735e collected $0.44 from pot
*** SUMMARY ***
Total pot $0.46 | Rake $0.02 | Jackpot $0 | Bingo $0 | Fortune $0
Board [4s Tc 8d 2h Ts]
Seat 1: Hero (button) folded on the River
Seat 2: 1d0da3a7 (small blind) folded before Flop
Seat 3: a592735e (big blind) won ($0.44)
Seat 4: 713370ec folded before Flop (didn't bet)
Seat 5: a2d31939 folded before Flop (didn't bet)
Seat 6: 5b1dc166 folded before Flop (didn't bet)


Poker Hand #HD1144687891: Hold'em No Limit  ($0.02/$0.05) - 2023/03/03 21:02:49
Table 'NLHBlue116' 6-max Seat #6 is the button
Seat 1: Hero ($5.13 in chips)
Seat 2: 1d0da3a7 ($5.29 in chips)
Seat 4: 713370ec ($10.53 in chips)
Seat 5: a2d31939 ($13.12 in chips)
Seat 6: 5b1dc166 ($5.87 in chips)
Hero: posts small blind $0.02
1d0da3a7: posts big blind $0.05
*** HOLE CARDS ***
Dealt to Hero [8c 6s]
Dealt to 1d0da3a7 
Dealt to 713370ec 
Dealt to a2d31939 
Dealt to 5b1dc166 
713370ec: folds
a2d31939: folds
5b1dc166: folds
Hero: folds
Uncalled bet ($0.03) returned to 1d0da3a7
*** SHOWDOWN ***
1d0da3a7 collected $0.04 from pot
*** SUMMARY ***
Total pot $0.04 | Rake $0 | Jackpot $0 | Bingo $0 | Fortune $0
Seat 1: Hero (small blind) folded before Flop
Seat 2: 1d0da3a7 (big blind) collected ($0.04)
Seat 4: 713370ec folded before Flop (didn't bet)
Seat 5: a2d31939 folded before Flop (didn't bet)
Seat 6: 5b1dc166 (button) folded before Flop (didn't bet)


Poker Hand #HD1144687817: Hold'em No Limit  ($0.02/$0.05) - 2023/03/03 21:02:23
Table 'NLHBlue116' 6-max Seat #5 is the button
Seat 1: Hero ($5 in chips)
Seat 2: 1d0da3a7 ($5.29 in chips)
Seat 4: 713370ec ($10.53 in chips)
Seat 5: a2d31939 ($13.24 in chips)
Seat 6: 5b1dc166 ($5.89 in chips)
5b1dc166: posts small blind $0.02
Hero: posts big blind $0.05
*** HOLE CARDS ***
Dealt to Hero [Kc 2c]
Dealt to 1d0da3a7 
Dealt to 713370ec 
Dealt to a2d31939 
Dealt to 5b1dc166 
1d0da3a7: folds
713370ec: folds
a2d31939: raises $0.07 to $0.12
5b1dc166: folds
Hero: calls $0.07
*** FLOP *** [5s 4c 3c]
Hero: checks
a2d31939: checks
*** TURN *** [5s 4c 3c] [8c]
Hero: bets $0.2
a2d31939: folds
Uncalled bet ($0.2) returned to Hero
*** SHOWDOWN ***
Hero collected $0.25 from pot
*** SUMMARY ***
Total pot $0.26 | Rake $0.01 | Jackpot $0 | Bingo $0 | Fortune $0
Board [5s 4c 3c 8c]
Seat 1: Hero (big blind) won ($0.25)
Seat 2: 1d0da3a7 folded before Flop (didn't bet)
Seat 4: 713370ec folded before Flop (didn't bet)
Seat 5: a2d31939 (button) folded on the Turn
Seat 6: 5b1dc166 (small blind) folded before Flop


Poker Hand #HD1144687784: Hold'em No Limit  ($0.02/$0.05) - 2023/03/03 21:02:12
Table 'NLHBlue116' 6-max Seat #4 is the button
Seat 1: Hero ($5 in chips)
Seat 2: 1d0da3a7 ($5.29 in chips)
Seat 4: 713370ec ($10.53 in chips)
Seat 5: a2d31939 ($13.26 in chips)
Seat 6: 5b1dc166 ($5.87 in chips)
a2d31939: posts small blind $0.02
5b1dc166: posts big blind $0.05
*** HOLE CARDS ***
Dealt to Hero [7c 6s]
Dealt to 1d0da3a7 
Dealt to 713370ec 
Dealt to a2d31939 
Dealt to 5b1dc166 
Hero: folds
1d0da3a7: folds
713370ec: folds
a2d31939: folds
Uncalled bet ($0.03) returned to 5b1dc166
*** SHOWDOWN ***
5b1dc166 collected $0.04 from pot
*** SUMMARY ***
Total pot $0.04 | Rake $0 | Jackpot $0 | Bingo $0 | Fortune $0
Seat 1: Hero folded before Flop (didn't bet)
Seat 2: 1d0da3a7 folded before Flop (didn't bet)
Seat 4: 713370ec (button) folded before Flop (didn't bet)
Seat 5: a2d31939 (small blind) folded before Flop
Seat 6: 5b1dc166 (big blind) collected ($0.04)


Poker Hand #HD1144687715: Hold'em No Limit  ($0.02/$0.05) - 2023/03/03 21:01:43
Table 'NLHBlue116' 6-max Seat #2 is the button
Seat 1: Hero ($5 in chips)
Seat 2: 1d0da3a7 ($5.29 in chips)
Seat 4: 713370ec ($10.37 in chips)
Seat 5: a2d31939 ($13.31 in chips)
Seat 6: 5b1dc166 ($5.87 in chips)
713370ec: posts small blind $0.02
a2d31939: posts big blind $0.05
*** HOLE CARDS ***
Dealt to Hero [8h 8d]
Dealt to 1d0da3a7 
Dealt to 713370ec 
Dealt to a2d31939 
Dealt to 5b1dc166 
5b1dc166: folds
Hero: raises $0.07 to $0.12
1d0da3a7: folds
713370ec: raises $0.4 to $0.52
a2d31939: folds
Hero: folds
Uncalled bet ($0.4) returned to 713370ec
*** SHOWDOWN ***
713370ec collected $0.28 from pot
*** SUMMARY ***
Total pot $0.29 | Rake $0.01 | Jackpot $0 | Bingo $0 | Fortune $0
Seat 1: Hero folded before Flop
Seat 2: 1d0da3a7 (button) folded before Flop (didn't bet)
Seat 4: 713370ec (small blind) collected ($0.28)
Seat 5: a2d31939 (big blind) folded before Flop
Seat 6: 5b1dc166 folded before Flop (didn't bet)


Poker Hand #HD1144687663: Hold'em No Limit  ($0.02/$0.05) - 2023/03/03 21:01:28
Table 'NLHBlue116' 6-max Seat #1 is the button
Seat 1: Hero ($5 in chips)
Seat 2: 1d0da3a7 ($5.31 in chips)
Seat 4: 713370ec ($10.42 in chips)
Seat 5: a2d31939 ($13.31 in chips)
Seat 6: 5b1dc166 ($5.8 in chips)
1d0da3a7: posts small blind $0.02
713370ec: posts big blind $0.05
*** HOLE CARDS ***
Dealt to Hero [5h Qs]
Dealt to 1d0da3a7 
Dealt to 713370ec 
Dealt to a2d31939 
Dealt to 5b1dc166 
a2d31939: folds
5b1dc166: raises $0.08 to $0.13
Hero: folds
1d0da3a7: folds
713370ec: folds
Uncalled bet ($0.08) returned to 5b1dc166
*** SHOWDOWN ***
5b1dc166 collected $0.12 from pot
*** SUMMARY ***
Total pot $0.12 | Rake $0 | Jackpot $0 | Bingo $0 | Fortune $0
Seat 1: Hero (button) folded before Flop (didn't bet)
Seat 2: 1d0da3a7 (small blind) folded before Flop
Seat 4: 713370ec (big blind) folded before Flop
Seat 5: a2d31939 folded before Flop (didn't bet)
Seat 6: 5b1dc166 collected ($0.12)


Poker Hand #HD1144687558: Hold'em No Limit  ($0.02/$0.05) - 2023/03/03 21:00:45
Table 'NLHBlue116' 6-max Seat #6 is the button
Seat 1: Hero ($5 in chips)
Seat 2: 1d0da3a7 ($5.36 in chips)
Seat 4: 713370ec ($10.42 in chips)
Seat 5: a2d31939 ($13.24 in chips)
Seat 6: 5b1dc166 ($5.8 in chips)
Hero: posts small blind $0.02
1d0da3a7: posts big blind $0.05
*** HOLE CARDS ***
Dealt to Hero [8c Kh]
Dealt to 1d0da3a7 
Dealt to 713370ec 
Dealt to a2d31939 
Dealt to 5b1dc166 
713370ec: folds
a2d31939: raises $0.08 to $0.13
5b1dc166: folds
Hero: folds
1d0da3a7: folds
Uncalled bet ($0.08) returned to a2d31939
*** SHOWDOWN ***
a2d31939 collected $0.12 from pot
*** SUMMARY ***
Total pot $0.12 | Rake $0 | Jackpot $0 | Bingo $0 | Fortune $0
Seat 1: Hero (small blind) folded before Flop
Seat 2: 1d0da3a7 (big blind) folded before Flop
Seat 4: 713370ec folded before Flop (didn't bet)
Seat 5: a2d31939 collected ($0.12)
Seat 6: 5b1dc166 (button) folded before Flop (didn't bet)


Poker Hand #HD1144687387: Hold'em No Limit  ($0.02/$0.05) - 2023/03/03 20:59:43
Table 'NLHBlue116' 6-max Seat #5 is the button
Seat 1: Hero ($5 in chips)
Seat 2: 1d0da3a7 ($5.36 in chips)
Seat 4: 713370ec ($10.42 in chips)
Seat 5: a2d31939 ($14.12 in chips)
Seat 6: 5b1dc166 ($5 in chips)
5b1dc166: posts small blind $0.02
Hero: posts big blind $0.05
*** HOLE CARDS ***
Dealt to Hero [8h 4c]
Dealt to 1d0da3a7 
Dealt to 713370ec 
Dealt to a2d31939 
Dealt to 5b1dc166 
1d0da3a7: folds
713370ec: folds
a2d31939: raises $0.07 to $0.12
5b1dc166: raises $0.33 to $0.45
Hero: folds
a2d31939: calls $0.33
*** FLOP *** [Ad 2c Kc]
5b1dc166: checks
a2d31939: checks
*** TURN *** [Ad 2c Kc] [Kh]
5b1dc166: checks
a2d31939: bets $0.43
5b1dc166: raises $0.58 to $1.01
a2d31939: folds
Uncalled bet ($0.58) returned to 5b1dc166
*** SHOWDOWN ***
5b1dc166 collected $1.68 from pot
*** SUMMARY ***
Total pot $1.81 | Rake $0.08 | Jackpot $0.05 | Bingo $0 | Fortune $0
Board [Ad 2c Kc Kh]
Seat 1: Hero (big blind) folded before Flop
Seat 2: 1d0da3a7 folded before Flop (didn't bet)
Seat 4: 713370ec folded before Flop (didn't bet)
Seat 5: a2d31939 (button) folded on the Turn
Seat 6: 5b1dc166 (small blind) won ($1.68)


Poker Hand #HD1144687331: Hold'em No Limit  ($0.02/$0.05) - 2023/03/03 20:59:27
Table 'NLHBlue116' 6-max Seat #4 is the button
Seat 1: Hero ($5.07 in chips)
Seat 2: 1d0da3a7 ($5.18 in chips)
Seat 4: 713370ec ($10.42 in chips)
Seat 5: a2d31939 ($14.14 in chips)
Seat 6: 5b1dc166 ($5 in chips)
a2d31939: posts small blind $0.02
5b1dc166: posts big blind $0.05
*** HOLE CARDS ***
Dealt to Hero [7c 8c]
Dealt to 1d0da3a7 
Dealt to 713370ec 
Dealt to a2d31939 
Dealt to 5b1dc166 
Hero: raises $0.07 to $0.12
1d0da3a7: raises $0.45 to $0.57
713370ec: folds
a2d31939: folds
5b1dc166: folds
Hero: folds
Uncalled bet ($0.45) returned to 1d0da3a7
*** SHOWDOWN ***
1d0da3a7 collected $0.3 from pot
*** SUMMARY ***
Total pot $0.31 | Rake $0.01 | Jackpot $0 | Bingo $0 | Fortune $0
Seat 1: Hero folded before Flop
Seat 2: 1d0da3a7 collected ($0.3)
Seat 4: 713370ec (button) folded before Flop (didn't bet)
Seat 5: a2d31939 (small blind) folded before Flop
Seat 6: 5b1dc166 (big blind) folded before Flop


Poker Hand #HD1144687301: Hold'em No Limit  ($0.02/$0.05) - 2023/03/03 20:59:17
Table 'NLHBlue116' 6-max Seat #2 is the button
Seat 1: Hero ($5.07 in chips)
Seat 2: 1d0da3a7 ($5.18 in chips)
Seat 4: 713370ec ($10.44 in chips)
Seat 5: a2d31939 ($14.12 in chips)
Seat 6: 5b1dc166 ($5 in chips)
713370ec: posts small blind $0.02
a2d31939: posts big blind $0.05
*** HOLE CARDS ***
Dealt to Hero [5h Ts]
Dealt to 1d0da3a7 
Dealt to 713370ec 
Dealt to a2d31939 
Dealt to 5b1dc166 
5b1dc166: folds
Hero: folds
1d0da3a7: folds
713370ec: folds
Uncalled bet ($0.03) returned to a2d31939
*** SHOWDOWN ***
a2d31939 collected $0.04 from pot
*** SUMMARY ***
Total pot $0.04 | Rake $0 | Jackpot $0 | Bingo $0 | Fortune $0
Seat 1: Hero folded before Flop (didn't bet)
Seat 2: 1d0da3a7 (button) folded before Flop (didn't bet)
Seat 4: 713370ec (small blind) folded before Flop
Seat 5: a2d31939 (big blind) collected ($0.04)
Seat 6: 5b1dc166 folded before Flop (didn't bet)


Poker Hand #HD1144687276: Hold'em No Limit  ($0.02/$0.05) - 2023/03/03 20:59:08
Table 'NLHBlue116' 6-max Seat #1 is the button
Seat 1: Hero ($5.07 in chips)
Seat 2: 1d0da3a7 ($5.2 in chips)
Seat 4: 713370ec ($10.42 in chips)
Seat 5: a2d31939 ($14.12 in chips)
Seat 6: 5b1dc166 ($5 in chips)
1d0da3a7: posts small blind $0.02
713370ec: posts big blind $0.05
*** HOLE CARDS ***
Dealt to Hero [5s Tc]
Dealt to 1d0da3a7 
Dealt to 713370ec 
Dealt to a2d31939 
Dealt to 5b1dc166 
a2d31939: folds
5b1dc166: folds
Hero: folds
1d0da3a7: folds
Uncalled bet ($0.03) returned to 713370ec
*** SHOWDOWN ***
713370ec collected $0.04 from pot
*** SUMMARY ***
Total pot $0.04 | Rake $0 | Jackpot $0 | Bingo $0 | Fortune $0
Seat 1: Hero (button) folded before Flop (didn't bet)
Seat 2: 1d0da3a7 (small blind) folded before Flop
Seat 4: 713370ec (big blind) collected ($0.04)
Seat 5: a2d31939 folded before Flop (didn't bet)
Seat 6: 5b1dc166 folded before Flop (didn't bet)


Poker Hand #HD1144687220: Hold'em No Limit  ($0.02/$0.05) - 2023/03/03 20:58:49
Table 'NLHBlue116' 6-max Seat #6 is the button
Seat 1: Hero ($5.02 in chips)
Seat 2: 1d0da3a7 ($5.25 in chips)
Seat 4: 713370ec ($10.42 in chips)
Seat 5: a2d31939 ($14.12 in chips)
Seat 6: 5b1dc166 ($5 in chips)
Hero: posts small blind $0.02
1d0da3a7: posts big blind $0.05
*** HOLE CARDS ***
Dealt to Hero [Tc 6c]
Dealt to 1d0da3a7 
Dealt to 713370ec 
Dealt to a2d31939 
Dealt to 5b1dc166 
713370ec: folds
a2d31939: folds
5b1dc166: folds
Hero: raises $0.09 to $0.14
1d0da3a7: folds
Uncalled bet ($0.09) returned to Hero
*** SHOWDOWN ***
Hero collected $0.1 from pot
*** SUMMARY ***
Total pot $0.1 | Rake $0 | Jackpot $0 | Bingo $0 | Fortune $0
Seat 1: Hero (small blind) collected ($0.1)
Seat 2: 1d0da3a7 (big blind) folded before Flop
Seat 4: 713370ec folded before Flop (didn't bet)
Seat 5: a2d31939 folded before Flop (didn't bet)
Seat 6: 5b1dc166 (button) folded before Flop (didn't bet)


Poker Hand #HD1144687191: Hold'em No Limit  ($0.02/$0.05) - 2023/03/03 20:58:40
Table 'NLHBlue116' 6-max Seat #5 is the button
Seat 1: Hero ($5 in chips)
Seat 2: 1d0da3a7 ($5.25 in chips)
Seat 4: 713370ec ($10.42 in chips)
Seat 5: a2d31939 ($14.12 in chips)
Seat 6: 5b1dc166 ($5.02 in chips)
5b1dc166: posts small blind $0.02
Hero: posts big blind $0.05
*** HOLE CARDS ***
Dealt to Hero [3c 6h]
Dealt to 1d0da3a7 
Dealt to 713370ec 
Dealt to a2d31939 
Dealt to 5b1dc166 
1d0da3a7: folds
713370ec: folds
a2d31939: folds
5b1dc166: folds
Uncalled bet ($0.03) returned to Hero
*** SHOWDOWN ***
Hero collected $0.04 from pot
*** SUMMARY ***
Total pot $0.04 | Rake $0 | Jackpot $0 | Bingo $0 | Fortune $0
Seat 1: Hero (big blind) collected ($0.04)
Seat 2: 1d0da3a7 folded before Flop (didn't bet)
Seat 4: 713370ec folded before Flop (didn't bet)
Seat 5: a2d31939 (button) folded before Flop (didn't bet)
Seat 6: 5b1dc166 (small blind) folded before Flop


Poker Hand #HD1144687161: Hold'em No Limit  ($0.02/$0.05) - 2023/03/03 20:58:27
Table 'NLHBlue116' 6-max Seat #4 is the button
Seat 1: Hero ($5 in chips)
Seat 2: 1d0da3a7 ($5.25 in chips)
Seat 4: 713370ec ($10.35 in chips)
Seat 5: a2d31939 ($14.14 in chips)
Seat 6: 5b1dc166 ($5.07 in chips)
a2d31939: posts small blind $0.02
5b1dc166: posts big blind $0.05
*** HOLE CARDS ***
Dealt to Hero [7d 6s]
Dealt to 1d0da3a7 
Dealt to 713370ec 
Dealt to a2d31939 
Dealt to 5b1dc166 
Hero: folds
1d0da3a7: folds
713370ec: raises $0.1 to $0.15
a2d31939: folds
5b1dc166: folds
Uncalled bet ($0.1) returned to 713370ec
*** SHOWDOWN ***
713370ec collected $0.12 from pot
*** SUMMARY ***
Total pot $0.12 | Rake $0 | Jackpot $0 | Bingo $0 | Fortune $0
Seat 1: Hero folded before Flop (didn't bet)
Seat 2: 1d0da3a7 folded before Flop (didn't bet)
Seat 4: 713370ec (button) collected ($0.12)
Seat 5: a2d31939 (small blind) folded before Flop
Seat 6: 5b1dc166 (big blind) folded before Flop


Poker Hand #HD1144687107: Hold'em No Limit  ($0.02/$0.05) - 2023/03/03 20:58:10
Table 'NLHBlue116' 6-max Seat #2 is the button
Seat 1: Hero ($5 in chips)
Seat 2: 1d0da3a7 ($5.25 in chips)
Seat 4: 713370ec ($10.37 in chips)
Seat 5: a2d31939 ($14.19 in chips)
Seat 6: 5b1dc166 ($5 in chips)
713370ec: posts small blind $0.02
a2d31939: posts big blind $0.05
*** HOLE CARDS ***
Dealt to Hero [7c 8d]
Dealt to 1d0da3a7 
Dealt to 713370ec 
Dealt to a2d31939 
Dealt to 5b1dc166 
5b1dc166: raises $0.08 to $0.13
Hero: folds
1d0da3a7: folds
713370ec: folds
a2d31939: folds
Uncalled bet ($0.08) returned to 5b1dc166
*** SHOWDOWN ***
5b1dc166 collected $0.12 from pot
*** SUMMARY ***
Total pot $0.12 | Rake $0 | Jackpot $0 | Bingo $0 | Fortune $0
Seat 1: Hero folded before Flop (didn't bet)
Seat 2: 1d0da3a7 (button) folded before Flop (didn't bet)
Seat 4: 713370ec (small blind) folded before Flop
Seat 5: a2d31939 (big blind) folded before Flop
Seat 6: 5b1dc166 collected ($0.12)


Poker Hand #HD1144687094: Hold'em No Limit  ($0.02/$0.05) - 2023/03/03 20:58:03
Table 'NLHBlue116' 6-max Seat #1 is the button
Seat 1: Hero ($5 in chips)
Seat 2: 1d0da3a7 ($5.27 in chips)
Seat 4: 713370ec ($10.35 in chips)
Seat 5: a2d31939 ($14.19 in chips)
Seat 6: 5b1dc166 ($5 in chips)
1d0da3a7: posts small blind $0.02
713370ec: posts big blind $0.05
*** HOLE CARDS ***
Dealt to Hero [7d 3c]
Dealt to 1d0da3a7 
Dealt to 713370ec 
Dealt to a2d31939 
Dealt to 5b1dc166 
a2d31939: folds
5b1dc166: folds
Hero: folds
1d0da3a7: folds
Uncalled bet ($0.03) returned to 713370ec
*** SHOWDOWN ***
713370ec collected $0.04 from pot
*** SUMMARY ***
Total pot $0.04 | Rake $0 | Jackpot $0 | Bingo $0 | Fortune $0
Seat 1: Hero (button) folded before Flop (didn't bet)
Seat 2: 1d0da3a7 (small blind) folded before Flop
Seat 4: 713370ec (big blind) collected ($0.04)
Seat 5: a2d31939 folded before Flop (didn't bet)
Seat 6: 5b1dc166 folded before Flop (didn't bet)


Poker Hand #HD1144687025: Hold'em No Limit  ($0.02/$0.05) - 2023/03/03 20:57:38
Table 'NLHBlue116' 6-max Seat #6 is the button
Seat 1: Hero ($5 in chips)
Seat 2: 1d0da3a7 ($5 in chips)
Seat 3: a592735e ($6.23 in chips)
Seat 4: 713370ec ($10.35 in chips)
Seat 5: a2d31939 ($14.19 in chips)
Seat 6: 5b1dc166 ($5 in chips)
Hero: posts small blind $0.02
1d0da3a7: posts big blind $0.05
*** HOLE CARDS ***
Dealt to Hero [3s Ts]
Dealt to 1d0da3a7 
Dealt to a592735e 
Dealt to 713370ec 
Dealt to a2d31939 
Dealt to 5b1dc166 
a592735e: raises $0.1 to $0.15
713370ec: folds
a2d31939: folds
5b1dc166: folds
Hero: folds
1d0da3a7: calls $0.1
*** FLOP *** [4s Td As]
1d0da3a7: checks
a592735e: bets $0.12
1d0da3a7: raises $0.41 to $0.53
a592735e: folds
Uncalled bet ($0.41) returned to 1d0da3a7
*** SHOWDOWN ***
1d0da3a7 collected $0.54 from pot
*** SUMMARY ***
Total pot $0.56 | Rake $0.02 | Jackpot $0 | Bingo $0 | Fortune $0
Board [4s Td As]
Seat 1: Hero (small blind) folded before Flop
Seat 2: 1d0da3a7 (big blind) won ($0.54)
Seat 3: a592735e folded on the Flop
Seat 4: 713370ec folded before Flop (didn't bet)
Seat 5: a2d31939 folded before Flop (didn't bet)
Seat 6: 5b1dc166 (button) folded before Flop (didn't bet)


Poker Hand #HD1144686837: Hold'em No Limit  ($0.02/$0.05) - 2023/03/03 20:56:32
Table 'NLHBlue116' 6-max Seat #5 is the button
Seat 1: Hero ($5 in chips)
Seat 2: 1d0da3a7 ($5.52 in chips)
Seat 3: a592735e ($6.23 in chips)
Seat 4: 713370ec ($10.35 in chips)
Seat 5: a2d31939 ($13.49 in chips)
Seat 6: 5b1dc166 ($5 in chips)
5b1dc166: posts small blind $0.02
Hero: posts big blind $0.05
*** HOLE CARDS ***
Dealt to Hero [7s Ks]
Dealt to 1d0da3a7 
Dealt to a592735e 
Dealt to 713370ec 
Dealt to a2d31939 
Dealt to 5b1dc166 
1d0da3a7: raises $0.08 to $0.13
a592735e: folds
713370ec: folds
a2d31939: calls $0.13
5b1dc166: folds
Hero: calls $0.08
*** FLOP *** [3s 4h Ac]
Hero: checks
1d0da3a7: bets $0.14
a2d31939: calls $0.14
Hero: folds
*** TURN *** [3s 4h Ac] [2d]
1d0da3a7: checks
a2d31939: checks
*** RIVER *** [3s 4h Ac 2d] [2h]
1d0da3a7: checks
a2d31939: bets $0.35
1d0da3a7: calls $0.35
a2d31939: shows [Qh Ah] (Pair of Aces and Pair of Twos)
1d0da3a7: shows [9h 9c] (Pair of Nines and Pair of Twos)
*** SHOWDOWN ***
a2d31939 collected $1.32 from pot
*** SUMMARY ***
Total pot $1.39 | Rake $0.07 | Jackpot $0 | Bingo $0 | Fortune $0
Board [3s 4h Ac 2d 2h]
Seat 1: Hero (big blind) folded on the Flop
Seat 2: 1d0da3a7 showed [9h 9c] and lost with Pair of Nines and Pair of Twos
Seat 3: a592735e folded before Flop (didn't bet)
Seat 4: 713370ec folded before Flop (didn't bet)
Seat 5: a2d31939 (button) showed [Qh Ah] and won ($1.32) with Pair of Aces and Pair of Twos
Seat 6: 5b1dc166 (small blind) folded before Flop


Poker Hand #HD1144686528: Hold'em No Limit  ($0.02/$0.05) - 2023/03/03 20:54:36
Table 'NLHBlue116' 6-max Seat #4 is the button
Seat 1: Hero ($5.34 in chips)
Seat 2: 1d0da3a7 ($5.52 in chips)
Seat 3: a592735e ($6.23 in chips)
Seat 4: 713370ec ($10.35 in chips)
Seat 5: a2d31939 ($11.76 in chips)
Seat 6: 5b1dc166 ($5 in chips)
a2d31939: posts small blind $0.02
5b1dc166: posts big blind $0.05
*** HOLE CARDS ***
Dealt to Hero [Td Ad]
Dealt to 1d0da3a7 
Dealt to a592735e 
Dealt to 713370ec 
Dealt to a2d31939 
Dealt to 5b1dc166 
Hero: raises $0.07 to $0.12
1d0da3a7: folds
a592735e: folds
713370ec: folds
a2d31939: raises $0.4 to $0.52
5b1dc166: folds
Hero: calls $0.4
*** FLOP *** [Kd Jh 6s]
a2d31939: bets $0.4
Hero: calls $0.4
*** TURN *** [Kd Jh 6s] [6c]
a2d31939: checks
Hero: bets $1
a2d31939: calls $1
*** RIVER *** [Kd Jh 6s 6c] [8h]
a2d31939: checks
Hero: checks
a2d31939: shows [Kc Ks] (Kings Full over Sixes)
Hero: shows [Td Ad] (Pair of Sixes)
*** SHOWDOWN ***
a2d31939 collected $3.65 from pot
*** SUMMARY ***
Total pot $3.89 | Rake $0.19 | Jackpot $0.05 | Bingo $0 | Fortune $0
Board [Kd Jh 6s 6c 8h]
Seat 1: Hero showed [Td Ad] and lost with Pair of Sixes
Seat 2: 1d0da3a7 folded before Flop (didn't bet)
Seat 3: a592735e folded before Flop (didn't bet)
Seat 4: 713370ec (button) folded before Flop (didn't bet)
Seat 5: a2d31939 (small blind) showed [Kc Ks] and won ($3.65) with Kings Full over Sixes
Seat 6: 5b1dc166 (big blind) folded before Flop


Poker Hand #HD1144686491: Hold'em No Limit  ($0.02/$0.05) - 2023/03/03 20:54:22
Table 'NLHBlue116' 6-max Seat #3 is the button
Seat 1: Hero ($5.34 in chips)
Seat 2: 1d0da3a7 ($5.52 in chips)
Seat 3: a592735e ($6.16 in chips)
Seat 4: 713370ec ($10.37 in chips)
Seat 5: a2d31939 ($11.81 in chips)
Seat 6: 5b1dc166 ($5 in chips)
713370ec: posts small blind $0.02
a2d31939: posts big blind $0.05
*** HOLE CARDS ***
Dealt to Hero [2h Qs]
Dealt to 1d0da3a7 
Dealt to a592735e 
Dealt to 713370ec 
Dealt to a2d31939 
Dealt to 5b1dc166 
5b1dc166: folds
Hero: folds
1d0da3a7: folds
a592735e: raises $0.08 to $0.13
713370ec: folds
a2d31939: folds
Uncalled bet ($0.08) returned to a592735e
*** SHOWDOWN ***
a592735e collected $0.12 from pot
*** SUMMARY ***
Total pot $0.12 | Rake $0 | Jackpot $0 | Bingo $0 | Fortune $0
Seat 1: Hero folded before Flop (didn't bet)
Seat 2: 1d0da3a7 folded before Flop (didn't bet)
Seat 3: a592735e (button) collected ($0.12)
Seat 4: 713370ec (small blind) folded before Flop
Seat 5: a2d31939 (big blind) folded before Flop
Seat 6: 5b1dc166 folded before Flop (didn't bet)


Poker Hand #HD1144686458: Hold'em No Limit  ($0.02/$0.05) - 2023/03/03 20:54:10
Table 'NLHBlue116' 6-max Seat #2 is the button
Seat 1: Hero ($5.27 in chips)
Seat 2: 1d0da3a7 ($5.52 in chips)
Seat 3: a592735e ($6.18 in chips)
Seat 4: 713370ec ($10.42 in chips)
Seat 5: a2d31939 ($11.81 in chips)
Seat 6: 5b1dc166 ($5 in chips)
a592735e: posts small blind $0.02
713370ec: posts big blind $0.05
*** HOLE CARDS ***
Dealt to Hero [2h Ah]
Dealt to 1d0da3a7 
Dealt to a592735e 
Dealt to 713370ec 
Dealt to a2d31939 
Dealt to 5b1dc166 
a2d31939: folds
5b1dc166: folds
Hero: raises $0.07 to $0.12
1d0da3a7: folds
a592735e: folds
713370ec: folds
Uncalled bet ($0.07) returned to Hero
*** SHOWDOWN ***
Hero collected $0.12 from pot
*** SUMMARY ***
Total pot $0.12 | Rake $0 | Jackpot $0 | Bingo $0 | Fortune $0
Seat 1: Hero collected ($0.12)
Seat 2: 1d0da3a7 (button) folded before Flop (didn't bet)
Seat 3: a592735e (small blind) folded before Flop
Seat 4: 713370ec (big blind) folded before Flop
Seat 5: a2d31939 folded before Flop (didn't bet)
Seat 6: 5b1dc166 folded before Flop (didn't bet)


Poker Hand #HD1144686415: Hold'em No Limit  ($0.02/$0.05) - 2023/03/03 20:53:57
Table 'NLHBlue116' 6-max Seat #1 is the button
Seat 1: Hero ($5.27 in chips)
Seat 2: 1d0da3a7 ($5.54 in chips)
Seat 3: a592735e ($6.16 in chips)
Seat 4: 713370ec ($10.42 in chips)
Seat 5: a2d31939 ($11.81 in chips)
Seat 6: 5b1dc166 ($5 in chips)
1d0da3a7: posts small blind $0.02
a592735e: posts big blind $0.05
*** HOLE CARDS ***
Dealt to Hero [5d Jh]
Dealt to 1d0da3a7 
Dealt to a592735e 
Dealt to 713370ec 
Dealt to a2d31939 
Dealt to 5b1dc166 
713370ec: folds
a2d31939: folds
5b1dc166: folds
Hero: folds
1d0da3a7: folds
Uncalled bet ($0.03) returned to a592735e
*** SHOWDOWN ***
a592735e collected $0.04 from pot
*** SUMMARY ***
Total pot $0.04 | Rake $0 | Jackpot $0 | Bingo $0 | Fortune $0
Seat 1: Hero (button) folded before Flop (didn't bet)
Seat 2: 1d0da3a7 (small blind) folded before Flop
Seat 3: a592735e (big blind) collected ($0.04)
Seat 4: 713370ec folded before Flop (didn't bet)
Seat 5: a2d31939 folded before Flop (didn't bet)
Seat 6: 5b1dc166 folded before Flop (didn't bet)


Poker Hand #HD1144686326: Hold'em No Limit  ($0.02/$0.05) - 2023/03/03 20:53:25
Table 'NLHBlue116' 6-max Seat #6 is the button
Seat 1: Hero ($5.29 in chips)
Seat 2: 1d0da3a7 ($5.59 in chips)
Seat 3: a592735e ($6.16 in chips)
Seat 4: 713370ec ($10.42 in chips)
Seat 5: a2d31939 ($11.74 in chips)
Seat 6: 5b1dc166 ($5 in chips)
Hero: posts small blind $0.02
1d0da3a7: posts big blind $0.05
*** HOLE CARDS ***
Dealt to Hero [Jc Qs]
Dealt to 1d0da3a7 
Dealt to a592735e 
Dealt to 713370ec 
Dealt to a2d31939 
Dealt to 5b1dc166 
a592735e: folds
713370ec: folds
a2d31939: raises $0.08 to $0.13
5b1dc166: folds
Hero: folds
1d0da3a7: folds
Uncalled bet ($0.08) returned to a2d31939
*** SHOWDOWN ***
a2d31939 collected $0.12 from pot
*** SUMMARY ***
Total pot $0.12 | Rake $0 | Jackpot $0 | Bingo $0 | Fortune $0
Seat 1: Hero (small blind) folded before Flop
Seat 2: 1d0da3a7 (big blind) folded before Flop
Seat 3: a592735e folded before Flop (didn't bet)
Seat 4: 713370ec folded before Flop (didn't bet)
Seat 5: a2d31939 collected ($0.12)
Seat 6: 5b1dc166 (button) folded before Flop (didn't bet)


Poker Hand #HD1144686266: Hold'em No Limit  ($0.02/$0.05) - 2023/03/03 20:53:06
Table 'NLHBlue116' 6-max Seat #5 is the button
Seat 1: Hero ($5.34 in chips)
Seat 2: 1d0da3a7 ($5.59 in chips)
Seat 3: a592735e ($6.16 in chips)
Seat 4: 713370ec ($10.35 in chips)
Seat 5: a2d31939 ($11.74 in chips)
Seat 6: 5b1dc166 ($5 in chips)
5b1dc166: posts small blind $0.02
Hero: posts big blind $0.05
*** HOLE CARDS ***
Dealt to Hero [Ts 4d]
Dealt to 1d0da3a7 
Dealt to a592735e 
Dealt to 713370ec 
Dealt to a2d31939 
Dealt to 5b1dc166 
1d0da3a7: folds
a592735e: folds
713370ec: raises $0.1 to $0.15
a2d31939: folds
5b1dc166: folds
Hero: folds
Uncalled bet ($0.1) returned to 713370ec
*** SHOWDOWN ***
713370ec collected $0.12 from pot
*** SUMMARY ***
Total pot $0.12 | Rake $0 | Jackpot $0 | Bingo $0 | Fortune $0
Seat 1: Hero (big blind) folded before Flop
Seat 2: 1d0da3a7 folded before Flop (didn't bet)
Seat 3: a592735e folded before Flop (didn't bet)
Seat 4: 713370ec collected ($0.12)
Seat 5: a2d31939 (button) folded before Flop (didn't bet)
Seat 6: 5b1dc166 (small blind) folded before Flop


Poker Hand #HD1144686207: Hold'em No Limit  ($0.02/$0.05) - 2023/03/03 20:52:48
Table 'NLHBlue116' 6-max Seat #4 is the button
Seat 1: Hero ($5.34 in chips)
Seat 2: 1d0da3a7 ($5.59 in chips)
Seat 3: a592735e ($6.16 in chips)
Seat 4: 713370ec ($10.28 in chips)
Seat 5: a2d31939 ($11.76 in chips)
Seat 6: 5b1dc166 ($5.02 in chips)
a2d31939: posts small blind $0.02
5b1dc166: posts big blind $0.05
*** HOLE CARDS ***
Dealt to Hero [5s 6c]
Dealt to 1d0da3a7 
Dealt to a592735e 
Dealt to 713370ec 
Dealt to a2d31939 
Dealt to 5b1dc166 
Hero: folds
1d0da3a7: folds
a592735e: folds
713370ec: raises $0.1 to $0.15
a2d31939: folds
5b1dc166: folds
Uncalled bet ($0.1) returned to 713370ec
*** SHOWDOWN ***
713370ec collected $0.12 from pot
*** SUMMARY ***
Total pot $0.12 | Rake $0 | Jackpot $0 | Bingo $0 | Fortune $0
Seat 1: Hero folded before Flop (didn't bet)
Seat 2: 1d0da3a7 folded before Flop (didn't bet)
Seat 3: a592735e folded before Flop (didn't bet)
Seat 4: 713370ec (button) collected ($0.12)
Seat 5: a2d31939 (small blind) folded before Flop
Seat 6: 5b1dc166 (big blind) folded before Flop


Poker Hand #HD1144686075: Hold'em No Limit  ($0.02/$0.05) - 2023/03/03 20:52:07
Table 'NLHBlue116' 6-max Seat #3 is the button
Seat 1: Hero ($5.34 in chips)
Seat 2: 1d0da3a7 ($5.14 in chips)
Seat 3: a592735e ($6.16 in chips)
Seat 4: 713370ec ($10.3 in chips)
Seat 5: a2d31939 ($12.23 in chips)
713370ec: posts small blind $0.02
a2d31939: posts big blind $0.05
*** HOLE CARDS ***
Dealt to Hero [6d Jh]
Dealt to 1d0da3a7 
Dealt to a592735e 
Dealt to 713370ec 
Dealt to a2d31939 
Hero: folds
1d0da3a7: raises $0.08 to $0.13
a592735e: folds
713370ec: folds
a2d31939: calls $0.08
*** FLOP *** [Kh 6s 7s]
a2d31939: checks
1d0da3a7: checks
*** TURN *** [Kh 6s 7s] [Ks]
a2d31939: bets $0.1
1d0da3a7: calls $0.1
*** RIVER *** [Kh 6s 7s Ks] [Js]
a2d31939: bets $0.24
1d0da3a7: calls $0.24
a2d31939: shows [Ac 5c] (Pair of Kings)
1d0da3a7: shows [Qh Ts] (King High Flush)
*** SHOWDOWN ***
1d0da3a7 collected $0.92 from pot
*** SUMMARY ***
Total pot $0.96 | Rake $0.04 | Jackpot $0 | Bingo $0 | Fortune $0
Board [Kh 6s 7s Ks Js]
Seat 1: Hero folded before Flop (didn't bet)
Seat 2: 1d0da3a7 showed [Qh Ts] and won ($0.92) with King High Flush
Seat 3: a592735e (button) folded before Flop (didn't bet)
Seat 4: 713370ec (small blind) folded before Flop
Seat 5: a2d31939 (big blind) showed [Ac 5c] and lost with Pair of Kings


Poker Hand #HD1144686049: Hold'em No Limit  ($0.02/$0.05) - 2023/03/03 20:51:54
Table 'NLHBlue116' 6-max Seat #2 is the button
Seat 1: Hero ($5.34 in chips)
Seat 2: 1d0da3a7 ($5.14 in chips)
Seat 3: a592735e ($6.18 in chips)
Seat 4: 713370ec ($10.28 in chips)
Seat 5: a2d31939 ($12.23 in chips)
a592735e: posts small blind $0.02
713370ec: posts big blind $0.05
*** HOLE CARDS ***
Dealt to Hero [Jd 2d]
Dealt to 1d0da3a7 
Dealt to a592735e 
Dealt to 713370ec 
Dealt to a2d31939 
a2d31939: folds
Hero: folds
1d0da3a7: folds
a592735e: folds
Uncalled bet ($0.03) returned to 713370ec
*** SHOWDOWN ***
713370ec collected $0.04 from pot
*** SUMMARY ***
Total pot $0.04 | Rake $0 | Jackpot $0 | Bingo $0 | Fortune $0
Seat 1: Hero folded before Flop (didn't bet)
Seat 2: 1d0da3a7 (button) folded before Flop (didn't bet)
Seat 3: a592735e (small blind) folded before Flop
Seat 4: 713370ec (big blind) collected ($0.04)
Seat 5: a2d31939 folded before Flop (didn't bet)


Poker Hand #HD1144686019: Hold'em No Limit  ($0.02/$0.05) - 2023/03/03 20:51:44
Table 'NLHBlue116' 6-max Seat #1 is the button
Seat 1: Hero ($5.34 in chips)
Seat 2: 1d0da3a7 ($5.16 in chips)
Seat 3: a592735e ($6.16 in chips)
Seat 4: 713370ec ($10.28 in chips)
Seat 5: a2d31939 ($12.23 in chips)
1d0da3a7: posts small blind $0.02
a592735e: posts big blind $0.05
*** HOLE CARDS ***
Dealt to Hero [5h 4c]
Dealt to 1d0da3a7 
Dealt to a592735e 
Dealt to 713370ec 
Dealt to a2d31939 
713370ec: folds
a2d31939: folds
Hero: folds
1d0da3a7: folds
Uncalled bet ($0.03) returned to a592735e
*** SHOWDOWN ***
a592735e collected $0.04 from pot
*** SUMMARY ***
Total pot $0.04 | Rake $0 | Jackpot $0 | Bingo $0 | Fortune $0
Seat 1: Hero (button) folded before Flop (didn't bet)
Seat 2: 1d0da3a7 (small blind) folded before Flop
Seat 3: a592735e (big blind) collected ($0.04)
Seat 4: 713370ec folded before Flop (didn't bet)
Seat 5: a2d31939 folded before Flop (didn't bet)


Poker Hand #HD1144685984: Hold'em No Limit  ($0.02/$0.05) - 2023/03/03 20:51:35
Table 'NLHBlue116' 6-max Seat #5 is the button
Seat 1: Hero ($5.36 in chips)
Seat 2: 1d0da3a7 ($5.14 in chips)
Seat 3: a592735e ($6.16 in chips)
Seat 4: 713370ec ($10.28 in chips)
Seat 5: a2d31939 ($12.23 in chips)
Hero: posts small blind $0.02
1d0da3a7: posts big blind $0.05
*** HOLE CARDS ***
Dealt to Hero [3s 6c]
Dealt to 1d0da3a7 
Dealt to a592735e 
Dealt to 713370ec 
Dealt to a2d31939 
a592735e: folds
713370ec: folds
a2d31939: folds
Hero: folds
Uncalled bet ($0.03) returned to 1d0da3a7
*** SHOWDOWN ***
1d0da3a7 collected $0.04 from pot
*** SUMMARY ***
Total pot $0.04 | Rake $0 | Jackpot $0 | Bingo $0 | Fortune $0
Seat 1: Hero (small blind) folded before Flop
Seat 2: 1d0da3a7 (big blind) collected ($0.04)
Seat 3: a592735e folded before Flop (didn't bet)
Seat 4: 713370ec folded before Flop (didn't bet)
Seat 5: a2d31939 (button) folded before Flop (didn't bet)


Poker Hand #HD1144685916: Hold'em No Limit  ($0.02/$0.05) - 2023/03/03 20:51:08
Table 'NLHBlue116' 6-max Seat #4 is the button
Seat 1: Hero ($5.29 in chips)
Seat 2: 1d0da3a7 ($5.14 in chips)
Seat 3: a592735e ($6.16 in chips)
Seat 4: 713370ec ($10.28 in chips)
Seat 5: a2d31939 ($12.25 in chips)
Seat 6: 5b1dc166 ($5.07 in chips)
a2d31939: posts small blind $0.02
5b1dc166: posts big blind $0.05
*** HOLE CARDS ***
Dealt to Hero [Jh Th]
Dealt to 1d0da3a7 
Dealt to a592735e 
Dealt to 713370ec 
Dealt to a2d31939 
Dealt to 5b1dc166 
Hero: raises $0.07 to $0.12
1d0da3a7: folds
a592735e: folds
713370ec: folds
a2d31939: folds
5b1dc166: folds
Uncalled bet ($0.07) returned to Hero
*** SHOWDOWN ***
Hero collected $0.12 from pot
*** SUMMARY ***
Total pot $0.12 | Rake $0 | Jackpot $0 | Bingo $0 | Fortune $0
Seat 1: Hero collected ($0.12)
Seat 2: 1d0da3a7 folded before Flop (didn't bet)
Seat 3: a592735e folded before Flop (didn't bet)
Seat 4: 713370ec (button) folded before Flop (didn't bet)
Seat 5: a2d31939 (small blind) folded before Flop
Seat 6: 5b1dc166 (big blind) folded before Flop


Poker Hand #HD1144685849: Hold'em No Limit  ($0.02/$0.05) - 2023/03/03 20:50:45
Table 'NLHBlue116' 6-max Seat #3 is the button
Seat 1: Hero ($5.29 in chips)
Seat 2: 1d0da3a7 ($5.14 in chips)
Seat 3: a592735e ($6.16 in chips)
Seat 4: 713370ec ($10.3 in chips)
Seat 5: a2d31939 ($12.23 in chips)
Seat 6: 5b1dc166 ($5.07 in chips)
713370ec: posts small blind $0.02
a2d31939: posts big blind $0.05
*** HOLE CARDS ***
Dealt to Hero [Ks 4c]
Dealt to 1d0da3a7 
Dealt to a592735e 
Dealt to 713370ec 
Dealt to a2d31939 
Dealt to 5b1dc166 
5b1dc166: folds
Hero: folds
1d0da3a7: folds
a592735e: folds
713370ec: folds
Uncalled bet ($0.03) returned to a2d31939
*** SHOWDOWN ***
a2d31939 collected $0.04 from pot
*** SUMMARY ***
Total pot $0.04 | Rake $0 | Jackpot $0 | Bingo $0 | Fortune $0
Seat 1: Hero folded before Flop (didn't bet)
Seat 2: 1d0da3a7 folded before Flop (didn't bet)
Seat 3: a592735e (button) folded before Flop (didn't bet)
Seat 4: 713370ec (small blind) folded before Flop
Seat 5: a2d31939 (big blind) collected ($0.04)
Seat 6: 5b1dc166 folded before Flop (didn't bet)


Poker Hand #HD1144685705: Hold'em No Limit  ($0.02/$0.05) - 2023/03/03 20:49:54
Table 'NLHBlue116' 6-max Seat #2 is the button
Seat 1: Hero ($5.29 in chips)
Seat 2: 1d0da3a7 ($5 in chips)
Seat 3: a592735e ($6.18 in chips)
Seat 4: 713370ec ($10.43 in chips)
Seat 5: a2d31939 ($12.23 in chips)
Seat 6: 5b1dc166 ($5.07 in chips)
a592735e: posts small blind $0.02
713370ec: posts big blind $0.05
*** HOLE CARDS ***
Dealt to Hero [6c Tc]
Dealt to 1d0da3a7 
Dealt to a592735e 
Dealt to 713370ec 
Dealt to a2d31939 
Dealt to 5b1dc166 
a2d31939: folds
5b1dc166: folds
Hero: folds
1d0da3a7: raises $0.08 to $0.13
a592735e: folds
713370ec: calls $0.08
*** FLOP *** [9s 2d Kh]
713370ec: checks
1d0da3a7: checks
*** TURN *** [9s 2d Kh] [2h]
713370ec: checks
1d0da3a7: checks
*** RIVER *** [9s 2d Kh 2h] [9c]
713370ec: checks
1d0da3a7: checks
713370ec: shows [Jh Ts] (Pair of Nines and Pair of Twos)
1d0da3a7: shows [Ah 8c] (Pair of Nines and Pair of Twos)
*** SHOWDOWN ***
1d0da3a7 collected $0.27 from pot
*** SUMMARY ***
Total pot $0.28 | Rake $0.01 | Jackpot $0 | Bingo $0 | Fortune $0
Board [9s 2d Kh 2h 9c]
Seat 1: Hero folded before Flop (didn't bet)
Seat 2: 1d0da3a7 (button) showed [Ah 8c] and won ($0.27) with Pair of Nines and Pair of Twos
Seat 3: a592735e (small blind) folded before Flop
Seat 4: 713370ec (big blind) showed [Jh Ts] and lost with Pair of Nines and Pair of Twos
Seat 5: a2d31939 folded before Flop (didn't bet)
Seat 6: 5b1dc166 folded before Flop (didn't bet)


Poker Hand #HD1144635582: Hold'em No Limit  ($0.02/$0.05) - 2023/03/03 20:49:12
Table 'NLHBlue116' 6-max Seat #1 is the button
Seat 1: Hero ($5.54 in chips)
Seat 2: 1d0da3a7 ($5 in chips)
Seat 3: a592735e ($5.93 in chips)
Seat 4: 713370ec ($10.43 in chips)
Seat 5: a2d31939 ($12.23 in chips)
Seat 6: 5b1dc166 ($5.07 in chips)
1d0da3a7: posts small blind $0.02
a592735e: posts big blind $0.05
*** HOLE CARDS ***
Dealt to Hero [9d Ad]
Dealt to 1d0da3a7 
Dealt to a592735e 
Dealt to 713370ec 
Dealt to a2d31939 
Dealt to 5b1dc166 
713370ec: folds
a2d31939: folds
5b1dc166: folds
Hero: raises $0.07 to $0.12
1d0da3a7: folds
a592735e: calls $0.07
*** FLOP *** [7d 3h Kh]
a592735e: checks
Hero: bets $0.13
a592735e: calls $0.13
*** TURN *** [7d 3h Kh] [Qh]
a592735e: checks
Hero: checks
*** RIVER *** [7d 3h Kh Qh] [5c]
a592735e: checks
Hero: checks
a592735e: shows [8h 8c] (Pair of Eights)
Hero: shows [9d Ad] (Ace-High)
*** SHOWDOWN ***
a592735e collected $0.5 from pot
*** SUMMARY ***
Total pot $0.52 | Rake $0.02 | Jackpot $0 | Bingo $0 | Fortune $0
Board [7d 3h Kh Qh 5c]
Seat 1: Hero (button) showed [9d Ad] and lost with Ace-High
Seat 2: 1d0da3a7 (small blind) folded before Flop
Seat 3: a592735e (big blind) showed [8h 8c] and won ($0.5) with Pair of Eights
Seat 4: 713370ec folded before Flop (didn't bet)
Seat 5: a2d31939 folded before Flop (didn't bet)
Seat 6: 5b1dc166 folded before Flop (didn't bet)


Poker Hand #HD1144635520: Hold'em No Limit  ($0.02/$0.05) - 2023/03/03 20:48:50
Table 'NLHBlue116' 6-max Seat #6 is the button
Seat 1: Hero ($5.56 in chips)
Seat 2: 1d0da3a7 ($5 in chips)
Seat 3: a592735e ($5.93 in chips)
Seat 4: 713370ec ($10.43 in chips)
Seat 5: a2d31939 ($12.16 in chips)
Seat 6: 5b1dc166 ($5.07 in chips)
Hero: posts small blind $0.02
1d0da3a7: posts big blind $0.05
*** HOLE CARDS ***
Dealt to Hero [Kd 3h]
Dealt to 1d0da3a7 
Dealt to a592735e 
Dealt to 713370ec 
Dealt to a2d31939 
Dealt to 5b1dc166 
a592735e: folds
713370ec: folds
a2d31939: raises $0.08 to $0.13
5b1dc166: folds
Hero: folds
1d0da3a7: folds
Uncalled bet ($0.08) returned to a2d31939
*** SHOWDOWN ***
a2d31939 collected $0.12 from pot
*** SUMMARY ***
Total pot $0.12 | Rake $0 | Jackpot $0 | Bingo $0 | Fortune $0
Seat 1: Hero (small blind) folded before Flop
Seat 2: 1d0da3a7 (big blind) folded before Flop
Seat 3: a592735e folded before Flop (didn't bet)
Seat 4: 713370ec folded before Flop (didn't bet)
Seat 5: a2d31939 collected ($0.12)
Seat 6: 5b1dc166 (button) folded before Flop (didn't bet)


Poker Hand #HD1144635408: Hold'em No Limit  ($0.02/$0.05) - 2023/03/03 20:48:08
Table 'NLHBlue116' 6-max Seat #5 is the button
Seat 1: Hero ($5.61 in chips)
Seat 2: 1d0da3a7 ($5 in chips)
Seat 3: a592735e ($5.74 in chips)
Seat 4: 713370ec ($10.43 in chips)
Seat 5: a2d31939 ($12.16 in chips)
Seat 6: 5b1dc166 ($5.09 in chips)
5b1dc166: posts small blind $0.02
Hero: posts big blind $0.05
*** HOLE CARDS ***
Dealt to Hero [2s 2h]
Dealt to 1d0da3a7 
Dealt to a592735e 
Dealt to 713370ec 
Dealt to a2d31939 
Dealt to 5b1dc166 
1d0da3a7: raises $0.08 to $0.13
a592735e: raises $0.33 to $0.46
713370ec: folds
a2d31939: folds
5b1dc166: folds
Hero: folds
1d0da3a7: folds
Uncalled bet ($0.33) returned to a592735e
*** SHOWDOWN ***
a592735e collected $0.32 from pot
*** SUMMARY ***
Total pot $0.33 | Rake $0.01 | Jackpot $0 | Bingo $0 | Fortune $0
Seat 1: Hero (big blind) folded before Flop
Seat 2: 1d0da3a7 folded before Flop
Seat 3: a592735e collected ($0.32)
Seat 4: 713370ec folded before Flop (didn't bet)
Seat 5: a2d31939 (button) folded before Flop (didn't bet)
Seat 6: 5b1dc166 (small blind) folded before Flop


Poker Hand #HD1144635309: Hold'em No Limit  ($0.02/$0.05) - 2023/03/03 20:47:36
Table 'NLHBlue116' 6-max Seat #4 is the button
Seat 1: Hero ($5.61 in chips)
Seat 2: 1d0da3a7 ($5 in chips)
Seat 3: a592735e ($5.67 in chips)
Seat 4: 713370ec ($10.43 in chips)
Seat 5: a2d31939 ($12.18 in chips)
Seat 6: 5b1dc166 ($5.14 in chips)
a2d31939: posts small blind $0.02
5b1dc166: posts big blind $0.05
*** HOLE CARDS ***
Dealt to Hero [Jh 2s]
Dealt to 1d0da3a7 
Dealt to a592735e 
Dealt to 713370ec 
Dealt to a2d31939 
Dealt to 5b1dc166 
Hero: folds
1d0da3a7: folds
a592735e: raises $0.08 to $0.13
713370ec: folds
a2d31939: folds
5b1dc166: folds
Uncalled bet ($0.08) returned to a592735e
*** SHOWDOWN ***
a592735e collected $0.12 from pot
*** SUMMARY ***
Total pot $0.12 | Rake $0 | Jackpot $0 | Bingo $0 | Fortune $0
Seat 1: Hero folded before Flop (didn't bet)
Seat 2: 1d0da3a7 folded before Flop (didn't bet)
Seat 3: a592735e collected ($0.12)
Seat 4: 713370ec (button) folded before Flop (didn't bet)
Seat 5: a2d31939 (small blind) folded before Flop
Seat 6: 5b1dc166 (big blind) folded before Flop


Poker Hand #HD1144635224: Hold'em No Limit  ($0.02/$0.05) - 2023/03/03 20:47:03
Table 'NLHBlue116' 6-max Seat #3 is the button
Seat 1: Hero ($5.61 in chips)
Seat 2: 1d0da3a7 ($5 in chips)
Seat 3: a592735e ($5.6 in chips)
Seat 4: 713370ec ($10.45 in chips)
Seat 5: a2d31939 ($12.23 in chips)
Seat 6: 5b1dc166 ($5.14 in chips)
713370ec: posts small blind $0.02
a2d31939: posts big blind $0.05
*** HOLE CARDS ***
Dealt to Hero [6d 9d]
Dealt to 1d0da3a7 
Dealt to a592735e 
Dealt to 713370ec 
Dealt to a2d31939 
Dealt to 5b1dc166 
5b1dc166: folds
Hero: folds
1d0da3a7: folds
a592735e: raises $0.08 to $0.13
713370ec: folds
a2d31939: folds
Uncalled bet ($0.08) returned to a592735e
*** SHOWDOWN ***
a592735e collected $0.12 from pot
*** SUMMARY ***
Total pot $0.12 | Rake $0 | Jackpot $0 | Bingo $0 | Fortune $0
Seat 1: Hero folded before Flop (didn't bet)
Seat 2: 1d0da3a7 folded before Flop (didn't bet)
Seat 3: a592735e (button) collected ($0.12)
Seat 4: 713370ec (small blind) folded before Flop
Seat 5: a2d31939 (big blind) folded before Flop
Seat 6: 5b1dc166 folded before Flop (didn't bet)


Poker Hand #HD1144635034: Hold'em No Limit  ($0.02/$0.05) - 2023/03/03 20:45:52
Table 'NLHBlue116' 6-max Seat #2 is the button
Seat 1: Hero ($5.61 in chips)
Seat 2: 1d0da3a7 ($5.5 in chips)
Seat 3: a592735e ($5.1 in chips)
Seat 4: 713370ec ($10.5 in chips)
Seat 5: a2d31939 ($12.23 in chips)
Seat 6: 5b1dc166 ($5.14 in chips)
a592735e: posts small blind $0.02
713370ec: posts big blind $0.05
*** HOLE CARDS ***
Dealt to Hero [3d 2s]
Dealt to 1d0da3a7 
Dealt to a592735e 
Dealt to 713370ec 
Dealt to a2d31939 
Dealt to 5b1dc166 
a2d31939: folds
5b1dc166: folds
Hero: folds
1d0da3a7: raises $0.08 to $0.13
a592735e: raises $0.37 to $0.5
713370ec: folds
1d0da3a7: calls $0.37
*** FLOP *** [Ad Tc 7c]
a592735e: checks
1d0da3a7: checks
*** TURN *** [Ad Tc 7c] [Ts]
a592735e: bets $0.58
1d0da3a7: folds
Uncalled bet ($0.58) returned to a592735e
*** SHOWDOWN ***
a592735e collected $1 from pot
*** SUMMARY ***
Total pot $1.05 | Rake $0.05 | Jackpot $0 | Bingo $0 | Fortune $0
Board [Ad Tc 7c Ts]
Seat 1: Hero folded before Flop (didn't bet)
Seat 2: 1d0da3a7 (button) folded on the Turn
Seat 3: a592735e (small blind) won ($1)
Seat 4: 713370ec (big blind) folded before Flop
Seat 5: a2d31939 folded before Flop (didn't bet)
Seat 6: 5b1dc166 folded before Flop (didn't bet)


Poker Hand #HD1144634989: Hold'em No Limit  ($0.02/$0.05) - 2023/03/03 20:45:36
Table 'NLHBlue116' 6-max Seat #1 is the button
Seat 1: Hero ($5.61 in chips)
Seat 2: 1d0da3a7 ($5.52 in chips)
Seat 3: a592735e ($5.15 in chips)
Seat 4: 713370ec ($10.5 in chips)
Seat 5: a2d31939 ($12.16 in chips)
Seat 6: 5b1dc166 ($5.14 in chips)
1d0da3a7: posts small blind $0.02
a592735e: posts big blind $0.05
*** HOLE CARDS ***
Dealt to Hero [Js 5s]
Dealt to 1d0da3a7 
Dealt to a592735e 
Dealt to 713370ec 
Dealt to a2d31939 
Dealt to 5b1dc166 
713370ec: folds
a2d31939: raises $0.08 to $0.13
5b1dc166: folds
Hero: folds
1d0da3a7: folds
a592735e: folds
Uncalled bet ($0.08) returned to a2d31939
*** SHOWDOWN ***
a2d31939 collected $0.12 from pot
*** SUMMARY ***
Total pot $0.12 | Rake $0 | Jackpot $0 | Bingo $0 | Fortune $0
Seat 1: Hero (button) folded before Flop (didn't bet)
Seat 2: 1d0da3a7 (small blind) folded before Flop
Seat 3: a592735e (big blind) folded before Flop
Seat 4: 713370ec folded before Flop (didn't bet)
Seat 5: a2d31939 collected ($0.12)
Seat 6: 5b1dc166 folded before Flop (didn't bet)


Poker Hand #HD1144634950: Hold'em No Limit  ($0.02/$0.05) - 2023/03/03 20:45:25
Table 'NLHBlue116' 6-max Seat #6 is the button
Seat 1: Hero ($5.63 in chips)
Seat 2: 1d0da3a7 ($5.5 in chips)
Seat 3: a592735e ($5.15 in chips)
Seat 4: 713370ec ($10.5 in chips)
Seat 5: a2d31939 ($12.16 in chips)
Seat 6: 5b1dc166 ($5.14 in chips)
Hero: posts small blind $0.02
1d0da3a7: posts big blind $0.05
*** HOLE CARDS ***
Dealt to Hero [7d 3d]
Dealt to 1d0da3a7 
Dealt to a592735e 
Dealt to 713370ec 
Dealt to a2d31939 
Dealt to 5b1dc166 
a592735e: folds
713370ec: folds
a2d31939: folds
5b1dc166: folds
Hero: folds
Uncalled bet ($0.03) returned to 1d0da3a7
*** SHOWDOWN ***
1d0da3a7 collected $0.04 from pot
*** SUMMARY ***
Total pot $0.04 | Rake $0 | Jackpot $0 | Bingo $0 | Fortune $0
Seat 1: Hero (small blind) folded before Flop
Seat 2: 1d0da3a7 (big blind) collected ($0.04)
Seat 3: a592735e folded before Flop (didn't bet)
Seat 4: 713370ec folded before Flop (didn't bet)
Seat 5: a2d31939 folded before Flop (didn't bet)
Seat 6: 5b1dc166 (button) folded before Flop (didn't bet)


Poker Hand #HD1144634891: Hold'em No Limit  ($0.02/$0.05) - 2023/03/03 20:45:06
Table 'NLHBlue116' 6-max Seat #5 is the button
Seat 1: Hero ($5.68 in chips)
Seat 2: 1d0da3a7 ($5.5 in chips)
Seat 3: a592735e ($5.08 in chips)
Seat 4: 713370ec ($10.5 in chips)
Seat 5: a2d31939 ($12.16 in chips)
Seat 6: 5b1dc166 ($5.16 in chips)
5b1dc166: posts small blind $0.02
Hero: posts big blind $0.05
*** HOLE CARDS ***
Dealt to Hero [3s Kc]
Dealt to 1d0da3a7 
Dealt to a592735e 
Dealt to 713370ec 
Dealt to a2d31939 
Dealt to 5b1dc166 
1d0da3a7: folds
a592735e: raises $0.1 to $0.15
713370ec: folds
a2d31939: folds
5b1dc166: folds
Hero: folds
Uncalled bet ($0.1) returned to a592735e
*** SHOWDOWN ***
a592735e collected $0.12 from pot
*** SUMMARY ***
Total pot $0.12 | Rake $0 | Jackpot $0 | Bingo $0 | Fortune $0
Seat 1: Hero (big blind) folded before Flop
Seat 2: 1d0da3a7 folded before Flop (didn't bet)
Seat 3: a592735e collected ($0.12)
Seat 4: 713370ec folded before Flop (didn't bet)
Seat 5: a2d31939 (button) folded before Flop (didn't bet)
Seat 6: 5b1dc166 (small blind) folded before Flop


Poker Hand #HD1144634781: Hold'em No Limit  ($0.02/$0.05) - 2023/03/03 20:44:25
Table 'NLHBlue116' 6-max Seat #4 is the button
Seat 1: Hero ($5.68 in chips)
Seat 2: 1d0da3a7 ($5.5 in chips)
Seat 3: a592735e ($5.08 in chips)
Seat 4: 713370ec ($10.65 in chips)
Seat 5: a2d31939 ($11.97 in chips)
Seat 6: 5b1dc166 ($5.21 in chips)
a2d31939: posts small blind $0.02
5b1dc166: posts big blind $0.05
*** HOLE CARDS ***
Dealt to Hero [Ad 6h]
Dealt to 1d0da3a7 
Dealt to a592735e 
Dealt to 713370ec 
Dealt to a2d31939 
Dealt to 5b1dc166 
Hero: folds
1d0da3a7: folds
a592735e: folds
713370ec: raises $0.1 to $0.15
a2d31939: raises $0.55 to $0.7
5b1dc166: folds
713370ec: folds
Uncalled bet ($0.55) returned to a2d31939
*** SHOWDOWN ***
a2d31939 collected $0.34 from pot
*** SUMMARY ***
Total pot $0.35 | Rake $0.01 | Jackpot $0 | Bingo $0 | Fortune $0
Seat 1: Hero folded before Flop (didn't bet)
Seat 2: 1d0da3a7 folded before Flop (didn't bet)
Seat 3: a592735e folded before Flop (didn't bet)
Seat 4: 713370ec (button) folded before Flop
Seat 5: a2d31939 (small blind) collected ($0.34)
Seat 6: 5b1dc166 (big blind) folded before Flop


Poker Hand #HD1144634723: Hold'em No Limit  ($0.02/$0.05) - 2023/03/03 20:44:06
Table 'NLHBlue116' 6-max Seat #3 is the button
Seat 1: Hero ($5.61 in chips)
Seat 2: 1d0da3a7 ($5.5 in chips)
Seat 3: a592735e ($5.08 in chips)
Seat 4: 713370ec ($10.67 in chips)
Seat 5: a2d31939 ($12.02 in chips)
Seat 6: 5b1dc166 ($5.21 in chips)
713370ec: posts small blind $0.02
a2d31939: posts big blind $0.05
*** HOLE CARDS ***
Dealt to Hero [9d Td]
Dealt to 1d0da3a7 
Dealt to a592735e 
Dealt to 713370ec 
Dealt to a2d31939 
Dealt to 5b1dc166 
5b1dc166: folds
Hero: raises $0.07 to $0.12
1d0da3a7: folds
a592735e: folds
713370ec: folds
a2d31939: folds
Uncalled bet ($0.07) returned to Hero
*** SHOWDOWN ***
Hero collected $0.12 from pot
*** SUMMARY ***
Total pot $0.12 | Rake $0 | Jackpot $0 | Bingo $0 | Fortune $0
Seat 1: Hero collected ($0.12)
Seat 2: 1d0da3a7 folded before Flop (didn't bet)
Seat 3: a592735e (button) folded before Flop (didn't bet)
Seat 4: 713370ec (small blind) folded before Flop
Seat 5: a2d31939 (big blind) folded before Flop
Seat 6: 5b1dc166 folded before Flop (didn't bet)


Poker Hand #HD1144634688: Hold'em No Limit  ($0.02/$0.05) - 2023/03/03 20:43:52
Table 'NLHBlue116' 6-max Seat #2 is the button
Seat 1: Hero ($5.61 in chips)
Seat 2: 1d0da3a7 ($5.5 in chips)
Seat 3: a592735e ($5.1 in chips)
Seat 4: 713370ec ($10.72 in chips)
Seat 5: a2d31939 ($11.95 in chips)
Seat 6: 5b1dc166 ($5.21 in chips)
a592735e: posts small blind $0.02
713370ec: posts big blind $0.05
*** HOLE CARDS ***
Dealt to Hero [Ah 8s]
Dealt to 1d0da3a7 
Dealt to a592735e 
Dealt to 713370ec 
Dealt to a2d31939 
Dealt to 5b1dc166 
a2d31939: raises $0.08 to $0.13
5b1dc166: folds
Hero: folds
1d0da3a7: folds
a592735e: folds
713370ec: folds
Uncalled bet ($0.08) returned to a2d31939
*** SHOWDOWN ***
a2d31939 collected $0.12 from pot
*** SUMMARY ***
Total pot $0.12 | Rake $0 | Jackpot $0 | Bingo $0 | Fortune $0
Seat 1: Hero folded before Flop (didn't bet)
Seat 2: 1d0da3a7 (button) folded before Flop (didn't bet)
Seat 3: a592735e (small blind) folded before Flop
Seat 4: 713370ec (big blind) folded before Flop
Seat 5: a2d31939 collected ($0.12)
Seat 6: 5b1dc166 folded before Flop (didn't bet)


Poker Hand #HD1144634511: Hold'em No Limit  ($0.02/$0.05) - 2023/03/03 20:42:51
Table 'NLHBlue116' 6-max Seat #1 is the button
Seat 1: Hero ($5.48 in chips)
Seat 2: 1d0da3a7 ($5.52 in chips)
Seat 3: a592735e ($5.22 in chips)
Seat 4: 713370ec ($10.72 in chips)
Seat 5: a2d31939 ($11.95 in chips)
Seat 6: 5b1dc166 ($5.21 in chips)
1d0da3a7: posts small blind $0.02
a592735e: posts big blind $0.05
*** HOLE CARDS ***
Dealt to Hero [Jc Ah]
Dealt to 1d0da3a7 
Dealt to a592735e 
Dealt to 713370ec 
Dealt to a2d31939 
Dealt to 5b1dc166 
713370ec: folds
a2d31939: folds
5b1dc166: folds
Hero: raises $0.07 to $0.12
1d0da3a7: folds
a592735e: calls $0.07
*** FLOP *** [Kc 4c Td]
a592735e: checks
Hero: bets $0.13
a592735e: folds
Uncalled bet ($0.13) returned to Hero
*** SHOWDOWN ***
Hero collected $0.25 from pot
*** SUMMARY ***
Total pot $0.26 | Rake $0.01 | Jackpot $0 | Bingo $0 | Fortune $0
Board [Kc 4c Td]
Seat 1: Hero (button) won ($0.25)
Seat 2: 1d0da3a7 (small blind) folded before Flop
Seat 3: a592735e (big blind) folded on the Flop
Seat 4: 713370ec folded before Flop (didn't bet)
Seat 5: a2d31939 folded before Flop (didn't bet)
Seat 6: 5b1dc166 folded before Flop (didn't bet)


Poker Hand #HD1144634479: Hold'em No Limit  ($0.02/$0.05) - 2023/03/03 20:42:37
Table 'NLHBlue116' 6-max Seat #6 is the button
Seat 1: Hero ($5.43 in chips)
Seat 2: 1d0da3a7 ($5.57 in chips)
Seat 3: a592735e ($5.22 in chips)
Seat 4: 713370ec ($10.72 in chips)
Seat 5: a2d31939 ($11.95 in chips)
Seat 6: 5b1dc166 ($5.21 in chips)
Hero: posts small blind $0.02
1d0da3a7: posts big blind $0.05
*** HOLE CARDS ***
Dealt to Hero [3h Ad]
Dealt to 1d0da3a7 
Dealt to a592735e 
Dealt to 713370ec 
Dealt to a2d31939 
Dealt to 5b1dc166 
a592735e: folds
713370ec: folds
a2d31939: folds
5b1dc166: folds
Hero: raises $0.09 to $0.14
1d0da3a7: folds
Uncalled bet ($0.09) returned to Hero
*** SHOWDOWN ***
Hero collected $0.1 from pot
*** SUMMARY ***
Total pot $0.1 | Rake $0 | Jackpot $0 | Bingo $0 | Fortune $0
Seat 1: Hero (small blind) collected ($0.1)
Seat 2: 1d0da3a7 (big blind) folded before Flop
Seat 3: a592735e folded before Flop (didn't bet)
Seat 4: 713370ec folded before Flop (didn't bet)
Seat 5: a2d31939 folded before Flop (didn't bet)
Seat 6: 5b1dc166 (button) folded before Flop (didn't bet)


Poker Hand #HD1144634372: Hold'em No Limit  ($0.02/$0.05) - 2023/03/03 20:41:54
Table 'NLHBlue116' 6-max Seat #5 is the button
Seat 1: Hero ($5.48 in chips)
Seat 2: 1d0da3a7 ($5.57 in chips)
Seat 3: a592735e ($5.22 in chips)
Seat 4: 713370ec ($10.65 in chips)
Seat 5: a2d31939 ($11.95 in chips)
Seat 6: 5b1dc166 ($5.23 in chips)
5b1dc166: posts small blind $0.02
Hero: posts big blind $0.05
*** HOLE CARDS ***
Dealt to Hero [8h Kc]
Dealt to 1d0da3a7 
Dealt to a592735e 
Dealt to 713370ec 
Dealt to a2d31939 
Dealt to 5b1dc166 
1d0da3a7: folds
a592735e: folds
713370ec: raises $0.1 to $0.15
a2d31939: folds
5b1dc166: folds
Hero: folds
Uncalled bet ($0.1) returned to 713370ec
*** SHOWDOWN ***
713370ec collected $0.12 from pot
*** SUMMARY ***
Total pot $0.12 | Rake $0 | Jackpot $0 | Bingo $0 | Fortune $0
Seat 1: Hero (big blind) folded before Flop
Seat 2: 1d0da3a7 folded before Flop (didn't bet)
Seat 3: a592735e folded before Flop (didn't bet)
Seat 4: 713370ec collected ($0.12)
Seat 5: a2d31939 (button) folded before Flop (didn't bet)
Seat 6: 5b1dc166 (small blind) folded before Flop


Poker Hand #HD1144634338: Hold'em No Limit  ($0.02/$0.05) - 2023/03/03 20:41:42
Table 'NLHBlue116' 6-max Seat #4 is the button
Seat 1: Hero ($5.48 in chips)
Seat 2: 1d0da3a7 ($5.57 in chips)
Seat 3: a592735e ($5.22 in chips)
Seat 4: 713370ec ($10.65 in chips)
Seat 5: a2d31939 ($11.97 in chips)
Seat 6: 5b1dc166 ($5.21 in chips)
a2d31939: posts small blind $0.02
5b1dc166: posts big blind $0.05
*** HOLE CARDS ***
Dealt to Hero [5s Kc]
Dealt to 1d0da3a7 
Dealt to a592735e 
Dealt to 713370ec 
Dealt to a2d31939 
Dealt to 5b1dc166 
Hero: folds
1d0da3a7: folds
a592735e: folds
713370ec: folds
a2d31939: folds
Uncalled bet ($0.03) returned to 5b1dc166
*** SHOWDOWN ***
5b1dc166 collected $0.04 from pot
*** SUMMARY ***
Total pot $0.04 | Rake $0 | Jackpot $0 | Bingo $0 | Fortune $0
Seat 1: Hero folded before Flop (didn't bet)
Seat 2: 1d0da3a7 folded before Flop (didn't bet)
Seat 3: a592735e folded before Flop (didn't bet)
Seat 4: 713370ec (button) folded before Flop (didn't bet)
Seat 5: a2d31939 (small blind) folded before Flop
Seat 6: 5b1dc166 (big blind) collected ($0.04)


Poker Hand #HD1144634298: Hold'em No Limit  ($0.02/$0.05) - 2023/03/03 20:41:26
Table 'NLHBlue116' 6-max Seat #3 is the button
Seat 1: Hero ($5.48 in chips)
Seat 2: 1d0da3a7 ($5.57 in chips)
Seat 3: a592735e ($5.22 in chips)
Seat 4: 713370ec ($10.67 in chips)
Seat 5: a2d31939 ($12.02 in chips)
Seat 6: 5b1dc166 ($5.14 in chips)
713370ec: posts small blind $0.02
a2d31939: posts big blind $0.05
*** HOLE CARDS ***
Dealt to Hero [9h 7c]
Dealt to 1d0da3a7 
Dealt to a592735e 
Dealt to 713370ec 
Dealt to a2d31939 
Dealt to 5b1dc166 
5b1dc166: raises $0.08 to $0.13
Hero: folds
1d0da3a7: folds
a592735e: folds
713370ec: folds
a2d31939: folds
Uncalled bet ($0.08) returned to 5b1dc166
*** SHOWDOWN ***
5b1dc166 collected $0.12 from pot
*** SUMMARY ***
Total pot $0.12 | Rake $0 | Jackpot $0 | Bingo $0 | Fortune $0
Seat 1: Hero folded before Flop (didn't bet)
Seat 2: 1d0da3a7 folded before Flop (didn't bet)
Seat 3: a592735e (button) folded before Flop (didn't bet)
Seat 4: 713370ec (small blind) folded before Flop
Seat 5: a2d31939 (big blind) folded before Flop
Seat 6: 5b1dc166 collected ($0.12)


Poker Hand #HD1144634267: Hold'em No Limit  ($0.02/$0.05) - 2023/03/03 20:41:17
Table 'NLHBlue116' 6-max Seat #2 is the button
Seat 1: Hero ($5.48 in chips)
Seat 2: 1d0da3a7 ($5.57 in chips)
Seat 3: a592735e ($5.24 in chips)
Seat 4: 713370ec ($10.65 in chips)
Seat 5: a2d31939 ($12.02 in chips)
Seat 6: 5b1dc166 ($5.14 in chips)
a592735e: posts small blind $0.02
713370ec: posts big blind $0.05
*** HOLE CARDS ***
Dealt to Hero [5s Kh]
Dealt to 1d0da3a7 
Dealt to a592735e 
Dealt to 713370ec 
Dealt to a2d31939 
Dealt to 5b1dc166 
a2d31939: folds
5b1dc166: folds
Hero: folds
1d0da3a7: folds
a592735e: folds
Uncalled bet ($0.03) returned to 713370ec
*** SHOWDOWN ***
713370ec collected $0.04 from pot
*** SUMMARY ***
Total pot $0.04 | Rake $0 | Jackpot $0 | Bingo $0 | Fortune $0
Seat 1: Hero folded before Flop (didn't bet)
Seat 2: 1d0da3a7 (button) folded before Flop (didn't bet)
Seat 3: a592735e (small blind) folded before Flop
Seat 4: 713370ec (big blind) collected ($0.04)
Seat 5: a2d31939 folded before Flop (didn't bet)
Seat 6: 5b1dc166 folded before Flop (didn't bet)


Poker Hand #HD1144634217: Hold'em No Limit  ($0.02/$0.05) - 2023/03/03 20:40:58
Table 'NLHBlue116' 6-max Seat #1 is the button
Seat 1: Hero ($5.41 in chips)
Seat 2: 1d0da3a7 ($5.59 in chips)
Seat 3: a592735e ($5.29 in chips)
Seat 4: 713370ec ($10.65 in chips)
Seat 5: a2d31939 ($12.02 in chips)
Seat 6: 5b1dc166 ($5.14 in chips)
1d0da3a7: posts small blind $0.02
a592735e: posts big blind $0.05
*** HOLE CARDS ***
Dealt to Hero [Jd Qs]
Dealt to 1d0da3a7 
Dealt to a592735e 
Dealt to 713370ec 
Dealt to a2d31939 
Dealt to 5b1dc166 
713370ec: folds
a2d31939: folds
5b1dc166: folds
Hero: raises $0.07 to $0.12
1d0da3a7: folds
a592735e: folds
Uncalled bet ($0.07) returned to Hero
*** SHOWDOWN ***
Hero collected $0.12 from pot
*** SUMMARY ***
Total pot $0.12 | Rake $0 | Jackpot $0 | Bingo $0 | Fortune $0
Seat 1: Hero (button) collected ($0.12)
Seat 2: 1d0da3a7 (small blind) folded before Flop
Seat 3: a592735e (big blind) folded before Flop
Seat 4: 713370ec folded before Flop (didn't bet)
Seat 5: a2d31939 folded before Flop (didn't bet)
Seat 6: 5b1dc166 folded before Flop (didn't bet)


Poker Hand #HD1144634185: Hold'em No Limit  ($0.02/$0.05) - 2023/03/03 20:40:47
Table 'NLHBlue116' 6-max Seat #6 is the button
Seat 1: Hero ($5.43 in chips)
Seat 2: 1d0da3a7 ($5.57 in chips)
Seat 3: a592735e ($5.29 in chips)
Seat 4: 713370ec ($10.65 in chips)
Seat 5: a2d31939 ($12.02 in chips)
Seat 6: 5b1dc166 ($5.14 in chips)
Hero: posts small blind $0.02
1d0da3a7: posts big blind $0.05
*** HOLE CARDS ***
Dealt to Hero [Qd 2s]
Dealt to 1d0da3a7 
Dealt to a592735e 
Dealt to 713370ec 
Dealt to a2d31939 
Dealt to 5b1dc166 
a592735e: folds
713370ec: folds
a2d31939: folds
5b1dc166: folds
Hero: folds
Uncalled bet ($0.03) returned to 1d0da3a7
*** SHOWDOWN ***
1d0da3a7 collected $0.04 from pot
*** SUMMARY ***
Total pot $0.04 | Rake $0 | Jackpot $0 | Bingo $0 | Fortune $0
Seat 1: Hero (small blind) folded before Flop
Seat 2: 1d0da3a7 (big blind) collected ($0.04)
Seat 3: a592735e folded before Flop (didn't bet)
Seat 4: 713370ec folded before Flop (didn't bet)
Seat 5: a2d31939 folded before Flop (didn't bet)
Seat 6: 5b1dc166 (button) folded before Flop (didn't bet)


Poker Hand #HD1144634158: Hold'em No Limit  ($0.02/$0.05) - 2023/03/03 20:40:34
Table 'NLHBlue116' 6-max Seat #5 is the button
Seat 1: Hero ($5.48 in chips)
Seat 2: 1d0da3a7 ($5.57 in chips)
Seat 3: a592735e ($5.29 in chips)
Seat 4: 713370ec ($10.58 in chips)
Seat 5: a2d31939 ($12.02 in chips)
Seat 6: 5b1dc166 ($5.16 in chips)
5b1dc166: posts small blind $0.02
Hero: posts big blind $0.05
*** HOLE CARDS ***
Dealt to Hero [Qh 7c]
Dealt to 1d0da3a7 
Dealt to a592735e 
Dealt to 713370ec 
Dealt to a2d31939 
Dealt to 5b1dc166 
1d0da3a7: folds
a592735e: folds
713370ec: raises $0.1 to $0.15
a2d31939: folds
5b1dc166: folds
Hero: folds
Uncalled bet ($0.1) returned to 713370ec
*** SHOWDOWN ***
713370ec collected $0.12 from pot
*** SUMMARY ***
Total pot $0.12 | Rake $0 | Jackpot $0 | Bingo $0 | Fortune $0
Seat 1: Hero (big blind) folded before Flop
Seat 2: 1d0da3a7 folded before Flop (didn't bet)
Seat 3: a592735e folded before Flop (didn't bet)
Seat 4: 713370ec collected ($0.12)
Seat 5: a2d31939 (button) folded before Flop (didn't bet)
Seat 6: 5b1dc166 (small blind) folded before Flop


Poker Hand #HD1144634099: Hold'em No Limit  ($0.02/$0.05) - 2023/03/03 20:40:15
Table 'NLHBlue116' 6-max Seat #4 is the button
Seat 1: Hero ($5.48 in chips)
Seat 2: 1d0da3a7 ($5.5 in chips)
Seat 3: a592735e ($5.29 in chips)
Seat 4: 713370ec ($10.58 in chips)
Seat 5: a2d31939 ($12.04 in chips)
Seat 6: 5b1dc166 ($5.21 in chips)
a2d31939: posts small blind $0.02
5b1dc166: posts big blind $0.05
*** HOLE CARDS ***
Dealt to Hero [Kc 7h]
Dealt to 1d0da3a7 
Dealt to a592735e 
Dealt to 713370ec 
Dealt to a2d31939 
Dealt to 5b1dc166 
Hero: folds
1d0da3a7: raises $0.08 to $0.13
a592735e: folds
713370ec: folds
a2d31939: folds
5b1dc166: folds
Uncalled bet ($0.08) returned to 1d0da3a7
*** SHOWDOWN ***
1d0da3a7 collected $0.12 from pot
*** SUMMARY ***
Total pot $0.12 | Rake $0 | Jackpot $0 | Bingo $0 | Fortune $0
Seat 1: Hero folded before Flop (didn't bet)
Seat 2: 1d0da3a7 collected ($0.12)
Seat 3: a592735e folded before Flop (didn't bet)
Seat 4: 713370ec (button) folded before Flop (didn't bet)
Seat 5: a2d31939 (small blind) folded before Flop
Seat 6: 5b1dc166 (big blind) folded before Flop


Poker Hand #HD1144634042: Hold'em No Limit  ($0.02/$0.05) - 2023/03/03 20:39:52
Table 'NLHBlue116' 6-max Seat #3 is the button
Seat 1: Hero ($5.48 in chips)
Seat 2: 1d0da3a7 ($5.5 in chips)
Seat 3: a592735e ($5.22 in chips)
Seat 4: 713370ec ($10.6 in chips)
Seat 5: a2d31939 ($12.09 in chips)
Seat 6: 5b1dc166 ($5.21 in chips)
713370ec: posts small blind $0.02
a2d31939: posts big blind $0.05
*** HOLE CARDS ***
Dealt to Hero [9d Ks]
Dealt to 1d0da3a7 
Dealt to a592735e 
Dealt to 713370ec 
Dealt to a2d31939 
Dealt to 5b1dc166 
5b1dc166: folds
Hero: folds
1d0da3a7: folds
a592735e: raises $0.08 to $0.13
713370ec: folds
a2d31939: folds
Uncalled bet ($0.08) returned to a592735e
*** SHOWDOWN ***
a592735e collected $0.12 from pot
*** SUMMARY ***
Total pot $0.12 | Rake $0 | Jackpot $0 | Bingo $0 | Fortune $0
Seat 1: Hero folded before Flop (didn't bet)
Seat 2: 1d0da3a7 folded before Flop (didn't bet)
Seat 3: a592735e (button) collected ($0.12)
Seat 4: 713370ec (small blind) folded before Flop
Seat 5: a2d31939 (big blind) folded before Flop
Seat 6: 5b1dc166 folded before Flop (didn't bet)


Poker Hand #HD1144633999: Hold'em No Limit  ($0.02/$0.05) - 2023/03/03 20:39:32
Table 'NLHBlue116' 6-max Seat #2 is the button
Seat 1: Hero ($5.48 in chips)
Seat 2: 1d0da3a7 ($5.5 in chips)
Seat 3: a592735e ($5.24 in chips)
Seat 4: 713370ec ($10.65 in chips)
Seat 5: a2d31939 ($12.09 in chips)
Seat 6: 5b1dc166 ($5.14 in chips)
a592735e: posts small blind $0.02
713370ec: posts big blind $0.05
*** HOLE CARDS ***
Dealt to Hero [5h 8c]
Dealt to 1d0da3a7 
Dealt to a592735e 
Dealt to 713370ec 
Dealt to a2d31939 
Dealt to 5b1dc166 
a2d31939: folds
5b1dc166: raises $0.08 to $0.13
Hero: folds
1d0da3a7: folds
a592735e: folds
713370ec: folds
Uncalled bet ($0.08) returned to 5b1dc166
*** SHOWDOWN ***
5b1dc166 collected $0.12 from pot
*** SUMMARY ***
Total pot $0.12 | Rake $0 | Jackpot $0 | Bingo $0 | Fortune $0
Seat 1: Hero folded before Flop (didn't bet)
Seat 2: 1d0da3a7 (button) folded before Flop (didn't bet)
Seat 3: a592735e (small blind) folded before Flop
Seat 4: 713370ec (big blind) folded before Flop
Seat 5: a2d31939 folded before Flop (didn't bet)
Seat 6: 5b1dc166 collected ($0.12)


Poker Hand #HD1144633820: Hold'em No Limit  ($0.02/$0.05) - 2023/03/03 20:38:28
Table 'NLHBlue116' 6-max Seat #1 is the button
Seat 1: Hero ($5.6 in chips)
Seat 2: 1d0da3a7 ($5.52 in chips)
Seat 3: a592735e ($5.11 in chips)
Seat 4: 713370ec ($10.65 in chips)
Seat 5: a2d31939 ($12.09 in chips)
Seat 6: 5b1dc166 ($5.14 in chips)
1d0da3a7: posts small blind $0.02
a592735e: posts big blind $0.05
*** HOLE CARDS ***
Dealt to Hero [8s Ts]
Dealt to 1d0da3a7 
Dealt to a592735e 
Dealt to 713370ec 
Dealt to a2d31939 
Dealt to 5b1dc166 
713370ec: folds
a2d31939: folds
5b1dc166: folds
Hero: raises $0.07 to $0.12
1d0da3a7: folds
a592735e: calls $0.07
*** FLOP *** [2s 5c Qh]
a592735e: checks
Hero: checks
*** TURN *** [2s 5c Qh] [4h]
a592735e: checks
Hero: checks
*** RIVER *** [2s 5c Qh 4h] [7d]
a592735e: checks
Hero: checks
a592735e: shows [7s Ac] (Pair of Sevens)
Hero: shows [8s Ts] (Queen-High)
*** SHOWDOWN ***
a592735e collected $0.25 from pot
*** SUMMARY ***
Total pot $0.26 | Rake $0.01 | Jackpot $0 | Bingo $0 | Fortune $0
Board [2s 5c Qh 4h 7d]
Seat 1: Hero (button) showed [8s Ts] and lost with Queen-High
Seat 2: 1d0da3a7 (small blind) folded before Flop
Seat 3: a592735e (big blind) showed [7s Ac] and won ($0.25) with Pair of Sevens
Seat 4: 713370ec folded before Flop (didn't bet)
Seat 5: a2d31939 folded before Flop (didn't bet)
Seat 6: 5b1dc166 folded before Flop (didn't bet)


Poker Hand #HD1144633781: Hold'em No Limit  ($0.02/$0.05) - 2023/03/03 20:38:14
Table 'NLHBlue116' 6-max Seat #6 is the button
Seat 1: Hero ($5.62 in chips)
Seat 2: 1d0da3a7 ($5.5 in chips)
Seat 3: a592735e ($5.11 in chips)
Seat 4: 713370ec ($10.65 in chips)
Seat 5: a2d31939 ($12.09 in chips)
Seat 6: 5b1dc166 ($5.14 in chips)
Hero: posts small blind $0.02
1d0da3a7: posts big blind $0.05
*** HOLE CARDS ***
Dealt to Hero [Th 5d]
Dealt to 1d0da3a7 
Dealt to a592735e 
Dealt to 713370ec 
Dealt to a2d31939 
Dealt to 5b1dc166 
a592735e: folds
713370ec: folds
a2d31939: folds
5b1dc166: folds
Hero: folds
Uncalled bet ($0.03) returned to 1d0da3a7
*** SHOWDOWN ***
1d0da3a7 collected $0.04 from pot
*** SUMMARY ***
Total pot $0.04 | Rake $0 | Jackpot $0 | Bingo $0 | Fortune $0
Seat 1: Hero (small blind) folded before Flop
Seat 2: 1d0da3a7 (big blind) collected ($0.04)
Seat 3: a592735e folded before Flop (didn't bet)
Seat 4: 713370ec folded before Flop (didn't bet)
Seat 5: a2d31939 folded before Flop (didn't bet)
Seat 6: 5b1dc166 (button) folded before Flop (didn't bet)


Poker Hand #HD1144633691: Hold'em No Limit  ($0.02/$0.05) - 2023/03/03 20:37:44
Table 'NLHBlue116' 6-max Seat #5 is the button
Seat 1: Hero ($5.67 in chips)
Seat 2: 1d0da3a7 ($5.07 in chips)
Seat 3: a592735e ($5.11 in chips)
Seat 4: 713370ec ($10.65 in chips)
Seat 5: a2d31939 ($12.49 in chips)
Seat 6: 5b1dc166 ($5.16 in chips)
5b1dc166: posts small blind $0.02
Hero: posts big blind $0.05
*** HOLE CARDS ***
Dealt to Hero [Jc 4d]
Dealt to 1d0da3a7 
Dealt to a592735e 
Dealt to 713370ec 
Dealt to a2d31939 
Dealt to 5b1dc166 
1d0da3a7: raises $0.08 to $0.13
a592735e: folds
713370ec: folds
a2d31939: raises $0.27 to $0.4
5b1dc166: folds
Hero: folds
1d0da3a7: raises $4.67 to $5.07 and is all-in
a2d31939: folds
Uncalled bet ($4.67) returned to 1d0da3a7
*** SHOWDOWN ***
1d0da3a7 collected $0.83 from pot
*** SUMMARY ***
Total pot $0.87 | Rake $0.04 | Jackpot $0 | Bingo $0 | Fortune $0
Seat 1: Hero (big blind) folded before Flop
Seat 2: 1d0da3a7 collected ($0.83)
Seat 3: a592735e folded before Flop (didn't bet)
Seat 4: 713370ec folded before Flop (didn't bet)
Seat 5: a2d31939 (button) folded before Flop
Seat 6: 5b1dc166 (small blind) folded before Flop


Poker Hand #HD1144633651: Hold'em No Limit  ($0.02/$0.05) - 2023/03/03 20:37:29
Table 'NLHBlue116' 6-max Seat #4 is the button
Seat 1: Hero ($5.67 in chips)
Seat 2: 1d0da3a7 ($5 in chips)
Seat 3: a592735e ($5.11 in chips)
Seat 4: 713370ec ($10.65 in chips)
Seat 5: a2d31939 ($12.51 in chips)
Seat 6: 5b1dc166 ($5.21 in chips)
a2d31939: posts small blind $0.02
5b1dc166: posts big blind $0.05
*** HOLE CARDS ***
Dealt to Hero [Jd Ks]
Dealt to 1d0da3a7 
Dealt to a592735e 
Dealt to 713370ec 
Dealt to a2d31939 
Dealt to 5b1dc166 
Hero: folds
1d0da3a7: raises $0.08 to $0.13
a592735e: folds
713370ec: folds
a2d31939: folds
5b1dc166: folds
Uncalled bet ($0.08) returned to 1d0da3a7
*** SHOWDOWN ***
1d0da3a7 collected $0.12 from pot
*** SUMMARY ***
Total pot $0.12 | Rake $0 | Jackpot $0 | Bingo $0 | Fortune $0
Seat 1: Hero folded before Flop (didn't bet)
Seat 2: 1d0da3a7 collected ($0.12)
Seat 3: a592735e folded before Flop (didn't bet)
Seat 4: 713370ec (button) folded before Flop (didn't bet)
Seat 5: a2d31939 (small blind) folded before Flop
Seat 6: 5b1dc166 (big blind) folded before Flop


Poker Hand #HD1144633561: Hold'em No Limit  ($0.02/$0.05) - 2023/03/03 20:36:57
Table 'NLHBlue116' 6-max Seat #3 is the button
Seat 1: Hero ($5.54 in chips)
Seat 2: 1d0da3a7 ($5 in chips)
Seat 3: a592735e ($5.11 in chips)
Seat 4: 713370ec ($10.67 in chips)
Seat 5: a2d31939 ($12.63 in chips)
Seat 6: 5b1dc166 ($5.21 in chips)
713370ec: posts small blind $0.02
a2d31939: posts big blind $0.05
*** HOLE CARDS ***
Dealt to Hero [7d 8d]
Dealt to 1d0da3a7 
Dealt to a592735e 
Dealt to 713370ec 
Dealt to a2d31939 
Dealt to 5b1dc166 
5b1dc166: folds
Hero: raises $0.07 to $0.12
1d0da3a7: folds
a592735e: folds
713370ec: folds
a2d31939: calls $0.07
*** FLOP *** [8c 7s Ad]
a2d31939: checks
Hero: bets $0.2
a2d31939: folds
Uncalled bet ($0.2) returned to Hero
*** SHOWDOWN ***
Hero collected $0.25 from pot
*** SUMMARY ***
Total pot $0.26 | Rake $0.01 | Jackpot $0 | Bingo $0 | Fortune $0
Board [8c 7s Ad]
Seat 1: Hero won ($0.25)
Seat 2: 1d0da3a7 folded before Flop (didn't bet)
Seat 3: a592735e (button) folded before Flop (didn't bet)
Seat 4: 713370ec (small blind) folded before Flop
Seat 5: a2d31939 (big blind) folded on the Flop
Seat 6: 5b1dc166 folded before Flop (didn't bet)


Poker Hand #HD1144633521: Hold'em No Limit  ($0.02/$0.05) - 2023/03/03 20:36:42
Table 'NLHBlue116' 6-max Seat #2 is the button
Seat 1: Hero ($5.54 in chips)
Seat 2: 1d0da3a7 ($5 in chips)
Seat 3: a592735e ($5.13 in chips)
Seat 4: 713370ec ($10.72 in chips)
Seat 5: a2d31939 ($12.56 in chips)
Seat 6: 5b1dc166 ($5.21 in chips)
a592735e: posts small blind $0.02
713370ec: posts big blind $0.05
*** HOLE CARDS ***
Dealt to Hero [7s 3d]
Dealt to 1d0da3a7 
Dealt to a592735e 
Dealt to 713370ec 
Dealt to a2d31939 
Dealt to 5b1dc166 
a2d31939: raises $0.08 to $0.13
5b1dc166: folds
Hero: folds
1d0da3a7: folds
a592735e: folds
713370ec: folds
Uncalled bet ($0.08) returned to a2d31939
*** SHOWDOWN ***
a2d31939 collected $0.12 from pot
*** SUMMARY ***
Total pot $0.12 | Rake $0 | Jackpot $0 | Bingo $0 | Fortune $0
Seat 1: Hero folded before Flop (didn't bet)
Seat 2: 1d0da3a7 (button) folded before Flop (didn't bet)
Seat 3: a592735e (small blind) folded before Flop
Seat 4: 713370ec (big blind) folded before Flop
Seat 5: a2d31939 collected ($0.12)
Seat 6: 5b1dc166 folded before Flop (didn't bet)


Poker Hand #HD1144633393: Hold'em No Limit  ($0.02/$0.05) - 2023/03/03 20:35:58
Table 'NLHBlue116' 6-max Seat #1 is the button
Seat 1: Hero ($5.66 in chips)
Seat 2: 1d0da3a7 ($5 in chips)
Seat 3: a592735e ($5 in chips)
Seat 4: 713370ec ($10.72 in chips)
Seat 5: a2d31939 ($12.56 in chips)
Seat 6: 5b1dc166 ($5.21 in chips)
1d0da3a7: posts small blind $0.02
a592735e: posts big blind $0.05
*** HOLE CARDS ***
Dealt to Hero [5s 7s]
Dealt to 1d0da3a7 
Dealt to a592735e 
Dealt to 713370ec 
Dealt to a2d31939 
Dealt to 5b1dc166 
713370ec: folds
a2d31939: folds
5b1dc166: folds
Hero: raises $0.07 to $0.12
1d0da3a7: folds
a592735e: calls $0.07
*** FLOP *** [4c Kd 3c]
a592735e: checks
Hero: checks
*** TURN *** [4c Kd 3c] [9d]
a592735e: checks
Hero: checks
*** RIVER *** [4c Kd 3c 9d] [Qd]
a592735e: checks
Hero: checks
a592735e: shows [8s Ac] (Ace-High)
Hero: shows [5s 7s] (King-High)
*** SHOWDOWN ***
a592735e collected $0.25 from pot
*** SUMMARY ***
Total pot $0.26 | Rake $0.01 | Jackpot $0 | Bingo $0 | Fortune $0
Board [4c Kd 3c 9d Qd]
Seat 1: Hero (button) showed [5s 7s] and lost with King-High
Seat 2: 1d0da3a7 (small blind) folded before Flop
Seat 3: a592735e (big blind) showed [8s Ac] and won ($0.25) with Ace-High
Seat 4: 713370ec folded before Flop (didn't bet)
Seat 5: a2d31939 folded before Flop (didn't bet)
Seat 6: 5b1dc166 folded before Flop (didn't bet)


Poker Hand #HD1144633130: Hold'em No Limit  ($0.02/$0.05) - 2023/03/03 20:34:22
Table 'NLHBlue116' 6-max Seat #6 is the button
Seat 1: Hero ($5.68 in chips)
Seat 2: 1d0da3a7 ($6.27 in chips)
Seat 3: a592735e ($5 in chips)
Seat 4: 713370ec ($10.72 in chips)
Seat 5: a2d31939 ($11.26 in chips)
Seat 6: 5b1dc166 ($5.21 in chips)
Hero: posts small blind $0.02
1d0da3a7: posts big blind $0.05
*** HOLE CARDS ***
Dealt to Hero [6c 2c]
Dealt to 1d0da3a7 
Dealt to a592735e 
Dealt to 713370ec 
Dealt to a2d31939 
Dealt to 5b1dc166 
a592735e: folds
713370ec: folds
a2d31939: raises $0.08 to $0.13
5b1dc166: folds
Hero: folds
1d0da3a7: calls $0.08
*** FLOP *** [9d Td 8d]
1d0da3a7: checks
a2d31939: bets $0.1
1d0da3a7: raises $0.36 to $0.46
a2d31939: calls $0.36
*** TURN *** [9d Td 8d] [5c]
1d0da3a7: bets $0.88
a2d31939: calls $0.88
*** RIVER *** [9d Td 8d 5c] [Ac]
1d0da3a7: checks
a2d31939: bets $1.25
1d0da3a7: folds
Uncalled bet ($1.25) returned to a2d31939
*** SHOWDOWN ***
a2d31939 collected $2.77 from pot
*** SUMMARY ***
Total pot $2.96 | Rake $0.14 | Jackpot $0.05 | Bingo $0 | Fortune $0
Board [9d Td 8d 5c Ac]
Seat 1: Hero (small blind) folded before Flop
Seat 2: 1d0da3a7 (big blind) folded on the River
Seat 3: a592735e folded before Flop (didn't bet)
Seat 4: 713370ec folded before Flop (didn't bet)
Seat 5: a2d31939 won ($2.77)
Seat 6: 5b1dc166 (button) folded before Flop (didn't bet)


Poker Hand #HD1144633051: Hold'em No Limit  ($0.02/$0.05) - 2023/03/03 20:33:56
Table 'NLHBlue116' 6-max Seat #5 is the button
Seat 1: Hero ($5.52 in chips)
Seat 2: 1d0da3a7 ($6.27 in chips)
Seat 3: a592735e ($5 in chips)
Seat 4: 713370ec ($10.87 in chips)
Seat 5: a2d31939 ($11.26 in chips)
Seat 6: 5b1dc166 ($5.23 in chips)
5b1dc166: posts small blind $0.02
Hero: posts big blind $0.05
*** HOLE CARDS ***
Dealt to Hero [Th Ks]
Dealt to 1d0da3a7 
Dealt to a592735e 
Dealt to 713370ec 
Dealt to a2d31939 
Dealt to 5b1dc166 
1d0da3a7: folds
a592735e: folds
713370ec: raises $0.1 to $0.15
a2d31939: folds
5b1dc166: folds
Hero: calls $0.1
*** FLOP *** [8c 5s 8d]
Hero: checks
713370ec: checks
*** TURN *** [8c 5s 8d] [Kc]
Hero: bets $0.24
713370ec: folds
Uncalled bet ($0.24) returned to Hero
*** SHOWDOWN ***
Hero collected $0.31 from pot
*** SUMMARY ***
Total pot $0.32 | Rake $0.01 | Jackpot $0 | Bingo $0 | Fortune $0
Board [8c 5s 8d Kc]
Seat 1: Hero (big blind) won ($0.31)
Seat 2: 1d0da3a7 folded before Flop (didn't bet)
Seat 3: a592735e folded before Flop (didn't bet)
Seat 4: 713370ec folded on the Turn
Seat 5: a2d31939 (button) folded before Flop (didn't bet)
Seat 6: 5b1dc166 (small blind) folded before Flop


Poker Hand #HD1144632894: Hold'em No Limit  ($0.02/$0.05) - 2023/03/03 20:33:01
Table 'NLHBlue116' 6-max Seat #4 is the button
Seat 1: Hero ($5.52 in chips)
Seat 2: 1d0da3a7 ($6.27 in chips)
Seat 3: a592735e ($5 in chips)
Seat 4: 713370ec ($10.57 in chips)
Seat 5: a2d31939 ($11.28 in chips)
Seat 6: 5b1dc166 ($5.54 in chips)
a2d31939: posts small blind $0.02
5b1dc166: posts big blind $0.05
*** HOLE CARDS ***
Dealt to Hero [Th 5h]
Dealt to 1d0da3a7 
Dealt to a592735e 
Dealt to 713370ec 
Dealt to a2d31939 
Dealt to 5b1dc166 
Hero: folds
1d0da3a7: folds
a592735e: folds
713370ec: raises $0.1 to $0.15
a2d31939: folds
5b1dc166: calls $0.1
*** FLOP *** [Ac 5d 7d]
5b1dc166: checks
713370ec: bets $0.16
5b1dc166: calls $0.16
*** TURN *** [Ac 5d 7d] [Td]
5b1dc166: checks
713370ec: checks
*** RIVER *** [Ac 5d 7d Td] [Qh]
5b1dc166: checks
713370ec: bets $0.22
5b1dc166: folds
Uncalled bet ($0.22) returned to 713370ec
*** SHOWDOWN ***
713370ec collected $0.61 from pot
*** SUMMARY ***
Total pot $0.64 | Rake $0.03 | Jackpot $0 | Bingo $0 | Fortune $0
Board [Ac 5d 7d Td Qh]
Seat 1: Hero folded before Flop (didn't bet)
Seat 2: 1d0da3a7 folded before Flop (didn't bet)
Seat 3: a592735e folded before Flop (didn't bet)
Seat 4: 713370ec (button) won ($0.61)
Seat 5: a2d31939 (small blind) folded before Flop
Seat 6: 5b1dc166 (big blind) folded on the River


Poker Hand #HD1144632805: Hold'em No Limit  ($0.02/$0.05) - 2023/03/03 20:32:34
Table 'NLHBlue116' 6-max Seat #3 is the button
Seat 1: Hero ($5.52 in chips)
Seat 2: 1d0da3a7 ($6.27 in chips)
Seat 3: a592735e ($5 in chips)
Seat 4: 713370ec ($10.59 in chips)
Seat 5: a2d31939 ($11.26 in chips)
Seat 6: 5b1dc166 ($5.54 in chips)
713370ec: posts small blind $0.02
a2d31939: posts big blind $0.05
*** HOLE CARDS ***
Dealt to Hero [4c Ad]
Dealt to 1d0da3a7 
Dealt to a592735e 
Dealt to 713370ec 
Dealt to a2d31939 
Dealt to 5b1dc166 
5b1dc166: folds
Hero: folds
1d0da3a7: folds
a592735e: folds
713370ec: folds
Uncalled bet ($0.03) returned to a2d31939
*** SHOWDOWN ***
a2d31939 collected $0.04 from pot
*** SUMMARY ***
Total pot $0.04 | Rake $0 | Jackpot $0 | Bingo $0 | Fortune $0
Seat 1: Hero folded before Flop (didn't bet)
Seat 2: 1d0da3a7 folded before Flop (didn't bet)
Seat 3: a592735e (button) folded before Flop (didn't bet)
Seat 4: 713370ec (small blind) folded before Flop
Seat 5: a2d31939 (big blind) collected ($0.04)
Seat 6: 5b1dc166 folded before Flop (didn't bet)


Poker Hand #HD1144632709: Hold'em No Limit  ($0.02/$0.05) - 2023/03/03 20:32:00
Table 'NLHBlue116' 6-max Seat #2 is the button
Seat 1: Hero ($5.52 in chips)
Seat 2: 1d0da3a7 ($6.4 in chips)
Seat 3: a592735e ($5 in chips)
Seat 4: 713370ec ($10.45 in chips)
Seat 5: a2d31939 ($11.26 in chips)
Seat 6: 5b1dc166 ($5.54 in chips)
a592735e: posts small blind $0.02
713370ec: posts big blind $0.05
*** HOLE CARDS ***
Dealt to Hero [6c Jh]
Dealt to 1d0da3a7 
Dealt to a592735e 
Dealt to 713370ec 
Dealt to a2d31939 
Dealt to 5b1dc166 
a2d31939: folds
5b1dc166: folds
Hero: folds
1d0da3a7: raises $0.08 to $0.13
a592735e: folds
713370ec: raises $0.39 to $0.52
1d0da3a7: folds
Uncalled bet ($0.39) returned to 713370ec
*** SHOWDOWN ***
713370ec collected $0.27 from pot
*** SUMMARY ***
Total pot $0.28 | Rake $0.01 | Jackpot $0 | Bingo $0 | Fortune $0
Seat 1: Hero folded before Flop (didn't bet)
Seat 2: 1d0da3a7 (button) folded before Flop
Seat 3: a592735e (small blind) folded before Flop
Seat 4: 713370ec (big blind) collected ($0.27)
Seat 5: a2d31939 folded before Flop (didn't bet)
Seat 6: 5b1dc166 folded before Flop (didn't bet)


Poker Hand #HD1144632655: Hold'em No Limit  ($0.02/$0.05) - 2023/03/03 20:31:42
Table 'NLHBlue116' 6-max Seat #1 is the button
Seat 1: Hero ($5.52 in chips)
Seat 2: 1d0da3a7 ($6.42 in chips)
Seat 3: a592735e ($5 in chips)
Seat 4: 713370ec ($10.45 in chips)
Seat 5: a2d31939 ($11.19 in chips)
Seat 6: 5b1dc166 ($5.54 in chips)
1d0da3a7: posts small blind $0.02
a592735e: posts big blind $0.05
*** HOLE CARDS ***
Dealt to Hero [8d Ac]
Dealt to 1d0da3a7 
Dealt to a592735e 
Dealt to 713370ec 
Dealt to a2d31939 
Dealt to 5b1dc166 
713370ec: folds
a2d31939: raises $0.08 to $0.13
5b1dc166: folds
Hero: folds
1d0da3a7: folds
a592735e: folds
Uncalled bet ($0.08) returned to a2d31939
*** SHOWDOWN ***
a2d31939 collected $0.12 from pot
*** SUMMARY ***
Total pot $0.12 | Rake $0 | Jackpot $0 | Bingo $0 | Fortune $0
Seat 1: Hero (button) folded before Flop (didn't bet)
Seat 2: 1d0da3a7 (small blind) folded before Flop
Seat 3: a592735e (big blind) folded before Flop
Seat 4: 713370ec folded before Flop (didn't bet)
Seat 5: a2d31939 collected ($0.12)
Seat 6: 5b1dc166 folded before Flop (didn't bet)


Poker Hand #HD1144632614: Hold'em No Limit  ($0.02/$0.05) - 2023/03/03 20:31:26
Table 'NLHBlue116' 6-max Seat #6 is the button
Seat 1: Hero ($5.54 in chips)
Seat 2: 1d0da3a7 ($6.47 in chips)
Seat 3: a592735e ($5 in chips)
Seat 4: 713370ec ($10.45 in chips)
Seat 5: a2d31939 ($11.12 in chips)
Seat 6: 5b1dc166 ($5.54 in chips)
Hero: posts small blind $0.02
1d0da3a7: posts big blind $0.05
*** HOLE CARDS ***
Dealt to Hero [Ts Kc]
Dealt to 1d0da3a7 
Dealt to a592735e 
Dealt to 713370ec 
Dealt to a2d31939 
Dealt to 5b1dc166 
a592735e: folds
713370ec: folds
a2d31939: raises $0.08 to $0.13
5b1dc166: folds
Hero: folds
1d0da3a7: folds
Uncalled bet ($0.08) returned to a2d31939
*** SHOWDOWN ***
a2d31939 collected $0.12 from pot
*** SUMMARY ***
Total pot $0.12 | Rake $0 | Jackpot $0 | Bingo $0 | Fortune $0
Seat 1: Hero (small blind) folded before Flop
Seat 2: 1d0da3a7 (big blind) folded before Flop
Seat 3: a592735e folded before Flop (didn't bet)
Seat 4: 713370ec folded before Flop (didn't bet)
Seat 5: a2d31939 collected ($0.12)
Seat 6: 5b1dc166 (button) folded before Flop (didn't bet)


Poker Hand #HD1144632470: Hold'em No Limit  ($0.02/$0.05) - 2023/03/03 20:30:37
Table 'NLHBlue116' 6-max Seat #5 is the button
Seat 1: Hero ($5.59 in chips)
Seat 2: 1d0da3a7 ($6.47 in chips)
Seat 3: a592735e ($5 in chips)
Seat 4: 713370ec ($10.45 in chips)
Seat 5: a2d31939 ($10.91 in chips)
Seat 6: 5b1dc166 ($5.56 in chips)
5b1dc166: posts small blind $0.02
Hero: posts big blind $0.05
*** HOLE CARDS ***
Dealt to Hero [3d 9c]
Dealt to 1d0da3a7 
Dealt to a592735e 
Dealt to 713370ec 
Dealt to a2d31939 
Dealt to 5b1dc166 
1d0da3a7: folds
a592735e: raises $0.1 to $0.15
713370ec: folds
a2d31939: raises $0.3 to $0.45
5b1dc166: folds
Hero: folds
a592735e: folds
Uncalled bet ($0.3) returned to a2d31939
*** SHOWDOWN ***
a2d31939 collected $0.36 from pot
*** SUMMARY ***
Total pot $0.37 | Rake $0.01 | Jackpot $0 | Bingo $0 | Fortune $0
Seat 1: Hero (big blind) folded before Flop
Seat 2: 1d0da3a7 folded before Flop (didn't bet)
Seat 3: a592735e folded before Flop
Seat 4: 713370ec folded before Flop (didn't bet)
Seat 5: a2d31939 (button) collected ($0.36)
Seat 6: 5b1dc166 (small blind) folded before Flop


Poker Hand #HD1144632370: Hold'em No Limit  ($0.02/$0.05) - 2023/03/03 20:30:02
Table 'NLHBlue116' 6-max Seat #4 is the button
Seat 1: Hero ($5.59 in chips)
Seat 2: 1d0da3a7 ($6.47 in chips)
Seat 3: a592735e ($5 in chips)
Seat 4: 713370ec ($10.26 in chips)
Seat 5: a2d31939 ($10.93 in chips)
Seat 6: 5b1dc166 ($5.61 in chips)
a2d31939: posts small blind $0.02
5b1dc166: posts big blind $0.05
*** HOLE CARDS ***
Dealt to Hero [5c Kh]
Dealt to 1d0da3a7 
Dealt to a592735e 
Dealt to 713370ec 
Dealt to a2d31939 
Dealt to 5b1dc166 
Hero: folds
1d0da3a7: folds
a592735e: raises $0.08 to $0.13
713370ec: calls $0.13
a2d31939: folds
5b1dc166: folds
*** FLOP *** [6s 2h Js]
a592735e: checks
713370ec: bets $0.17
a592735e: folds
Uncalled bet ($0.17) returned to 713370ec
*** SHOWDOWN ***
713370ec collected $0.32 from pot
*** SUMMARY ***
Total pot $0.33 | Rake $0.01 | Jackpot $0 | Bingo $0 | Fortune $0
Board [6s 2h Js]
Seat 1: Hero folded before Flop (didn't bet)
Seat 2: 1d0da3a7 folded before Flop (didn't bet)
Seat 3: a592735e folded on the Flop
Seat 4: 713370ec (button) won ($0.32)
Seat 5: a2d31939 (small blind) folded before Flop
Seat 6: 5b1dc166 (big blind) folded before Flop


Poker Hand #HD1144632338: Hold'em No Limit  ($0.02/$0.05) - 2023/03/03 20:29:49
Table 'NLHBlue116' 6-max Seat #3 is the button
Seat 1: Hero ($5.59 in chips)
Seat 2: 1d0da3a7 ($6.47 in chips)
Seat 3: a592735e ($5 in chips)
Seat 4: 713370ec ($10.28 in chips)
Seat 5: a2d31939 ($10.91 in chips)
713370ec: posts small blind $0.02
a2d31939: posts big blind $0.05
*** HOLE CARDS ***
Dealt to Hero [7h 9d]
Dealt to 1d0da3a7 
Dealt to a592735e 
Dealt to 713370ec 
Dealt to a2d31939 
Hero: folds
1d0da3a7: folds
a592735e: folds
713370ec: folds
Uncalled bet ($0.03) returned to a2d31939
*** SHOWDOWN ***
a2d31939 collected $0.04 from pot
*** SUMMARY ***
Total pot $0.04 | Rake $0 | Jackpot $0 | Bingo $0 | Fortune $0
Seat 1: Hero folded before Flop (didn't bet)
Seat 2: 1d0da3a7 folded before Flop (didn't bet)
Seat 3: a592735e (button) folded before Flop (didn't bet)
Seat 4: 713370ec (small blind) folded before Flop
Seat 5: a2d31939 (big blind) collected ($0.04)


Poker Hand #HD1144632187: Hold'em No Limit  ($0.02/$0.05) - 2023/03/03 20:28:56
Table 'NLHBlue116' 6-max Seat #2 is the button
Seat 1: Hero ($5.59 in chips)
Seat 2: 1d0da3a7 ($6.47 in chips)
Seat 3: a592735e ($5.02 in chips)
Seat 4: 713370ec ($9.6 in chips)
Seat 5: a2d31939 ($11.69 in chips)
a592735e: posts small blind $0.02
713370ec: posts big blind $0.05
*** HOLE CARDS ***
Dealt to Hero [5s Ad]
Dealt to 1d0da3a7 
Dealt to a592735e 
Dealt to 713370ec 
Dealt to a2d31939 
a2d31939: raises $0.08 to $0.13
Hero: folds
1d0da3a7: folds
a592735e: folds
713370ec: calls $0.08
*** FLOP *** [Th 8d 4h]
713370ec: checks
a2d31939: bets $0.2
713370ec: calls $0.2
*** TURN *** [Th 8d 4h] [8h]
713370ec: checks
a2d31939: bets $0.45
713370ec: calls $0.45
*** RIVER *** [Th 8d 4h 8h] [Ac]
713370ec: checks
a2d31939: checks
713370ec: shows [Qh Ah] (Ace High Flush)
a2d31939: shows [Kh Ks] (Pair of Kings and Pair of Eights)
*** SHOWDOWN ***
713370ec collected $1.46 from pot
*** SUMMARY ***
Total pot $1.58 | Rake $0.07 | Jackpot $0.05 | Bingo $0 | Fortune $0
Board [Th 8d 4h 8h Ac]
Seat 1: Hero folded before Flop (didn't bet)
Seat 2: 1d0da3a7 (button) folded before Flop (didn't bet)
Seat 3: a592735e (small blind) folded before Flop
Seat 4: 713370ec (big blind) showed [Qh Ah] and won ($1.46) with Ace High Flush
Seat 5: a2d31939 showed [Kh Ks] and lost with Pair of Kings and Pair of Eights


Poker Hand #HD1144632106: Hold'em No Limit  ($0.02/$0.05) - 2023/03/03 20:28:31
Table 'NLHBlue116' 6-max Seat #1 is the button
Seat 1: Hero ($5.59 in chips)
Seat 2: 1d0da3a7 ($6.49 in chips)
Seat 3: a592735e ($5.07 in chips)
Seat 4: 713370ec ($9.53 in chips)
1d0da3a7: posts small blind $0.02
a592735e: posts big blind $0.05
*** HOLE CARDS ***
Dealt to Hero [8c Th]
Dealt to 1d0da3a7 
Dealt to a592735e 
Dealt to 713370ec 
713370ec: raises $0.1 to $0.15
Hero: folds
1d0da3a7: folds
a592735e: folds
Uncalled bet ($0.1) returned to 713370ec
*** SHOWDOWN ***
713370ec collected $0.12 from pot
*** SUMMARY ***
Total pot $0.12 | Rake $0 | Jackpot $0 | Bingo $0 | Fortune $0
Seat 1: Hero (button) folded before Flop (didn't bet)
Seat 2: 1d0da3a7 (small blind) folded before Flop
Seat 3: a592735e (big blind) folded before Flop
Seat 4: 713370ec collected ($0.12)


Poker Hand #HD1144631998: Hold'em No Limit  ($0.02/$0.05) - 2023/03/03 20:27:54
Table 'NLHBlue116' 6-max Seat #5 is the button
Seat 1: Hero ($5.54 in chips)
Seat 2: 1d0da3a7 ($6.54 in chips)
Seat 3: a592735e ($5.07 in chips)
Seat 4: 713370ec ($9.53 in chips)
Seat 5: a2d31939 ($11.69 in chips)
Hero: posts small blind $0.02
1d0da3a7: posts big blind $0.05
*** HOLE CARDS ***
Dealt to Hero [9c Qs]
Dealt to 1d0da3a7 
Dealt to a592735e 
Dealt to 713370ec 
Dealt to a2d31939 
a592735e: folds
713370ec: folds
a2d31939: folds
Hero: raises $0.09 to $0.14
1d0da3a7: folds
Uncalled bet ($0.09) returned to Hero
*** SHOWDOWN ***
Hero collected $0.1 from pot
*** SUMMARY ***
Total pot $0.1 | Rake $0 | Jackpot $0 | Bingo $0 | Fortune $0
Seat 1: Hero (small blind) collected ($0.1)
Seat 2: 1d0da3a7 (big blind) folded before Flop
Seat 3: a592735e folded before Flop (didn't bet)
Seat 4: 713370ec folded before Flop (didn't bet)
Seat 5: a2d31939 (button) folded before Flop (didn't bet)


Poker Hand #HD1144631943: Hold'em No Limit  ($0.02/$0.05) - 2023/03/03 20:27:37
Table 'NLHBlue116' 6-max Seat #4 is the button
Seat 1: Hero ($5.59 in chips)
Seat 2: 1d0da3a7 ($6.54 in chips)
Seat 3: a592735e ($5 in chips)
Seat 4: 713370ec ($9.53 in chips)
Seat 5: a2d31939 ($11.71 in chips)
a2d31939: posts small blind $0.02
Hero: posts big blind $0.05
*** HOLE CARDS ***
Dealt to Hero [4c Jd]
Dealt to 1d0da3a7 
Dealt to a592735e 
Dealt to 713370ec 
Dealt to a2d31939 
1d0da3a7: folds
a592735e: raises $0.08 to $0.13
713370ec: folds
a2d31939: folds
Hero: folds
Uncalled bet ($0.08) returned to a592735e
*** SHOWDOWN ***
a592735e collected $0.12 from pot
*** SUMMARY ***
Total pot $0.12 | Rake $0 | Jackpot $0 | Bingo $0 | Fortune $0
Seat 1: Hero (big blind) folded before Flop
Seat 2: 1d0da3a7 folded before Flop (didn't bet)
Seat 3: a592735e collected ($0.12)
Seat 4: 713370ec (button) folded before Flop (didn't bet)
Seat 5: a2d31939 (small blind) folded before Flop


Poker Hand #HD1144631869: Hold'em No Limit  ($0.02/$0.05) - 2023/03/03 20:27:11
Table 'NLHBlue116' 6-max Seat #3 is the button
Seat 1: Hero ($5.52 in chips)
Seat 2: 1d0da3a7 ($6.54 in chips)
Seat 3: a592735e ($5 in chips)
Seat 4: 713370ec ($9.55 in chips)
Seat 5: a2d31939 ($11.76 in chips)
713370ec: posts small blind $0.02
a2d31939: posts big blind $0.05
*** HOLE CARDS ***
Dealt to Hero [6s 5s]
Dealt to 1d0da3a7 
Dealt to a592735e 
Dealt to 713370ec 
Dealt to a2d31939 
Hero: raises $0.07 to $0.12
1d0da3a7: folds
a592735e: folds
713370ec: folds
a2d31939: folds
Uncalled bet ($0.07) returned to Hero
*** SHOWDOWN ***
Hero collected $0.12 from pot
*** SUMMARY ***
Total pot $0.12 | Rake $0 | Jackpot $0 | Bingo $0 | Fortune $0
Seat 1: Hero collected ($0.12)
Seat 2: 1d0da3a7 folded before Flop (didn't bet)
Seat 3: a592735e (button) folded before Flop (didn't bet)
Seat 4: 713370ec (small blind) folded before Flop
Seat 5: a2d31939 (big blind) folded before Flop


Poker Hand #HD1144631813: Hold'em No Limit  ($0.02/$0.05) - 2023/03/03 20:26:50
Table 'NLHBlue116' 6-max Seat #2 is the button
Seat 1: Hero ($5.52 in chips)
Seat 2: 1d0da3a7 ($6.54 in chips)
Seat 3: a592735e ($5.02 in chips)
Seat 4: 713370ec ($9.6 in chips)
Seat 5: a2d31939 ($11.69 in chips)
a592735e: posts small blind $0.02
713370ec: posts big blind $0.05
*** HOLE CARDS ***
Dealt to Hero [8h 4s]
Dealt to 1d0da3a7 
Dealt to a592735e 
Dealt to 713370ec 
Dealt to a2d31939 
a2d31939: raises $0.08 to $0.13
Hero: folds
1d0da3a7: folds
a592735e: folds
713370ec: folds
Uncalled bet ($0.08) returned to a2d31939
*** SHOWDOWN ***
a2d31939 collected $0.12 from pot
*** SUMMARY ***
Total pot $0.12 | Rake $0 | Jackpot $0 | Bingo $0 | Fortune $0
Seat 1: Hero folded before Flop (didn't bet)
Seat 2: 1d0da3a7 (button) folded before Flop (didn't bet)
Seat 3: a592735e (small blind) folded before Flop
Seat 4: 713370ec (big blind) folded before Flop
Seat 5: a2d31939 collected ($0.12)


Poker Hand #HD1144631700: Hold'em No Limit  ($0.02/$0.05) - 2023/03/03 20:26:09
Table 'NLHBlue116' 6-max Seat #1 is the button
Seat 1: Hero ($5.52 in chips)
Seat 2: 1d0da3a7 ($6.56 in chips)
Seat 3: a592735e ($5.07 in chips)
Seat 4: 713370ec ($9.22 in chips)
Seat 5: a2d31939 ($12.03 in chips)
1d0da3a7: posts small blind $0.02
a592735e: posts big blind $0.05
*** HOLE CARDS ***
Dealt to Hero [9h 7h]
Dealt to 1d0da3a7 
Dealt to a592735e 
Dealt to 713370ec 
Dealt to a2d31939 
713370ec: raises $0.1 to $0.15
a2d31939: calls $0.15
Hero: folds
1d0da3a7: folds
a592735e: folds
*** FLOP *** [3h 3c Ks]
713370ec: bets $0.19
a2d31939: calls $0.19
*** TURN *** [3h 3c Ks] [Qh]
713370ec: bets $0.38
a2d31939: folds
Uncalled bet ($0.38) returned to 713370ec
*** SHOWDOWN ***
713370ec collected $0.72 from pot
*** SUMMARY ***
Total pot $0.75 | Rake $0.03 | Jackpot $0 | Bingo $0 | Fortune $0
Board [3h 3c Ks Qh]
Seat 1: Hero (button) folded before Flop (didn't bet)
Seat 2: 1d0da3a7 (small blind) folded before Flop
Seat 3: a592735e (big blind) folded before Flop
Seat 4: 713370ec won ($0.72)
Seat 5: a2d31939 folded on the Turn


Poker Hand #HD1144631644: Hold'em No Limit  ($0.02/$0.05) - 2023/03/03 20:25:48
Table 'NLHBlue116' 6-max Seat #5 is the button
Seat 1: Hero ($5.54 in chips)
Seat 2: 1d0da3a7 ($6.61 in chips)
Seat 4: 713370ec ($9.37 in chips)
Seat 5: a2d31939 ($11.82 in chips)
Hero: posts small blind $0.02
1d0da3a7: posts big blind $0.05
*** HOLE CARDS ***
Dealt to Hero [8d Qc]
Dealt to 1d0da3a7 
Dealt to 713370ec 
Dealt to a2d31939 
713370ec: raises $0.1 to $0.15
a2d31939: raises $0.3 to $0.45
Hero: folds
1d0da3a7: folds
713370ec: folds
Uncalled bet ($0.3) returned to a2d31939
*** SHOWDOWN ***
a2d31939 collected $0.36 from pot
*** SUMMARY ***
Total pot $0.37 | Rake $0.01 | Jackpot $0 | Bingo $0 | Fortune $0
Seat 1: Hero (small blind) folded before Flop
Seat 2: 1d0da3a7 (big blind) folded before Flop
Seat 4: 713370ec folded before Flop
Seat 5: a2d31939 (button) collected ($0.36)


Poker Hand #HD1144631465: Hold'em No Limit  ($0.02/$0.05) - 2023/03/03 20:24:46
Table 'NLHBlue116' 6-max Seat #4 is the button
Seat 1: Hero ($5.92 in chips)
Seat 2: 1d0da3a7 ($6.61 in chips)
Seat 4: 713370ec ($9.75 in chips)
Seat 5: a2d31939 ($11.11 in chips)
a2d31939: posts small blind $0.02
Hero: posts big blind $0.05
*** HOLE CARDS ***
Dealt to Hero [Qc Js]
Dealt to 1d0da3a7 
Dealt to 713370ec 
Dealt to a2d31939 
1d0da3a7: folds
713370ec: raises $0.1 to $0.15
a2d31939: calls $0.13
Hero: calls $0.1
*** FLOP *** [8h Ts 7d]
a2d31939: checks
Hero: bets $0.23
713370ec: calls $0.23
a2d31939: calls $0.23
*** TURN *** [8h Ts 7d] [3d]
a2d31939: checks
Hero: checks
713370ec: checks
*** RIVER *** [8h Ts 7d 3d] [As]
a2d31939: bets $0.45
Hero: folds
713370ec: folds
Uncalled bet ($0.45) returned to a2d31939
*** SHOWDOWN ***
a2d31939 collected $1.09 from pot
*** SUMMARY ***
Total pot $1.14 | Rake $0.05 | Jackpot $0 | Bingo $0 | Fortune $0
Board [8h Ts 7d 3d As]
Seat 1: Hero (big blind) folded on the River
Seat 2: 1d0da3a7 folded before Flop (didn't bet)
Seat 4: 713370ec (button) folded on the River
Seat 5: a2d31939 (small blind) won ($1.09)


Poker Hand #HD1144631413: Hold'em No Limit  ($0.02/$0.05) - 2023/03/03 20:24:27
Table 'NLHBlue116' 6-max Seat #2 is the button
Seat 1: Hero ($5.85 in chips)
Seat 2: 1d0da3a7 ($6.61 in chips)
Seat 4: 713370ec ($9.77 in chips)
Seat 5: a2d31939 ($11.16 in chips)
713370ec: posts small blind $0.02
a2d31939: posts big blind $0.05
*** HOLE CARDS ***
Dealt to Hero [Ah Ac]
Dealt to 1d0da3a7 
Dealt to 713370ec 
Dealt to a2d31939 
Hero: raises $0.07 to $0.12
1d0da3a7: folds
713370ec: folds
a2d31939: folds
Uncalled bet ($0.07) returned to Hero
*** SHOWDOWN ***
Hero collected $0.12 from pot
*** SUMMARY ***
Total pot $0.12 | Rake $0 | Jackpot $0 | Bingo $0 | Fortune $0
Seat 1: Hero collected ($0.12)
Seat 2: 1d0da3a7 (button) folded before Flop (didn't bet)
Seat 4: 713370ec (small blind) folded before Flop
Seat 5: a2d31939 (big blind) folded before Flop


Poker Hand #HD1144631342: Hold'em No Limit  ($0.02/$0.05) - 2023/03/03 20:24:06
Table 'NLHBlue116' 6-max Seat #1 is the button
Seat 1: Hero ($5.85 in chips)
Seat 2: 1d0da3a7 ($6.63 in chips)
Seat 4: 713370ec ($9.82 in chips)
Seat 5: a2d31939 ($11.09 in chips)
1d0da3a7: posts small blind $0.02
713370ec: posts big blind $0.05
*** HOLE CARDS ***
Dealt to Hero [3c 6d]
Dealt to 1d0da3a7 
Dealt to 713370ec 
Dealt to a2d31939 
a2d31939: raises $0.08 to $0.13
Hero: folds
1d0da3a7: folds
713370ec: folds
Uncalled bet ($0.08) returned to a2d31939
*** SHOWDOWN ***
a2d31939 collected $0.12 from pot
*** SUMMARY ***
Total pot $0.12 | Rake $0 | Jackpot $0 | Bingo $0 | Fortune $0
Seat 1: Hero (button) folded before Flop (didn't bet)
Seat 2: 1d0da3a7 (small blind) folded before Flop
Seat 4: 713370ec (big blind) folded before Flop
Seat 5: a2d31939 collected ($0.12)


Poker Hand #HD1144631301: Hold'em No Limit  ($0.02/$0.05) - 2023/03/03 20:23:50
Table 'NLHBlue116' 6-max Seat #5 is the button
Seat 1: Hero ($5.87 in chips)
Seat 2: 1d0da3a7 ($6.61 in chips)
Seat 4: 713370ec ($9.82 in chips)
Seat 5: a2d31939 ($11.09 in chips)
Hero: posts small blind $0.02
1d0da3a7: posts big blind $0.05
*** HOLE CARDS ***
Dealt to Hero [7h 3s]
Dealt to 1d0da3a7 
Dealt to 713370ec 
Dealt to a2d31939 
713370ec: folds
a2d31939: folds
Hero: folds
Uncalled bet ($0.03) returned to 1d0da3a7
*** SHOWDOWN ***
1d0da3a7 collected $0.04 from pot
*** SUMMARY ***
Total pot $0.04 | Rake $0 | Jackpot $0 | Bingo $0 | Fortune $0
Seat 1: Hero (small blind) folded before Flop
Seat 2: 1d0da3a7 (big blind) collected ($0.04)
Seat 4: 713370ec folded before Flop (didn't bet)
Seat 5: a2d31939 (button) folded before Flop (didn't bet)


Poker Hand #HD1144631229: Hold'em No Limit  ($0.02/$0.05) - 2023/03/03 20:23:26
Table 'NLHBlue116' 6-max Seat #4 is the button
Seat 1: Hero ($5.92 in chips)
Seat 2: 1d0da3a7 ($6.61 in chips)
Seat 4: 713370ec ($9.82 in chips)
Seat 5: a2d31939 ($11.04 in chips)
a2d31939: posts small blind $0.02
Hero: posts big blind $0.05
*** HOLE CARDS ***
Dealt to Hero [3c 5d]
Dealt to 1d0da3a7 
Dealt to 713370ec 
Dealt to a2d31939 
1d0da3a7: folds
713370ec: folds
a2d31939: calls $0.03
Hero: checks
*** FLOP *** [3h Qs Ts]
a2d31939: bets $0.05
Hero: folds
Uncalled bet ($0.05) returned to a2d31939
*** SHOWDOWN ***
a2d31939 collected $0.1 from pot
*** SUMMARY ***
Total pot $0.1 | Rake $0 | Jackpot $0 | Bingo $0 | Fortune $0
Board [3h Qs Ts]
Seat 1: Hero (big blind) folded on the Flop
Seat 2: 1d0da3a7 folded before Flop (didn't bet)
Seat 4: 713370ec (button) folded before Flop (didn't bet)
Seat 5: a2d31939 (small blind) won ($0.1)


Poker Hand #HD1144631206: Hold'em No Limit  ($0.02/$0.05) - 2023/03/03 20:23:18
Table 'NLHBlue116' 6-max Seat #2 is the button
Seat 1: Hero ($5.92 in chips)
Seat 2: 1d0da3a7 ($6.61 in chips)
Seat 4: 713370ec ($9.84 in chips)
Seat 5: a2d31939 ($11.02 in chips)
713370ec: posts small blind $0.02
a2d31939: posts big blind $0.05
*** HOLE CARDS ***
Dealt to Hero [Kd 6c]
Dealt to 1d0da3a7 
Dealt to 713370ec 
Dealt to a2d31939 
Hero: folds
1d0da3a7: folds
713370ec: folds
Uncalled bet ($0.03) returned to a2d31939
*** SHOWDOWN ***
a2d31939 collected $0.04 from pot
*** SUMMARY ***
Total pot $0.04 | Rake $0 | Jackpot $0 | Bingo $0 | Fortune $0
Seat 1: Hero folded before Flop (didn't bet)
Seat 2: 1d0da3a7 (button) folded before Flop (didn't bet)
Seat 4: 713370ec (small blind) folded before Flop
Seat 5: a2d31939 (big blind) collected ($0.04)


Poker Hand #HD1144631175: Hold'em No Limit  ($0.02/$0.05) - 2023/03/03 20:23:09
Table 'NLHBlue116' 6-max Seat #1 is the button
Seat 1: Hero ($5.92 in chips)
Seat 2: 1d0da3a7 ($6.63 in chips)
Seat 4: 713370ec ($9.82 in chips)
Seat 5: a2d31939 ($11.02 in chips)
1d0da3a7: posts small blind $0.02
713370ec: posts big blind $0.05
*** HOLE CARDS ***
Dealt to Hero [6h 7c]
Dealt to 1d0da3a7 
Dealt to 713370ec 
Dealt to a2d31939 
a2d31939: folds
Hero: folds
1d0da3a7: folds
Uncalled bet ($0.03) returned to 713370ec
*** SHOWDOWN ***
713370ec collected $0.04 from pot
*** SUMMARY ***
Total pot $0.04 | Rake $0 | Jackpot $0 | Bingo $0 | Fortune $0
Seat 1: Hero (button) folded before Flop (didn't bet)
Seat 2: 1d0da3a7 (small blind) folded before Flop
Seat 4: 713370ec (big blind) collected ($0.04)
Seat 5: a2d31939 folded before Flop (didn't bet)


Poker Hand #HD1144631146: Hold'em No Limit  ($0.02/$0.05) - 2023/03/03 20:22:59
Table 'NLHBlue116' 6-max Seat #5 is the button
Seat 1: Hero ($5.94 in chips)
Seat 2: 1d0da3a7 ($6.61 in chips)
Seat 3: a592735e ($5.07 in chips)
Seat 4: 713370ec ($9.82 in chips)
Seat 5: a2d31939 ($11.02 in chips)
Hero: posts small blind $0.02
1d0da3a7: posts big blind $0.05
*** HOLE CARDS ***
Dealt to Hero [8c Qh]
Dealt to 1d0da3a7 
Dealt to a592735e 
Dealt to 713370ec 
Dealt to a2d31939 
a592735e: folds
713370ec: folds
a2d31939: folds
Hero: folds
Uncalled bet ($0.03) returned to 1d0da3a7
*** SHOWDOWN ***
1d0da3a7 collected $0.04 from pot
*** SUMMARY ***
Total pot $0.04 | Rake $0 | Jackpot $0 | Bingo $0 | Fortune $0
Seat 1: Hero (small blind) folded before Flop
Seat 2: 1d0da3a7 (big blind) collected ($0.04)
Seat 3: a592735e folded before Flop (didn't bet)
Seat 4: 713370ec folded before Flop (didn't bet)
Seat 5: a2d31939 (button) folded before Flop (didn't bet)


Poker Hand #HD1144630991: Hold'em No Limit  ($0.02/$0.05) - 2023/03/03 20:22:10
Table 'NLHBlue116' 6-max Seat #4 is the button
Seat 1: Hero ($5.58 in chips)
Seat 2: 1d0da3a7 ($6.61 in chips)
Seat 3: a592735e ($5.07 in chips)
Seat 4: 713370ec ($9.82 in chips)
Seat 5: a2d31939 ($11.36 in chips)
Seat 6: 5b1dc166 ($5.66 in chips)
a2d31939: posts small blind $0.02
5b1dc166: posts big blind $0.05
*** HOLE CARDS ***
Dealt to Hero [Js Ks]
Dealt to 1d0da3a7 
Dealt to a592735e 
Dealt to 713370ec 
Dealt to a2d31939 
Dealt to 5b1dc166 
Hero: raises $0.07 to $0.12
1d0da3a7: folds
a592735e: folds
713370ec: folds
a2d31939: calls $0.1
5b1dc166: folds
*** FLOP *** [4s 2h Jd]
a2d31939: checks
Hero: bets $0.22
a2d31939: calls $0.22
*** TURN *** [4s 2h Jd] [Ah]
a2d31939: checks
Hero: bets $0.55
a2d31939: folds
Uncalled bet ($0.55) returned to Hero
*** SHOWDOWN ***
Hero collected $0.7 from pot
*** SUMMARY ***
Total pot $0.73 | Rake $0.03 | Jackpot $0 | Bingo $0 | Fortune $0
Board [4s 2h Jd Ah]
Seat 1: Hero won ($0.7)
Seat 2: 1d0da3a7 folded before Flop (didn't bet)
Seat 3: a592735e folded before Flop (didn't bet)
Seat 4: 713370ec (button) folded before Flop (didn't bet)
Seat 5: a2d31939 (small blind) folded on the Turn
Seat 6: 5b1dc166 (big blind) folded before Flop


Poker Hand #HD1144630868: Hold'em No Limit  ($0.02/$0.05) - 2023/03/03 20:21:26
Table 'NLHBlue116' 6-max Seat #3 is the button
Seat 1: Hero ($5.58 in chips)
Seat 2: 1d0da3a7 ($6.61 in chips)
Seat 3: a592735e ($5.07 in chips)
Seat 4: 713370ec ($9.84 in chips)
Seat 5: a2d31939 ($11.7 in chips)
Seat 6: 5b1dc166 ($5.33 in chips)
713370ec: posts small blind $0.02
a2d31939: posts big blind $0.05
*** HOLE CARDS ***
Dealt to Hero [3s 8c]
Dealt to 1d0da3a7 
Dealt to a592735e 
Dealt to 713370ec 
Dealt to a2d31939 
Dealt to 5b1dc166 
5b1dc166: raises $0.08 to $0.13
Hero: folds
1d0da3a7: folds
a592735e: folds
713370ec: folds
a2d31939: calls $0.08
*** FLOP *** [6c Kh Td]
a2d31939: checks
5b1dc166: checks
*** TURN *** [6c Kh Td] [5c]
a2d31939: checks
5b1dc166: checks
*** RIVER *** [6c Kh Td 5c] [5h]
a2d31939: bets $0.21
5b1dc166: calls $0.21
a2d31939: shows [2s 4s] (Pair of Fives)
5b1dc166: shows [7d 7c] (Pair of Sevens and Pair of Fives)
*** SHOWDOWN ***
5b1dc166 collected $0.67 from pot
*** SUMMARY ***
Total pot $0.7 | Rake $0.03 | Jackpot $0 | Bingo $0 | Fortune $0
Board [6c Kh Td 5c 5h]
Seat 1: Hero folded before Flop (didn't bet)
Seat 2: 1d0da3a7 folded before Flop (didn't bet)
Seat 3: a592735e (button) folded before Flop (didn't bet)
Seat 4: 713370ec (small blind) folded before Flop
Seat 5: a2d31939 (big blind) showed [2s 4s] and lost with Pair of Fives
Seat 6: 5b1dc166 showed [7d 7c] and won ($0.67) with Pair of Sevens and Pair of Fives


Poker Hand #HD1144630817: Hold'em No Limit  ($0.02/$0.05) - 2023/03/03 20:21:11
Table 'NLHBlue116' 6-max Seat #2 is the button
Seat 1: Hero ($5.58 in chips)
Seat 2: 1d0da3a7 ($6.61 in chips)
Seat 3: a592735e ($5.02 in chips)
Seat 4: 713370ec ($9.89 in chips)
Seat 5: a2d31939 ($11.7 in chips)
Seat 6: 5b1dc166 ($5.33 in chips)
a592735e: posts small blind $0.02
713370ec: posts big blind $0.05
*** HOLE CARDS ***
Dealt to Hero [6h 8s]
Dealt to 1d0da3a7 
Dealt to a592735e 
Dealt to 713370ec 
Dealt to a2d31939 
Dealt to 5b1dc166 
a2d31939: folds
5b1dc166: folds
Hero: folds
1d0da3a7: folds
a592735e: raises $0.08 to $0.13
713370ec: folds
Uncalled bet ($0.08) returned to a592735e
*** SHOWDOWN ***
a592735e collected $0.1 from pot
*** SUMMARY ***
Total pot $0.1 | Rake $0 | Jackpot $0 | Bingo $0 | Fortune $0
Seat 1: Hero folded before Flop (didn't bet)
Seat 2: 1d0da3a7 (button) folded before Flop (didn't bet)
Seat 3: a592735e (small blind) collected ($0.1)
Seat 4: 713370ec (big blind) folded before Flop
Seat 5: a2d31939 folded before Flop (didn't bet)
Seat 6: 5b1dc166 folded before Flop (didn't bet)


Poker Hand #HD1144630788: Hold'em No Limit  ($0.02/$0.05) - 2023/03/03 20:21:02
Table 'NLHBlue116' 6-max Seat #1 is the button
Seat 1: Hero ($5.58 in chips)
Seat 2: 1d0da3a7 ($6.63 in chips)
Seat 3: a592735e ($5 in chips)
Seat 4: 713370ec ($9.89 in chips)
Seat 5: a2d31939 ($11.7 in chips)
Seat 6: 5b1dc166 ($5.33 in chips)
1d0da3a7: posts small blind $0.02
a592735e: posts big blind $0.05
*** HOLE CARDS ***
Dealt to Hero [8s 4c]
Dealt to 1d0da3a7 
Dealt to a592735e 
Dealt to 713370ec 
Dealt to a2d31939 
Dealt to 5b1dc166 
713370ec: folds
a2d31939: folds
5b1dc166: folds
Hero: folds
1d0da3a7: folds
Uncalled bet ($0.03) returned to a592735e
*** SHOWDOWN ***
a592735e collected $0.04 from pot
*** SUMMARY ***
Total pot $0.04 | Rake $0 | Jackpot $0 | Bingo $0 | Fortune $0
Seat 1: Hero (button) folded before Flop (didn't bet)
Seat 2: 1d0da3a7 (small blind) folded before Flop
Seat 3: a592735e (big blind) collected ($0.04)
Seat 4: 713370ec folded before Flop (didn't bet)
Seat 5: a2d31939 folded before Flop (didn't bet)
Seat 6: 5b1dc166 folded before Flop (didn't bet)


Poker Hand #HD1144630688: Hold'em No Limit  ($0.02/$0.05) - 2023/03/03 20:20:29
Table 'NLHBlue116' 6-max Seat #6 is the button
Seat 1: Hero ($5.13 in chips)
Seat 2: 1d0da3a7 ($6.68 in chips)
Seat 3: a592735e ($5 in chips)
Seat 4: 713370ec ($9.89 in chips)
Seat 5: a2d31939 ($12.14 in chips)
Seat 6: 5b1dc166 ($5.33 in chips)
Hero: posts small blind $0.02
1d0da3a7: posts big blind $0.05
*** HOLE CARDS ***
Dealt to Hero [Qh Jh]
Dealt to 1d0da3a7 
Dealt to a592735e 
Dealt to 713370ec 
Dealt to a2d31939 
Dealt to 5b1dc166 
a592735e: folds
713370ec: folds
a2d31939: raises $0.08 to $0.13
5b1dc166: folds
Hero: raises $0.31 to $0.44
1d0da3a7: folds
a2d31939: calls $0.31
*** FLOP *** [7h As Kh]
Hero: bets $0.48
a2d31939: folds
Uncalled bet ($0.48) returned to Hero
*** SHOWDOWN ***
Hero collected $0.89 from pot
*** SUMMARY ***
Total pot $0.93 | Rake $0.04 | Jackpot $0 | Bingo $0 | Fortune $0
Board [7h As Kh]
Seat 1: Hero (small blind) won ($0.89)
Seat 2: 1d0da3a7 (big blind) folded before Flop
Seat 3: a592735e folded before Flop (didn't bet)
Seat 4: 713370ec folded before Flop (didn't bet)
Seat 5: a2d31939 folded on the Flop
Seat 6: 5b1dc166 (button) folded before Flop (didn't bet)


Poker Hand #HD1144630615: Hold'em No Limit  ($0.02/$0.05) - 2023/03/03 20:20:02
Table 'NLHBlue116' 6-max Seat #5 is the button
Seat 1: Hero ($5 in chips)
Seat 2: 1d0da3a7 ($6.68 in chips)
Seat 3: a592735e ($5 in chips)
Seat 4: 713370ec ($9.89 in chips)
Seat 5: a2d31939 ($12.26 in chips)
Seat 6: 5b1dc166 ($5.35 in chips)
5b1dc166: posts small blind $0.02
Hero: posts big blind $0.05
*** HOLE CARDS ***
Dealt to Hero [4h Ac]
Dealt to 1d0da3a7 
Dealt to a592735e 
Dealt to 713370ec 
Dealt to a2d31939 
Dealt to 5b1dc166 
1d0da3a7: folds
a592735e: folds
713370ec: folds
a2d31939: raises $0.07 to $0.12
5b1dc166: folds
Hero: calls $0.07
*** FLOP *** [6s Ad 3d]
Hero: bets $0.13
a2d31939: folds
Uncalled bet ($0.13) returned to Hero
*** SHOWDOWN ***
Hero collected $0.25 from pot
*** SUMMARY ***
Total pot $0.26 | Rake $0.01 | Jackpot $0 | Bingo $0 | Fortune $0
Board [6s Ad 3d]
Seat 1: Hero (big blind) won ($0.25)
Seat 2: 1d0da3a7 folded before Flop (didn't bet)
Seat 3: a592735e folded before Flop (didn't bet)
Seat 4: 713370ec folded before Flop (didn't bet)
Seat 5: a2d31939 (button) folded on the Flop
Seat 6: 5b1dc166 (small blind) folded before Flop


Poker Hand #HD1144630576: Hold'em No Limit  ($0.02/$0.05) - 2023/03/03 20:19:48
Table 'NLHBlue116' 6-max Seat #4 is the button
Seat 1: Hero ($5 in chips)
Seat 2: 1d0da3a7 ($6.68 in chips)
Seat 3: a592735e ($5 in chips)
Seat 4: 713370ec ($9.89 in chips)
Seat 5: a2d31939 ($12.28 in chips)
Seat 6: 5b1dc166 ($5.33 in chips)
a2d31939: posts small blind $0.02
5b1dc166: posts big blind $0.05
*** HOLE CARDS ***
Dealt to Hero [4c 7s]
Dealt to 1d0da3a7 
Dealt to a592735e 
Dealt to 713370ec 
Dealt to a2d31939 
Dealt to 5b1dc166 
Hero: folds
1d0da3a7: folds
a592735e: folds
713370ec: folds
a2d31939: folds
Uncalled bet ($0.03) returned to 5b1dc166
*** SHOWDOWN ***
5b1dc166 collected $0.04 from pot
*** SUMMARY ***
Total pot $0.04 | Rake $0 | Jackpot $0 | Bingo $0 | Fortune $0
Seat 1: Hero folded before Flop (didn't bet)
Seat 2: 1d0da3a7 folded before Flop (didn't bet)
Seat 3: a592735e folded before Flop (didn't bet)
Seat 4: 713370ec (button) folded before Flop (didn't bet)
Seat 5: a2d31939 (small blind) folded before Flop
Seat 6: 5b1dc166 (big blind) collected ($0.04)


Poker Hand #HD1144630425: Hold'em No Limit  ($0.02/$0.05) - 2023/03/03 20:18:54
Table 'NLHBlue116' 6-max Seat #3 is the button
Seat 1: Hero ($5 in chips)
Seat 2: 1d0da3a7 ($6.68 in chips)
Seat 3: a592735e ($5 in chips)
Seat 4: 713370ec ($9.35 in chips)
Seat 5: a2d31939 ($12.88 in chips)
Seat 6: 5b1dc166 ($5.33 in chips)
713370ec: posts small blind $0.02
a2d31939: posts big blind $0.05
*** HOLE CARDS ***
Dealt to Hero [Kd 9c]
Dealt to 1d0da3a7 
Dealt to a592735e 
Dealt to 713370ec 
Dealt to a2d31939 
Dealt to 5b1dc166 
5b1dc166: folds
Hero: folds
1d0da3a7: folds
a592735e: folds
713370ec: raises $0.1 to $0.15
a2d31939: calls $0.1
*** FLOP *** [9s 9d 3d]
713370ec: checks
a2d31939: checks
*** TURN *** [9s 9d 3d] [Ad]
713370ec: bets $0.15
a2d31939: raises $0.3 to $0.45
713370ec: calls $0.3
*** RIVER *** [9s 9d 3d Ad] [Ts]
713370ec: checks
a2d31939: checks
713370ec: shows [Ks As] (Pair of Aces and Pair of Nines)
a2d31939: shows [Ac 6h] (Pair of Aces and Pair of Nines)
*** SHOWDOWN ***
713370ec collected $1.14 from pot
*** SUMMARY ***
Total pot $1.2 | Rake $0.06 | Jackpot $0 | Bingo $0 | Fortune $0
Board [9s 9d 3d Ad Ts]
Seat 1: Hero folded before Flop (didn't bet)
Seat 2: 1d0da3a7 folded before Flop (didn't bet)
Seat 3: a592735e (button) folded before Flop (didn't bet)
Seat 4: 713370ec (small blind) showed [Ks As] and won ($1.14) with Pair of Aces and Pair of Nines
Seat 5: a2d31939 (big blind) showed [Ac 6h] and lost with Pair of Aces and Pair of Nines
Seat 6: 5b1dc166 folded before Flop (didn't bet)


Poker Hand #HD1144630336: Hold'em No Limit  ($0.02/$0.05) - 2023/03/03 20:18:30
Table 'NLHBlue116' 6-max Seat #2 is the button
Seat 1: Hero ($5 in chips)
Seat 2: 1d0da3a7 ($6.68 in chips)
Seat 3: a592735e ($5.02 in chips)
Seat 4: 713370ec ($9.33 in chips)
Seat 5: a2d31939 ($12.88 in chips)
Seat 6: 5b1dc166 ($5.33 in chips)
a592735e: posts small blind $0.02
713370ec: posts big blind $0.05
*** HOLE CARDS ***
Dealt to Hero [2s 4s]
Dealt to 1d0da3a7 
Dealt to a592735e 
Dealt to 713370ec 
Dealt to a2d31939 
Dealt to 5b1dc166 
a2d31939: folds
5b1dc166: folds
Hero: folds
1d0da3a7: folds
a592735e: folds
Uncalled bet ($0.03) returned to 713370ec
*** SHOWDOWN ***
713370ec collected $0.04 from pot
*** SUMMARY ***
Total pot $0.04 | Rake $0 | Jackpot $0 | Bingo $0 | Fortune $0
Seat 1: Hero folded before Flop (didn't bet)
Seat 2: 1d0da3a7 (button) folded before Flop (didn't bet)
Seat 3: a592735e (small blind) folded before Flop
Seat 4: 713370ec (big blind) collected ($0.04)
Seat 5: a2d31939 folded before Flop (didn't bet)
Seat 6: 5b1dc166 folded before Flop (didn't bet)


Poker Hand #HD1144630254: Hold'em No Limit  ($0.02/$0.05) - 2023/03/03 20:18:06
Table 'NLHBlue116' 6-max Seat #1 is the button
Seat 1: Hero ($5 in chips)
Seat 2: 1d0da3a7 ($6.7 in chips)
Seat 3: a592735e ($5 in chips)
Seat 4: 713370ec ($9.33 in chips)
Seat 5: a2d31939 ($12.88 in chips)
Seat 6: 5b1dc166 ($5.33 in chips)
1d0da3a7: posts small blind $0.02
a592735e: posts big blind $0.05
*** HOLE CARDS ***
Dealt to Hero [6s 2s]
Dealt to 1d0da3a7 
Dealt to a592735e 
Dealt to 713370ec 
Dealt to a2d31939 
Dealt to 5b1dc166 
713370ec: folds
a2d31939: folds
5b1dc166: folds
Hero: folds
1d0da3a7: folds
Uncalled bet ($0.03) returned to a592735e
*** SHOWDOWN ***
a592735e collected $0.04 from pot
*** SUMMARY ***
Total pot $0.04 | Rake $0 | Jackpot $0 | Bingo $0 | Fortune $0
Seat 1: Hero (button) folded before Flop (didn't bet)
Seat 2: 1d0da3a7 (small blind) folded before Flop
Seat 3: a592735e (big blind) collected ($0.04)
Seat 4: 713370ec folded before Flop (didn't bet)
Seat 5: a2d31939 folded before Flop (didn't bet)
Seat 6: 5b1dc166 folded before Flop (didn't bet)


Poker Hand #HD1144630172: Hold'em No Limit  ($0.02/$0.05) - 2023/03/03 20:17:42
Table 'NLHBlue116' 6-max Seat #6 is the button
Seat 1: Hero ($5.01 in chips)
Seat 2: 1d0da3a7 ($6.75 in chips)
Seat 3: a592735e ($5 in chips)
Seat 4: 713370ec ($9.33 in chips)
Seat 5: a2d31939 ($12.88 in chips)
Seat 6: 5b1dc166 ($5.26 in chips)
Hero: posts small blind $0.02
1d0da3a7: posts big blind $0.05
*** HOLE CARDS ***
Dealt to Hero [3d 2d]
Dealt to 1d0da3a7 
Dealt to a592735e 
Dealt to 713370ec 
Dealt to a2d31939 
Dealt to 5b1dc166 
a592735e: folds
713370ec: folds
a2d31939: folds
5b1dc166: raises $0.08 to $0.13
Hero: folds
1d0da3a7: folds
Uncalled bet ($0.08) returned to 5b1dc166
*** SHOWDOWN ***
5b1dc166 collected $0.12 from pot
*** SUMMARY ***
Total pot $0.12 | Rake $0 | Jackpot $0 | Bingo $0 | Fortune $0
Seat 1: Hero (small blind) folded before Flop
Seat 2: 1d0da3a7 (big blind) folded before Flop
Seat 3: a592735e folded before Flop (didn't bet)
Seat 4: 713370ec folded before Flop (didn't bet)
Seat 5: a2d31939 folded before Flop (didn't bet)
Seat 6: 5b1dc166 (button) collected ($0.12)


Poker Hand #HD1144630142: Hold'em No Limit  ($0.02/$0.05) - 2023/03/03 20:17:31
Table 'NLHBlue116' 6-max Seat #5 is the button
Seat 1: Hero ($5.06 in chips)
Seat 2: 1d0da3a7 ($6.68 in chips)
Seat 3: a592735e ($5 in chips)
Seat 4: 713370ec ($9.33 in chips)
Seat 5: a2d31939 ($12.88 in chips)
Seat 6: 5b1dc166 ($5.28 in chips)
5b1dc166: posts small blind $0.02
Hero: posts big blind $0.05
*** HOLE CARDS ***
Dealt to Hero [6h Qc]
Dealt to 1d0da3a7 
Dealt to a592735e 
Dealt to 713370ec 
Dealt to a2d31939 
Dealt to 5b1dc166 
1d0da3a7: raises $0.08 to $0.13
a592735e: folds
713370ec: folds
a2d31939: folds
5b1dc166: folds
Hero: folds
Uncalled bet ($0.08) returned to 1d0da3a7
*** SHOWDOWN ***
1d0da3a7 collected $0.12 from pot
*** SUMMARY ***
Total pot $0.12 | Rake $0 | Jackpot $0 | Bingo $0 | Fortune $0
Seat 1: Hero (big blind) folded before Flop
Seat 2: 1d0da3a7 collected ($0.12)
Seat 3: a592735e folded before Flop (didn't bet)
Seat 4: 713370ec folded before Flop (didn't bet)
Seat 5: a2d31939 (button) folded before Flop (didn't bet)
Seat 6: 5b1dc166 (small blind) folded before Flop


Poker Hand #HD1144630006: Hold'em No Limit  ($0.02/$0.05) - 2023/03/03 20:16:46
Table 'NLHBlue116' 6-max Seat #4 is the button
Seat 1: Hero ($5.58 in chips)
Seat 2: 1d0da3a7 ($6.68 in chips)
Seat 3: a592735e ($5 in chips)
Seat 4: 713370ec ($9.33 in chips)
Seat 5: a2d31939 ($12.36 in chips)
Seat 6: 5b1dc166 ($5.33 in chips)
a2d31939: posts small blind $0.02
5b1dc166: posts big blind $0.05
*** HOLE CARDS ***
Dealt to Hero [5s 6s]
Dealt to 1d0da3a7 
Dealt to a592735e 
Dealt to 713370ec 
Dealt to a2d31939 
Dealt to 5b1dc166 
Hero: raises $0.07 to $0.12
1d0da3a7: folds
a592735e: folds
713370ec: folds
a2d31939: raises $0.4 to $0.52
5b1dc166: folds
Hero: calls $0.4
*** FLOP *** [Jc Jd 7c]
a2d31939: bets $0.4
Hero: folds
Uncalled bet ($0.4) returned to a2d31939
*** SHOWDOWN ***
a2d31939 collected $1.04 from pot
*** SUMMARY ***
Total pot $1.09 | Rake $0.05 | Jackpot $0 | Bingo $0 | Fortune $0
Board [Jc Jd 7c]
Seat 1: Hero folded on the Flop
Seat 2: 1d0da3a7 folded before Flop (didn't bet)
Seat 3: a592735e folded before Flop (didn't bet)
Seat 4: 713370ec (button) folded before Flop (didn't bet)
Seat 5: a2d31939 (small blind) won ($1.04)
Seat 6: 5b1dc166 (big blind) folded before Flop


Poker Hand #HD1144629978: Hold'em No Limit  ($0.02/$0.05) - 2023/03/03 20:16:33
Table 'NLHBlue116' 6-max Seat #3 is the button
Seat 1: Hero ($5.51 in chips)
Seat 2: 1d0da3a7 ($6.68 in chips)
Seat 3: a592735e ($5 in chips)
Seat 4: 713370ec ($9.35 in chips)
Seat 5: a2d31939 ($12.41 in chips)
Seat 6: 5b1dc166 ($5.33 in chips)
713370ec: posts small blind $0.02
a2d31939: posts big blind $0.05
*** HOLE CARDS ***
Dealt to Hero [Qc Ad]
Dealt to 1d0da3a7 
Dealt to a592735e 
Dealt to 713370ec 
Dealt to a2d31939 
Dealt to 5b1dc166 
5b1dc166: folds
Hero: raises $0.07 to $0.12
1d0da3a7: folds
a592735e: folds
713370ec: folds
a2d31939: folds
Uncalled bet ($0.07) returned to Hero
*** SHOWDOWN ***
Hero collected $0.12 from pot
*** SUMMARY ***
Total pot $0.12 | Rake $0 | Jackpot $0 | Bingo $0 | Fortune $0
Seat 1: Hero collected ($0.12)
Seat 2: 1d0da3a7 folded before Flop (didn't bet)
Seat 3: a592735e (button) folded before Flop (didn't bet)
Seat 4: 713370ec (small blind) folded before Flop
Seat 5: a2d31939 (big blind) folded before Flop
Seat 6: 5b1dc166 folded before Flop (didn't bet)


Poker Hand #HD1144629926: Hold'em No Limit  ($0.02/$0.05) - 2023/03/03 20:16:17
Table 'NLHBlue116' 6-max Seat #2 is the button
Seat 1: Hero ($5.51 in chips)
Seat 2: 1d0da3a7 ($6.68 in chips)
Seat 3: a592735e ($5 in chips)
Seat 4: 713370ec ($9.4 in chips)
Seat 5: a2d31939 ($12.41 in chips)
Seat 6: 5b1dc166 ($5.26 in chips)
a592735e: posts small blind $0.02
713370ec: posts big blind $0.05
*** HOLE CARDS ***
Dealt to Hero [4s 5s]
Dealt to 1d0da3a7 
Dealt to a592735e 
Dealt to 713370ec 
Dealt to a2d31939 
Dealt to 5b1dc166 
a2d31939: folds
5b1dc166: raises $0.08 to $0.13
Hero: folds
1d0da3a7: folds
a592735e: folds
713370ec: folds
Uncalled bet ($0.08) returned to 5b1dc166
*** SHOWDOWN ***
5b1dc166 collected $0.12 from pot
*** SUMMARY ***
Total pot $0.12 | Rake $0 | Jackpot $0 | Bingo $0 | Fortune $0
Seat 1: Hero folded before Flop (didn't bet)
Seat 2: 1d0da3a7 (button) folded before Flop (didn't bet)
Seat 3: a592735e (small blind) folded before Flop
Seat 4: 713370ec (big blind) folded before Flop
Seat 5: a2d31939 folded before Flop (didn't bet)
Seat 6: 5b1dc166 collected ($0.12)


Poker Hand #HD1144629870: Hold'em No Limit  ($0.02/$0.05) - 2023/03/03 20:16:03
Table 'NLHBlue116' 6-max Seat #1 is the button
Seat 1: Hero ($5.51 in chips)
Seat 2: 1d0da3a7 ($6.7 in chips)
Seat 3: a592735e ($5.04 in chips)
Seat 4: 713370ec ($9.33 in chips)
Seat 5: a2d31939 ($12.41 in chips)
Seat 6: 5b1dc166 ($5.26 in chips)
1d0da3a7: posts small blind $0.02
a592735e: posts big blind $0.05
*** HOLE CARDS ***
Dealt to Hero [8s Qd]
Dealt to 1d0da3a7 
Dealt to a592735e 
Dealt to 713370ec 
Dealt to a2d31939 
Dealt to 5b1dc166 
713370ec: raises $0.1 to $0.15
a2d31939: folds
5b1dc166: folds
Hero: folds
1d0da3a7: folds
a592735e: folds
Uncalled bet ($0.1) returned to 713370ec
*** SHOWDOWN ***
713370ec collected $0.12 from pot
*** SUMMARY ***
Total pot $0.12 | Rake $0 | Jackpot $0 | Bingo $0 | Fortune $0
Seat 1: Hero (button) folded before Flop (didn't bet)
Seat 2: 1d0da3a7 (small blind) folded before Flop
Seat 3: a592735e (big blind) folded before Flop
Seat 4: 713370ec collected ($0.12)
Seat 5: a2d31939 folded before Flop (didn't bet)
Seat 6: 5b1dc166 folded before Flop (didn't bet)


Poker Hand #HD1144629793: Hold'em No Limit  ($0.02/$0.05) - 2023/03/03 20:15:37
Table 'NLHBlue116' 6-max Seat #6 is the button
Seat 1: Hero ($5.53 in chips)
Seat 2: 1d0da3a7 ($6.75 in chips)
Seat 3: a592735e ($5.04 in chips)
Seat 4: 713370ec ($9.33 in chips)
Seat 5: a2d31939 ($12.54 in chips)
Seat 6: 5b1dc166 ($5.07 in chips)
Hero: posts small blind $0.02
1d0da3a7: posts big blind $0.05
*** HOLE CARDS ***
Dealt to Hero [2h 6c]
Dealt to 1d0da3a7 
Dealt to a592735e 
Dealt to 713370ec 
Dealt to a2d31939 
Dealt to 5b1dc166 
a592735e: folds
713370ec: folds
a2d31939: raises $0.08 to $0.13
5b1dc166: raises $0.33 to $0.46
Hero: folds
1d0da3a7: folds
a2d31939: folds
Uncalled bet ($0.33) returned to 5b1dc166
*** SHOWDOWN ***
5b1dc166 collected $0.32 from pot
*** SUMMARY ***
Total pot $0.33 | Rake $0.01 | Jackpot $0 | Bingo $0 | Fortune $0
Seat 1: Hero (small blind) folded before Flop
Seat 2: 1d0da3a7 (big blind) folded before Flop
Seat 3: a592735e folded before Flop (didn't bet)
Seat 4: 713370ec folded before Flop (didn't bet)
Seat 5: a2d31939 folded before Flop
Seat 6: 5b1dc166 (button) collected ($0.32)


Poker Hand #HD1144629706: Hold'em No Limit  ($0.02/$0.05) - 2023/03/03 20:15:05
Table 'NLHBlue116' 6-max Seat #5 is the button
Seat 1: Hero ($5.58 in chips)
Seat 2: 1d0da3a7 ($6.75 in chips)
Seat 3: a592735e ($5.04 in chips)
Seat 4: 713370ec ($9.33 in chips)
Seat 5: a2d31939 ($12.47 in chips)
Seat 6: 5b1dc166 ($5.09 in chips)
5b1dc166: posts small blind $0.02
Hero: posts big blind $0.05
*** HOLE CARDS ***
Dealt to Hero [6h 2h]
Dealt to 1d0da3a7 
Dealt to a592735e 
Dealt to 713370ec 
Dealt to a2d31939 
Dealt to 5b1dc166 
1d0da3a7: folds
a592735e: folds
713370ec: folds
a2d31939: raises $0.07 to $0.12
5b1dc166: folds
Hero: folds
Uncalled bet ($0.07) returned to a2d31939
*** SHOWDOWN ***
a2d31939 collected $0.12 from pot
*** SUMMARY ***
Total pot $0.12 | Rake $0 | Jackpot $0 | Bingo $0 | Fortune $0
Seat 1: Hero (big blind) folded before Flop
Seat 2: 1d0da3a7 folded before Flop (didn't bet)
Seat 3: a592735e folded before Flop (didn't bet)
Seat 4: 713370ec folded before Flop (didn't bet)
Seat 5: a2d31939 (button) collected ($0.12)
Seat 6: 5b1dc166 (small blind) folded before Flop


Poker Hand #HD1144629659: Hold'em No Limit  ($0.02/$0.05) - 2023/03/03 20:14:53
Table 'NLHBlue116' 6-max Seat #4 is the button
Seat 1: Hero ($5.58 in chips)
Seat 2: 1d0da3a7 ($6.75 in chips)
Seat 3: a592735e ($5.04 in chips)
Seat 4: 713370ec ($9.33 in chips)
Seat 5: a2d31939 ($12.49 in chips)
Seat 6: 5b1dc166 ($5.07 in chips)
a2d31939: posts small blind $0.02
5b1dc166: posts big blind $0.05
*** HOLE CARDS ***
Dealt to Hero [Ad 7h]
Dealt to 1d0da3a7 
Dealt to a592735e 
Dealt to 713370ec 
Dealt to a2d31939 
Dealt to 5b1dc166 
Hero: folds
1d0da3a7: folds
a592735e: folds
713370ec: folds
a2d31939: folds
Uncalled bet ($0.03) returned to 5b1dc166
*** SHOWDOWN ***
5b1dc166 collected $0.04 from pot
*** SUMMARY ***
Total pot $0.04 | Rake $0 | Jackpot $0 | Bingo $0 | Fortune $0
Seat 1: Hero folded before Flop (didn't bet)
Seat 2: 1d0da3a7 folded before Flop (didn't bet)
Seat 3: a592735e folded before Flop (didn't bet)
Seat 4: 713370ec (button) folded before Flop (didn't bet)
Seat 5: a2d31939 (small blind) folded before Flop
Seat 6: 5b1dc166 (big blind) collected ($0.04)


Poker Hand #HD1144629509: Hold'em No Limit  ($0.02/$0.05) - 2023/03/03 20:14:01
Table 'NLHBlue116' 6-max Seat #3 is the button
Seat 1: Hero ($5.26 in chips)
Seat 2: 1d0da3a7 ($7.03 in chips)
Seat 3: a592735e ($5.04 in chips)
Seat 4: 713370ec ($9.35 in chips)
Seat 5: a2d31939 ($12.54 in chips)
Seat 6: 5b1dc166 ($5.07 in chips)
713370ec: posts small blind $0.02
a2d31939: posts big blind $0.05
*** HOLE CARDS ***
Dealt to Hero [Qd Kd]
Dealt to 1d0da3a7 
Dealt to a592735e 
Dealt to 713370ec 
Dealt to a2d31939 
Dealt to 5b1dc166 
5b1dc166: folds
Hero: raises $0.07 to $0.12
1d0da3a7: calls $0.12
a592735e: folds
713370ec: folds
a2d31939: folds
*** FLOP *** [7c 5d Jd]
Hero: bets $0.16
1d0da3a7: calls $0.16
*** TURN *** [7c 5d Jd] [Ah]
Hero: bets $0.5
1d0da3a7: folds
Uncalled bet ($0.5) returned to Hero
*** SHOWDOWN ***
Hero collected $0.6 from pot
*** SUMMARY ***
Total pot $0.63 | Rake $0.03 | Jackpot $0 | Bingo $0 | Fortune $0
Board [7c 5d Jd Ah]
Seat 1: Hero won ($0.6)
Seat 2: 1d0da3a7 folded on the Turn
Seat 3: a592735e (button) folded before Flop (didn't bet)
Seat 4: 713370ec (small blind) folded before Flop
Seat 5: a2d31939 (big blind) folded before Flop
Seat 6: 5b1dc166 folded before Flop (didn't bet)


Poker Hand #HD1144629464: Hold'em No Limit  ($0.02/$0.05) - 2023/03/03 20:13:47
Table 'NLHBlue116' 6-max Seat #2 is the button
Seat 1: Hero ($5.26 in chips)
Seat 2: 1d0da3a7 ($6.96 in chips)
Seat 3: a592735e ($5.06 in chips)
Seat 4: 713370ec ($9.4 in chips)
Seat 5: a2d31939 ($12.54 in chips)
Seat 6: 5b1dc166 ($5.07 in chips)
a592735e: posts small blind $0.02
713370ec: posts big blind $0.05
*** HOLE CARDS ***
Dealt to Hero [8h 9c]
Dealt to 1d0da3a7 
Dealt to a592735e 
Dealt to 713370ec 
Dealt to a2d31939 
Dealt to 5b1dc166 
a2d31939: folds
5b1dc166: folds
Hero: folds
1d0da3a7: raises $0.08 to $0.13
a592735e: folds
713370ec: folds
Uncalled bet ($0.08) returned to 1d0da3a7
*** SHOWDOWN ***
1d0da3a7 collected $0.12 from pot
*** SUMMARY ***
Total pot $0.12 | Rake $0 | Jackpot $0 | Bingo $0 | Fortune $0
Seat 1: Hero folded before Flop (didn't bet)
Seat 2: 1d0da3a7 (button) collected ($0.12)
Seat 3: a592735e (small blind) folded before Flop
Seat 4: 713370ec (big blind) folded before Flop
Seat 5: a2d31939 folded before Flop (didn't bet)
Seat 6: 5b1dc166 folded before Flop (didn't bet)


Poker Hand #HD1144629417: Hold'em No Limit  ($0.02/$0.05) - 2023/03/03 20:13:32
Table 'NLHBlue116' 6-max Seat #1 is the button
Seat 1: Hero ($5.26 in chips)
Seat 2: 1d0da3a7 ($6.98 in chips)
Seat 3: a592735e ($5.11 in chips)
Seat 4: 713370ec ($9.4 in chips)
Seat 5: a2d31939 ($12.54 in chips)
Seat 6: 5b1dc166 ($5 in chips)
1d0da3a7: posts small blind $0.02
a592735e: posts big blind $0.05
*** HOLE CARDS ***
Dealt to Hero [2c Qd]
Dealt to 1d0da3a7 
Dealt to a592735e 
Dealt to 713370ec 
Dealt to a2d31939 
Dealt to 5b1dc166 
713370ec: folds
a2d31939: folds
5b1dc166: raises $0.08 to $0.13
Hero: folds
1d0da3a7: folds
a592735e: folds
Uncalled bet ($0.08) returned to 5b1dc166
*** SHOWDOWN ***
5b1dc166 collected $0.12 from pot
*** SUMMARY ***
Total pot $0.12 | Rake $0 | Jackpot $0 | Bingo $0 | Fortune $0
Seat 1: Hero (button) folded before Flop (didn't bet)
Seat 2: 1d0da3a7 (small blind) folded before Flop
Seat 3: a592735e (big blind) folded before Flop
Seat 4: 713370ec folded before Flop (didn't bet)
Seat 5: a2d31939 folded before Flop (didn't bet)
Seat 6: 5b1dc166 collected ($0.12)


Poker Hand #HD1144629375: Hold'em No Limit  ($0.02/$0.05) - 2023/03/03 20:13:17
Table 'NLHBlue116' 6-max Seat #6 is the button
Seat 1: Hero ($5.28 in chips)
Seat 2: 1d0da3a7 ($7.03 in chips)
Seat 3: a592735e ($5.04 in chips)
Seat 4: 713370ec ($9.4 in chips)
Seat 5: a2d31939 ($12.54 in chips)
Seat 6: 5b1dc166 ($5 in chips)
Hero: posts small blind $0.02
1d0da3a7: posts big blind $0.05
*** HOLE CARDS ***
Dealt to Hero [Js 7d]
Dealt to 1d0da3a7 
Dealt to a592735e 
Dealt to 713370ec 
Dealt to a2d31939 
Dealt to 5b1dc166 
a592735e: raises $0.1 to $0.15
713370ec: folds
a2d31939: folds
5b1dc166: folds
Hero: folds
1d0da3a7: folds
Uncalled bet ($0.1) returned to a592735e
*** SHOWDOWN ***
a592735e collected $0.12 from pot
*** SUMMARY ***
Total pot $0.12 | Rake $0 | Jackpot $0 | Bingo $0 | Fortune $0
Seat 1: Hero (small blind) folded before Flop
Seat 2: 1d0da3a7 (big blind) folded before Flop
Seat 3: a592735e collected ($0.12)
Seat 4: 713370ec folded before Flop (didn't bet)
Seat 5: a2d31939 folded before Flop (didn't bet)
Seat 6: 5b1dc166 (button) folded before Flop (didn't bet)


Poker Hand #HD1144629331: Hold'em No Limit  ($0.02/$0.05) - 2023/03/03 20:13:04
Table 'NLHBlue116' 6-max Seat #5 is the button
Seat 1: Hero ($5.33 in chips)
Seat 2: 1d0da3a7 ($6.96 in chips)
Seat 3: a592735e ($5.04 in chips)
Seat 4: 713370ec ($9.4 in chips)
Seat 5: a2d31939 ($12.54 in chips)
Seat 6: 5b1dc166 ($5 in chips)
5b1dc166: posts small blind $0.02
Hero: posts big blind $0.05
*** HOLE CARDS ***
Dealt to Hero [4c Jc]
Dealt to 1d0da3a7 
Dealt to a592735e 
Dealt to 713370ec 
Dealt to a2d31939 
Dealt to 5b1dc166 
1d0da3a7: raises $0.08 to $0.13
a592735e: folds
713370ec: folds
a2d31939: folds
5b1dc166: folds
Hero: folds
Uncalled bet ($0.08) returned to 1d0da3a7
*** SHOWDOWN ***
1d0da3a7 collected $0.12 from pot
*** SUMMARY ***
Total pot $0.12 | Rake $0 | Jackpot $0 | Bingo $0 | Fortune $0
Seat 1: Hero (big blind) folded before Flop
Seat 2: 1d0da3a7 collected ($0.12)
Seat 3: a592735e folded before Flop (didn't bet)
Seat 4: 713370ec folded before Flop (didn't bet)
Seat 5: a2d31939 (button) folded before Flop (didn't bet)
Seat 6: 5b1dc166 (small blind) folded before Flop


Poker Hand #HD1144629189: Hold'em No Limit  ($0.02/$0.05) - 2023/03/03 20:12:10
Table 'NLHBlue116' 6-max Seat #4 is the button
Seat 1: Hero ($5.33 in chips)
Seat 2: 1d0da3a7 ($6.96 in chips)
Seat 3: a592735e ($5.04 in chips)
Seat 4: 713370ec ($9.4 in chips)
Seat 5: a2d31939 ($12.32 in chips)
Seat 6: 5b1dc166 ($5.11 in chips)
a2d31939: posts small blind $0.02
5b1dc166: posts big blind $0.05
*** HOLE CARDS ***
Dealt to Hero [3s Td]
Dealt to 1d0da3a7 
Dealt to a592735e 
Dealt to 713370ec 
Dealt to a2d31939 
Dealt to 5b1dc166 
Hero: folds
1d0da3a7: folds
a592735e: folds
713370ec: folds
a2d31939: raises $0.08 to $0.13
5b1dc166: calls $0.08
*** FLOP *** [Qd 4d 4c]
a2d31939: checks
5b1dc166: checks
*** TURN *** [Qd 4d 4c] [Tc]
a2d31939: bets $0.11
5b1dc166: calls $0.11
*** RIVER *** [Qd 4d 4c Tc] [6d]
a2d31939: bets $0.8
5b1dc166: folds
Uncalled bet ($0.8) returned to a2d31939
*** SHOWDOWN ***
a2d31939 collected $0.46 from pot
*** SUMMARY ***
Total pot $0.48 | Rake $0.02 | Jackpot $0 | Bingo $0 | Fortune $0
Board [Qd 4d 4c Tc 6d]
Seat 1: Hero folded before Flop (didn't bet)
Seat 2: 1d0da3a7 folded before Flop (didn't bet)
Seat 3: a592735e folded before Flop (didn't bet)
Seat 4: 713370ec (button) folded before Flop (didn't bet)
Seat 5: a2d31939 (small blind) won ($0.46)
Seat 6: 5b1dc166 (big blind) folded on the River


Poker Hand #HD1144629136: Hold'em No Limit  ($0.02/$0.05) - 2023/03/03 20:11:54
Table 'NLHBlue116' 6-max Seat #3 is the button
Seat 1: Hero ($5.33 in chips)
Seat 2: 1d0da3a7 ($6.96 in chips)
Seat 3: a592735e ($5.04 in chips)
Seat 4: 713370ec ($9.42 in chips)
Seat 5: a2d31939 ($12.3 in chips)
Seat 6: 5b1dc166 ($5.11 in chips)
713370ec: posts small blind $0.02
a2d31939: posts big blind $0.05
*** HOLE CARDS ***
Dealt to Hero [6h 2c]
Dealt to 1d0da3a7 
Dealt to a592735e 
Dealt to 713370ec 
Dealt to a2d31939 
Dealt to 5b1dc166 
5b1dc166: folds
Hero: folds
1d0da3a7: folds
a592735e: folds
713370ec: folds
Uncalled bet ($0.03) returned to a2d31939
*** SHOWDOWN ***
a2d31939 collected $0.04 from pot
*** SUMMARY ***
Total pot $0.04 | Rake $0 | Jackpot $0 | Bingo $0 | Fortune $0
Seat 1: Hero folded before Flop (didn't bet)
Seat 2: 1d0da3a7 folded before Flop (didn't bet)
Seat 3: a592735e (button) folded before Flop (didn't bet)
Seat 4: 713370ec (small blind) folded before Flop
Seat 5: a2d31939 (big blind) collected ($0.04)
Seat 6: 5b1dc166 folded before Flop (didn't bet)


Poker Hand #HD1144629102: Hold'em No Limit  ($0.02/$0.05) - 2023/03/03 20:11:41
Table 'NLHBlue116' 6-max Seat #2 is the button
Seat 1: Hero ($5.26 in chips)
Seat 2: 1d0da3a7 ($6.96 in chips)
Seat 3: a592735e ($5.06 in chips)
Seat 4: 713370ec ($9.47 in chips)
Seat 5: a2d31939 ($12.3 in chips)
Seat 6: 5b1dc166 ($5.11 in chips)
a592735e: posts small blind $0.02
713370ec: posts big blind $0.05
*** HOLE CARDS ***
Dealt to Hero [Ah Kc]
Dealt to 1d0da3a7 
Dealt to a592735e 
Dealt to 713370ec 
Dealt to a2d31939 
Dealt to 5b1dc166 
a2d31939: folds
5b1dc166: folds
Hero: raises $0.08 to $0.13
1d0da3a7: folds
a592735e: folds
713370ec: folds
Uncalled bet ($0.08) returned to Hero
*** SHOWDOWN ***
Hero collected $0.12 from pot
*** SUMMARY ***
Total pot $0.12 | Rake $0 | Jackpot $0 | Bingo $0 | Fortune $0
Seat 1: Hero collected ($0.12)
Seat 2: 1d0da3a7 (button) folded before Flop (didn't bet)
Seat 3: a592735e (small blind) folded before Flop
Seat 4: 713370ec (big blind) folded before Flop
Seat 5: a2d31939 folded before Flop (didn't bet)
Seat 6: 5b1dc166 folded before Flop (didn't bet)


Poker Hand #HD1144629037: Hold'em No Limit  ($0.02/$0.05) - 2023/03/03 20:11:16
Table 'NLHBlue116' 6-max Seat #1 is the button
Seat 1: Hero ($5.26 in chips)
Seat 2: 1d0da3a7 ($6.98 in chips)
Seat 3: a592735e ($5.04 in chips)
Seat 4: 713370ec ($9.47 in chips)
Seat 5: a2d31939 ($12.3 in chips)
Seat 6: 5b1dc166 ($5.11 in chips)
1d0da3a7: posts small blind $0.02
a592735e: posts big blind $0.05
*** HOLE CARDS ***
Dealt to Hero [Js 6s]
Dealt to 1d0da3a7 
Dealt to a592735e 
Dealt to 713370ec 
Dealt to a2d31939 
Dealt to 5b1dc166 
713370ec: folds
a2d31939: folds
5b1dc166: folds
Hero: folds
1d0da3a7: folds
Uncalled bet ($0.03) returned to a592735e
*** SHOWDOWN ***
a592735e collected $0.04 from pot
*** SUMMARY ***
Total pot $0.04 | Rake $0 | Jackpot $0 | Bingo $0 | Fortune $0
Seat 1: Hero (button) folded before Flop (didn't bet)
Seat 2: 1d0da3a7 (small blind) folded before Flop
Seat 3: a592735e (big blind) collected ($0.04)
Seat 4: 713370ec folded before Flop (didn't bet)
Seat 5: a2d31939 folded before Flop (didn't bet)
Seat 6: 5b1dc166 folded before Flop (didn't bet)


Poker Hand #HD1144628948: Hold'em No Limit  ($0.02/$0.05) - 2023/03/03 20:10:46
Table 'NLHBlue116' 6-max Seat #6 is the button
Seat 1: Hero ($5.09 in chips)
Seat 2: 1d0da3a7 ($7.03 in chips)
Seat 3: a592735e ($5.04 in chips)
Seat 4: 713370ec ($9.47 in chips)
Seat 5: a2d31939 ($12.3 in chips)
Seat 6: 5b1dc166 ($5.24 in chips)
Hero: posts small blind $0.02
1d0da3a7: posts big blind $0.05
*** HOLE CARDS ***
Dealt to Hero [9h 9c]
Dealt to 1d0da3a7 
Dealt to a592735e 
Dealt to 713370ec 
Dealt to a2d31939 
Dealt to 5b1dc166 
a592735e: folds
713370ec: folds
a2d31939: folds
5b1dc166: raises $0.08 to $0.13
Hero: raises $0.43 to $0.56
1d0da3a7: folds
5b1dc166: folds
Uncalled bet ($0.43) returned to Hero
*** SHOWDOWN ***
Hero collected $0.3 from pot
*** SUMMARY ***
Total pot $0.31 | Rake $0.01 | Jackpot $0 | Bingo $0 | Fortune $0
Seat 1: Hero (small blind) collected ($0.3)
Seat 2: 1d0da3a7 (big blind) folded before Flop
Seat 3: a592735e folded before Flop (didn't bet)
Seat 4: 713370ec folded before Flop (didn't bet)
Seat 5: a2d31939 folded before Flop (didn't bet)
Seat 6: 5b1dc166 (button) folded before Flop


Poker Hand #HD1144628894: Hold'em No Limit  ($0.02/$0.05) - 2023/03/03 20:10:33
Table 'NLHBlue116' 6-max Seat #5 is the button
Seat 1: Hero ($5.14 in chips)
Seat 2: 1d0da3a7 ($6.96 in chips)
Seat 3: a592735e ($5.04 in chips)
Seat 4: 713370ec ($9.47 in chips)
Seat 5: a2d31939 ($12.3 in chips)
Seat 6: 5b1dc166 ($5.26 in chips)
5b1dc166: posts small blind $0.02
Hero: posts big blind $0.05
*** HOLE CARDS ***
Dealt to Hero [6h Qs]
Dealt to 1d0da3a7 
Dealt to a592735e 
Dealt to 713370ec 
Dealt to a2d31939 
Dealt to 5b1dc166 
1d0da3a7: raises $0.08 to $0.13
a592735e: folds
713370ec: folds
a2d31939: folds
5b1dc166: folds
Hero: folds
Uncalled bet ($0.08) returned to 1d0da3a7
*** SHOWDOWN ***
1d0da3a7 collected $0.12 from pot
*** SUMMARY ***
Total pot $0.12 | Rake $0 | Jackpot $0 | Bingo $0 | Fortune $0
Seat 1: Hero (big blind) folded before Flop
Seat 2: 1d0da3a7 collected ($0.12)
Seat 3: a592735e folded before Flop (didn't bet)
Seat 4: 713370ec folded before Flop (didn't bet)
Seat 5: a2d31939 (button) folded before Flop (didn't bet)
Seat 6: 5b1dc166 (small blind) folded before Flop


Poker Hand #HD1144628851: Hold'em No Limit  ($0.02/$0.05) - 2023/03/03 20:10:18
Table 'NLHBlue116' 6-max Seat #4 is the button
Seat 1: Hero ($5.14 in chips)
Seat 2: 1d0da3a7 ($6.96 in chips)
Seat 3: a592735e ($5.04 in chips)
Seat 4: 713370ec ($9.4 in chips)
Seat 5: a2d31939 ($12.32 in chips)
Seat 6: 5b1dc166 ($5.31 in chips)
a2d31939: posts small blind $0.02
5b1dc166: posts big blind $0.05
*** HOLE CARDS ***
Dealt to Hero [2d 4c]
Dealt to 1d0da3a7 
Dealt to a592735e 
Dealt to 713370ec 
Dealt to a2d31939 
Dealt to 5b1dc166 
Hero: folds
1d0da3a7: folds
a592735e: folds
713370ec: raises $0.1 to $0.15
a2d31939: folds
5b1dc166: folds
Uncalled bet ($0.1) returned to 713370ec
*** SHOWDOWN ***
713370ec collected $0.12 from pot
*** SUMMARY ***
Total pot $0.12 | Rake $0 | Jackpot $0 | Bingo $0 | Fortune $0
Seat 1: Hero folded before Flop (didn't bet)
Seat 2: 1d0da3a7 folded before Flop (didn't bet)
Seat 3: a592735e folded before Flop (didn't bet)
Seat 4: 713370ec (button) collected ($0.12)
Seat 5: a2d31939 (small blind) folded before Flop
Seat 6: 5b1dc166 (big blind) folded before Flop


Poker Hand #HD1144628766: Hold'em No Limit  ($0.02/$0.05) - 2023/03/03 20:09:53
Table 'NLHBlue116' 6-max Seat #3 is the button
Seat 1: Hero ($5.26 in chips)
Seat 2: 1d0da3a7 ($6.96 in chips)
Seat 3: a592735e ($5.04 in chips)
Seat 4: 713370ec ($9.24 in chips)
Seat 5: a2d31939 ($12.37 in chips)
Seat 6: 5b1dc166 ($5.31 in chips)
713370ec: posts small blind $0.02
a2d31939: posts big blind $0.05
*** HOLE CARDS ***
Dealt to Hero [8s 7s]
Dealt to 1d0da3a7 
Dealt to a592735e 
Dealt to 713370ec 
Dealt to a2d31939 
Dealt to 5b1dc166 
5b1dc166: folds
Hero: raises $0.07 to $0.12
1d0da3a7: folds
a592735e: folds
713370ec: raises $0.29 to $0.41
a2d31939: folds
Hero: folds
Uncalled bet ($0.29) returned to 713370ec
*** SHOWDOWN ***
713370ec collected $0.28 from pot
*** SUMMARY ***
Total pot $0.29 | Rake $0.01 | Jackpot $0 | Bingo $0 | Fortune $0
Seat 1: Hero folded before Flop
Seat 2: 1d0da3a7 folded before Flop (didn't bet)
Seat 3: a592735e (button) folded before Flop (didn't bet)
Seat 4: 713370ec (small blind) collected ($0.28)
Seat 5: a2d31939 (big blind) folded before Flop
Seat 6: 5b1dc166 folded before Flop (didn't bet)


Poker Hand #HD1144628732: Hold'em No Limit  ($0.02/$0.05) - 2023/03/03 20:09:40
Table 'NLHBlue116' 6-max Seat #2 is the button
Seat 1: Hero ($5.26 in chips)
Seat 2: 1d0da3a7 ($6.96 in chips)
Seat 3: a592735e ($5.06 in chips)
Seat 4: 713370ec ($9.22 in chips)
Seat 5: a2d31939 ($12.37 in chips)
Seat 6: 5b1dc166 ($5.31 in chips)
a592735e: posts small blind $0.02
713370ec: posts big blind $0.05
*** HOLE CARDS ***
Dealt to Hero [4h 9h]
Dealt to 1d0da3a7 
Dealt to a592735e 
Dealt to 713370ec 
Dealt to a2d31939 
Dealt to 5b1dc166 
a2d31939: folds
5b1dc166: folds
Hero: folds
1d0da3a7: folds
a592735e: folds
Uncalled bet ($0.03) returned to 713370ec
*** SHOWDOWN ***
713370ec collected $0.04 from pot
*** SUMMARY ***
Total pot $0.04 | Rake $0 | Jackpot $0 | Bingo $0 | Fortune $0
Seat 1: Hero folded before Flop (didn't bet)
Seat 2: 1d0da3a7 (button) folded before Flop (didn't bet)
Seat 3: a592735e (small blind) folded before Flop
Seat 4: 713370ec (big blind) collected ($0.04)
Seat 5: a2d31939 folded before Flop (didn't bet)
Seat 6: 5b1dc166 folded before Flop (didn't bet)


Poker Hand #HD1144628626: Hold'em No Limit  ($0.02/$0.05) - 2023/03/03 20:09:05
Table 'NLHBlue116' 6-max Seat #1 is the button
Seat 1: Hero ($5.19 in chips)
Seat 2: 1d0da3a7 ($6.98 in chips)
Seat 3: a592735e ($5.11 in chips)
Seat 4: 713370ec ($9.22 in chips)
Seat 5: a2d31939 ($12.37 in chips)
Seat 6: 5b1dc166 ($5.31 in chips)
1d0da3a7: posts small blind $0.02
a592735e: posts big blind $0.05
*** HOLE CARDS ***
Dealt to Hero [9c As]
Dealt to 1d0da3a7 
Dealt to a592735e 
Dealt to 713370ec 
Dealt to a2d31939 
Dealt to 5b1dc166 
713370ec: folds
a2d31939: folds
5b1dc166: folds
Hero: raises $0.07 to $0.12
1d0da3a7: folds
a592735e: folds
Uncalled bet ($0.07) returned to Hero
*** SHOWDOWN ***
Hero collected $0.12 from pot
*** SUMMARY ***
Total pot $0.12 | Rake $0 | Jackpot $0 | Bingo $0 | Fortune $0
Seat 1: Hero (button) collected ($0.12)
Seat 2: 1d0da3a7 (small blind) folded before Flop
Seat 3: a592735e (big blind) folded before Flop
Seat 4: 713370ec folded before Flop (didn't bet)
Seat 5: a2d31939 folded before Flop (didn't bet)
Seat 6: 5b1dc166 folded before Flop (didn't bet)


Poker Hand #HD1144628603: Hold'em No Limit  ($0.02/$0.05) - 2023/03/03 20:08:57
Table 'NLHBlue116' 6-max Seat #6 is the button
Seat 1: Hero ($5.21 in chips)
Seat 2: 1d0da3a7 ($6.96 in chips)
Seat 3: a592735e ($5.11 in chips)
Seat 4: 713370ec ($9.22 in chips)
Seat 5: a2d31939 ($12.37 in chips)
Seat 6: 5b1dc166 ($5.31 in chips)
Hero: posts small blind $0.02
1d0da3a7: posts big blind $0.05
*** HOLE CARDS ***
Dealt to Hero [8c 3s]
Dealt to 1d0da3a7 
Dealt to a592735e 
Dealt to 713370ec 
Dealt to a2d31939 
Dealt to 5b1dc166 
a592735e: folds
713370ec: folds
a2d31939: folds
5b1dc166: folds
Hero: folds
Uncalled bet ($0.03) returned to 1d0da3a7
*** SHOWDOWN ***
1d0da3a7 collected $0.04 from pot
*** SUMMARY ***
Total pot $0.04 | Rake $0 | Jackpot $0 | Bingo $0 | Fortune $0
Seat 1: Hero (small blind) folded before Flop
Seat 2: 1d0da3a7 (big blind) collected ($0.04)
Seat 3: a592735e folded before Flop (didn't bet)
Seat 4: 713370ec folded before Flop (didn't bet)
Seat 5: a2d31939 folded before Flop (didn't bet)
Seat 6: 5b1dc166 (button) folded before Flop (didn't bet)


Poker Hand #HD1144628485: Hold'em No Limit  ($0.02/$0.05) - 2023/03/03 20:08:16
Table 'NLHBlue116' 6-max Seat #5 is the button
Seat 1: Hero ($5 in chips)
Seat 3: a592735e ($5.11 in chips)
Seat 4: 713370ec ($9.22 in chips)
Seat 5: a2d31939 ($12.58 in chips)
Seat 6: 5b1dc166 ($5.33 in chips)
5b1dc166: posts small blind $0.02
Hero: posts big blind $0.05
*** HOLE CARDS ***
Dealt to Hero [5h Ad]
Dealt to a592735e 
Dealt to 713370ec 
Dealt to a2d31939 
Dealt to 5b1dc166 
a592735e: folds
713370ec: folds
a2d31939: raises $0.07 to $0.12
5b1dc166: folds
Hero: calls $0.07
*** FLOP *** [Ac Jd Jh]
Hero: checks
a2d31939: bets $0.09
Hero: calls $0.09
*** TURN *** [Ac Jd Jh] [As]
Hero: bets $0.15
a2d31939: folds
Uncalled bet ($0.15) returned to Hero
*** SHOWDOWN ***
Hero collected $0.42 from pot
*** SUMMARY ***
Total pot $0.44 | Rake $0.02 | Jackpot $0 | Bingo $0 | Fortune $0
Board [Ac Jd Jh As]
Seat 1: Hero (big blind) won ($0.42)
Seat 3: a592735e folded before Flop (didn't bet)
Seat 4: 713370ec folded before Flop (didn't bet)
Seat 5: a2d31939 (button) folded on the Turn
Seat 6: 5b1dc166 (small blind) folded before Flop


Poker Hand #HD1144628405: Hold'em No Limit  ($0.02/$0.05) - 2023/03/03 20:07:50
Table 'NLHBlue116' 6-max Seat #4 is the button
Seat 1: Hero ($5 in chips)
Seat 3: a592735e ($5.11 in chips)
Seat 4: 713370ec ($9.15 in chips)
Seat 5: a2d31939 ($12.6 in chips)
Seat 6: 5b1dc166 ($5.38 in chips)
a2d31939: posts small blind $0.02
5b1dc166: posts big blind $0.05
*** HOLE CARDS ***
Dealt to Hero [4h 9s]
Dealt to a592735e 
Dealt to 713370ec 
Dealt to a2d31939 
Dealt to 5b1dc166 
Hero: folds
a592735e: folds
713370ec: raises $0.1 to $0.15
a2d31939: folds
5b1dc166: folds
Uncalled bet ($0.1) returned to 713370ec
*** SHOWDOWN ***
713370ec collected $0.12 from pot
*** SUMMARY ***
Total pot $0.12 | Rake $0 | Jackpot $0 | Bingo $0 | Fortune $0
Seat 1: Hero folded before Flop (didn't bet)
Seat 3: a592735e folded before Flop (didn't bet)
Seat 4: 713370ec (button) collected ($0.12)
Seat 5: a2d31939 (small blind) folded before Flop
Seat 6: 5b1dc166 (big blind) folded before Flop


Poker Hand #HD1144628372: Hold'em No Limit  ($0.02/$0.05) - 2023/03/03 20:07:39
Table 'NLHBlue116' 6-max Seat #3 is the button
Seat 1: Hero ($5 in chips)
Seat 3: a592735e ($5.11 in chips)
Seat 4: 713370ec ($9.17 in chips)
Seat 5: a2d31939 ($12.65 in chips)
Seat 6: 5b1dc166 ($5.31 in chips)
713370ec: posts small blind $0.02
a2d31939: posts big blind $0.05
*** HOLE CARDS ***
Dealt to Hero [Td 8s]
Dealt to a592735e 
Dealt to 713370ec 
Dealt to a2d31939 
Dealt to 5b1dc166 
5b1dc166: raises $0.08 to $0.13
Hero: folds
a592735e: folds
713370ec: folds
a2d31939: folds
Uncalled bet ($0.08) returned to 5b1dc166
*** SHOWDOWN ***
5b1dc166 collected $0.12 from pot
*** SUMMARY ***
Total pot $0.12 | Rake $0 | Jackpot $0 | Bingo $0 | Fortune $0
Seat 1: Hero folded before Flop (didn't bet)
Seat 3: a592735e (button) folded before Flop (didn't bet)
Seat 4: 713370ec (small blind) folded before Flop
Seat 5: a2d31939 (big blind) folded before Flop
Seat 6: 5b1dc166 collected ($0.12)


Poker Hand #HD1144628333: Hold'em No Limit  ($0.02/$0.05) - 2023/03/03 20:07:24
Table 'NLHBlue116' 6-max Seat #1 is the button
Seat 1: Hero ($5 in chips)
Seat 3: a592735e ($5.13 in chips)
Seat 4: 713370ec ($9.22 in chips)
Seat 5: a2d31939 ($12.58 in chips)
Seat 6: 5b1dc166 ($5.31 in chips)
a592735e: posts small blind $0.02
713370ec: posts big blind $0.05
*** HOLE CARDS ***
Dealt to Hero [2d Qh]
Dealt to a592735e 
Dealt to 713370ec 
Dealt to a2d31939 
Dealt to 5b1dc166 
a2d31939: raises $0.08 to $0.13
5b1dc166: folds
Hero: folds
a592735e: folds
713370ec: folds
Uncalled bet ($0.08) returned to a2d31939
*** SHOWDOWN ***
a2d31939 collected $0.12 from pot
*** SUMMARY ***
Total pot $0.12 | Rake $0 | Jackpot $0 | Bingo $0 | Fortune $0
Seat 1: Hero (button) folded before Flop (didn't bet)
Seat 3: a592735e (small blind) folded before Flop
Seat 4: 713370ec (big blind) folded before Flop
Seat 5: a2d31939 collected ($0.12)
Seat 6: 5b1dc166 folded before Flop (didn't bet)


Poker Hand #HD1144628244: Hold'em No Limit  ($0.02/$0.05) - 2023/03/03 20:06:54
Table 'NLHBlue116' 6-max Seat #6 is the button
Seat 1: Hero ($5 in chips)
Seat 3: a592735e ($5 in chips)
Seat 4: 713370ec ($9.22 in chips)
Seat 5: a2d31939 ($12.58 in chips)
Seat 6: 5b1dc166 ($5.31 in chips)
Hero: posts small blind $0.02
a592735e: posts big blind $0.05
*** HOLE CARDS ***
Dealt to Hero [Qc 9d]
Dealt to a592735e 
Dealt to 713370ec 
Dealt to a2d31939 
Dealt to 5b1dc166 
713370ec: folds
a2d31939: folds
5b1dc166: folds
Hero: raises $0.09 to $0.14
a592735e: raises $0.4 to $0.54
Hero: folds
Uncalled bet ($0.4) returned to a592735e
*** SHOWDOWN ***
a592735e collected $0.27 from pot
*** SUMMARY ***
Total pot $0.28 | Rake $0.01 | Jackpot $0 | Bingo $0 | Fortune $0
Seat 1: Hero (small blind) folded before Flop
Seat 3: a592735e (big blind) collected ($0.27)
Seat 4: 713370ec folded before Flop (didn't bet)
Seat 5: a2d31939 folded before Flop (didn't bet)
Seat 6: 5b1dc166 (button) folded before Flop (didn't bet)


Poker Hand #HD1144628223: Hold'em No Limit  ($0.02/$0.05) - 2023/03/03 20:06:45
Table 'NLHBlue116' 6-max Seat #5 is the button
Seat 1: Hero ($5 in chips)
Seat 4: 713370ec ($9.15 in chips)
Seat 5: a2d31939 ($12.58 in chips)
Seat 6: 5b1dc166 ($5.33 in chips)
5b1dc166: posts small blind $0.02
Hero: posts big blind $0.05
*** HOLE CARDS ***
Dealt to Hero [5c 9h]
Dealt to 713370ec 
Dealt to a2d31939 
Dealt to 5b1dc166 
713370ec: raises $0.1 to $0.15
a2d31939: folds
5b1dc166: folds
Hero: folds
Uncalled bet ($0.1) returned to 713370ec
*** SHOWDOWN ***
713370ec collected $0.12 from pot
*** SUMMARY ***
Total pot $0.12 | Rake $0 | Jackpot $0 | Bingo $0 | Fortune $0
Seat 1: Hero (big blind) folded before Flop
Seat 4: 713370ec collected ($0.12)
Seat 5: a2d31939 (button) folded before Flop (didn't bet)
Seat 6: 5b1dc166 (small blind) folded before Flop


Poker Hand #HD1144628130: Hold'em No Limit  ($0.02/$0.05) - 2023/03/03 20:06:16
Table 'NLHBlue116' 6-max Seat #4 is the button
Seat 1: Hero ($5 in chips)
Seat 2: 1d0da3a7 ($6.96 in chips)
Seat 4: 713370ec ($9.08 in chips)
Seat 5: a2d31939 ($12.6 in chips)
Seat 6: 5b1dc166 ($5.38 in chips)
a2d31939: posts small blind $0.02
5b1dc166: posts big blind $0.05
*** HOLE CARDS ***
Dealt to Hero [Qd 6h]
Dealt to 1d0da3a7 
Dealt to 713370ec 
Dealt to a2d31939 
Dealt to 5b1dc166 
Hero: folds
1d0da3a7: folds
713370ec: raises $0.1 to $0.15
a2d31939: folds
5b1dc166: folds
Uncalled bet ($0.1) returned to 713370ec
*** SHOWDOWN ***
713370ec collected $0.12 from pot
*** SUMMARY ***
Total pot $0.12 | Rake $0 | Jackpot $0 | Bingo $0 | Fortune $0
Seat 1: Hero folded before Flop (didn't bet)
Seat 2: 1d0da3a7 folded before Flop (didn't bet)
Seat 4: 713370ec (button) collected ($0.12)
Seat 5: a2d31939 (small blind) folded before Flop
Seat 6: 5b1dc166 (big blind) folded before Flop


Poker Hand #HD1144628088: Hold'em No Limit  ($0.02/$0.05) - 2023/03/03 20:06:04
Table 'NLHBlue116' 6-max Seat #2 is the button
Seat 1: Hero ($5 in chips)
Seat 2: 1d0da3a7 ($6.89 in chips)
Seat 4: 713370ec ($9.1 in chips)
Seat 5: a2d31939 ($12.65 in chips)
Seat 6: 5b1dc166 ($5.38 in chips)
713370ec: posts small blind $0.02
a2d31939: posts big blind $0.05
*** HOLE CARDS ***
Dealt to Hero [2s Th]
Dealt to 1d0da3a7 
Dealt to 713370ec 
Dealt to a2d31939 
Dealt to 5b1dc166 
5b1dc166: folds
Hero: folds
1d0da3a7: raises $0.08 to $0.13
713370ec: folds
a2d31939: folds
Uncalled bet ($0.08) returned to 1d0da3a7
*** SHOWDOWN ***
1d0da3a7 collected $0.12 from pot
*** SUMMARY ***
Total pot $0.12 | Rake $0 | Jackpot $0 | Bingo $0 | Fortune $0
Seat 1: Hero folded before Flop (didn't bet)
Seat 2: 1d0da3a7 (button) collected ($0.12)
Seat 4: 713370ec (small blind) folded before Flop
Seat 5: a2d31939 (big blind) folded before Flop
Seat 6: 5b1dc166 folded before Flop (didn't bet)


Poker Hand #HD1144627933: Hold'em No Limit  ($0.02/$0.05) - 2023/03/03 20:05:18
Table 'NLHBlue116' 6-max Seat #1 is the button
Seat 1: Hero ($5 in chips)
Seat 2: 1d0da3a7 ($7.21 in chips)
Seat 4: 713370ec ($8.81 in chips)
Seat 5: a2d31939 ($12.65 in chips)
Seat 6: 5b1dc166 ($5.38 in chips)
1d0da3a7: posts small blind $0.02
713370ec: posts big blind $0.05
*** HOLE CARDS ***
Dealt to Hero [Qc 3c]
Dealt to 1d0da3a7 
Dealt to 713370ec 
Dealt to a2d31939 
Dealt to 5b1dc166 
a2d31939: folds
5b1dc166: folds
Hero: folds
1d0da3a7: raises $0.08 to $0.13
713370ec: calls $0.08
*** FLOP *** [2h Ts Ad]
1d0da3a7: checks
713370ec: checks
*** TURN *** [2h Ts Ad] [Qh]
1d0da3a7: bets $0.19
713370ec: calls $0.19
*** RIVER *** [2h Ts Ad Qh] [5d]
1d0da3a7: checks
713370ec: checks
1d0da3a7: shows [7h 8h] (Ace-High)
713370ec: shows [8d As] (Pair of Aces)
*** SHOWDOWN ***
713370ec collected $0.61 from pot
*** SUMMARY ***
Total pot $0.64 | Rake $0.03 | Jackpot $0 | Bingo $0 | Fortune $0
Board [2h Ts Ad Qh 5d]
Seat 1: Hero (button) folded before Flop (didn't bet)
Seat 2: 1d0da3a7 (small blind) showed [7h 8h] and lost with Ace-High
Seat 4: 713370ec (big blind) showed [8d As] and won ($0.61) with Pair of Aces
Seat 5: a2d31939 folded before Flop (didn't bet)
Seat 6: 5b1dc166 folded before Flop (didn't bet)


Poker Hand #HD1144627786: Hold'em No Limit  ($0.02/$0.05) - 2023/03/03 20:04:27
Table 'NLHBlue116' 6-max Seat #6 is the button
Seat 1: Hero ($5.09 in chips)
Seat 2: 1d0da3a7 ($6.92 in chips)
Seat 4: 713370ec ($8.81 in chips)
Seat 5: a2d31939 ($12.65 in chips)
Seat 6: 5b1dc166 ($5.38 in chips)
Hero: posts small blind $0.02
1d0da3a7: posts big blind $0.05
*** HOLE CARDS ***
Dealt to Hero [4h 4d]
Dealt to 1d0da3a7 
Dealt to 713370ec 
Dealt to a2d31939 
Dealt to 5b1dc166 
713370ec: folds
a2d31939: folds
5b1dc166: folds
Hero: raises $0.11 to $0.16
1d0da3a7: calls $0.11
*** FLOP *** [8s Jh Kd]
Hero: bets $0.16
1d0da3a7: calls $0.16
*** TURN *** [8s Jh Kd] [As]
Hero: checks
1d0da3a7: checks
*** RIVER *** [8s Jh Kd As] [Kh]
Hero: checks
1d0da3a7: bets $0.36
Hero: folds
Uncalled bet ($0.36) returned to 1d0da3a7
*** SHOWDOWN ***
1d0da3a7 collected $0.61 from pot
*** SUMMARY ***
Total pot $0.64 | Rake $0.03 | Jackpot $0 | Bingo $0 | Fortune $0
Board [8s Jh Kd As Kh]
Seat 1: Hero (small blind) folded on the River
Seat 2: 1d0da3a7 (big blind) won ($0.61)
Seat 4: 713370ec folded before Flop (didn't bet)
Seat 5: a2d31939 folded before Flop (didn't bet)
Seat 6: 5b1dc166 (button) folded before Flop (didn't bet)


Poker Hand #HD1144627746: Hold'em No Limit  ($0.02/$0.05) - 2023/03/03 20:04:12
Table 'NLHBlue116' 6-max Seat #5 is the button
Seat 1: Hero ($5.14 in chips)
Seat 2: 1d0da3a7 ($6.92 in chips)
Seat 4: 713370ec ($8.81 in chips)
Seat 5: a2d31939 ($12.58 in chips)
Seat 6: 5b1dc166 ($5.4 in chips)
5b1dc166: posts small blind $0.02
Hero: posts big blind $0.05
*** HOLE CARDS ***
Dealt to Hero [5h 8c]
Dealt to 1d0da3a7 
Dealt to 713370ec 
Dealt to a2d31939 
Dealt to 5b1dc166 
1d0da3a7: folds
713370ec: folds
a2d31939: raises $0.07 to $0.12
5b1dc166: folds
Hero: folds
Uncalled bet ($0.07) returned to a2d31939
*** SHOWDOWN ***
a2d31939 collected $0.12 from pot
*** SUMMARY ***
Total pot $0.12 | Rake $0 | Jackpot $0 | Bingo $0 | Fortune $0
Seat 1: Hero (big blind) folded before Flop
Seat 2: 1d0da3a7 folded before Flop (didn't bet)
Seat 4: 713370ec folded before Flop (didn't bet)
Seat 5: a2d31939 (button) collected ($0.12)
Seat 6: 5b1dc166 (small blind) folded before Flop


Poker Hand #HD1144627704: Hold'em No Limit  ($0.02/$0.05) - 2023/03/03 20:03:58
Table 'NLHBlue116' 6-max Seat #4 is the button
Seat 1: Hero ($5.07 in chips)
Seat 2: 1d0da3a7 ($6.92 in chips)
Seat 3: 2c7184d7 ($5 in chips)
Seat 4: 713370ec ($8.81 in chips)
Seat 5: a2d31939 ($12.6 in chips)
Seat 6: 5b1dc166 ($5.45 in chips)
a2d31939: posts small blind $0.02
5b1dc166: posts big blind $0.05
*** HOLE CARDS ***
Dealt to Hero [Qs Qh]
Dealt to 1d0da3a7 
Dealt to 2c7184d7 
Dealt to 713370ec 
Dealt to a2d31939 
Dealt to 5b1dc166 
Hero: raises $0.07 to $0.12
1d0da3a7: folds
2c7184d7: folds
713370ec: folds
a2d31939: folds
5b1dc166: folds
Uncalled bet ($0.07) returned to Hero
*** SHOWDOWN ***
Hero collected $0.12 from pot
*** SUMMARY ***
Total pot $0.12 | Rake $0 | Jackpot $0 | Bingo $0 | Fortune $0
Seat 1: Hero collected ($0.12)
Seat 2: 1d0da3a7 folded before Flop (didn't bet)
Seat 3: 2c7184d7 folded before Flop (didn't bet)
Seat 4: 713370ec (button) folded before Flop (didn't bet)
Seat 5: a2d31939 (small blind) folded before Flop
Seat 6: 5b1dc166 (big blind) folded before Flop


Poker Hand #HD1144627657: Hold'em No Limit  ($0.02/$0.05) - 2023/03/03 20:03:41
Table 'NLHBlue116' 6-max Seat #3 is the button
Seat 1: Hero ($5.07 in chips)
Seat 2: 1d0da3a7 ($6.92 in chips)
Seat 3: 2c7184d7 ($4.82 in chips)
Seat 4: 713370ec ($8.83 in chips)
Seat 5: a2d31939 ($12.65 in chips)
Seat 6: 5b1dc166 ($5.38 in chips)
713370ec: posts small blind $0.02
a2d31939: posts big blind $0.05
*** HOLE CARDS ***
Dealt to Hero [9s 7s]
Dealt to 1d0da3a7 
Dealt to 2c7184d7 
Dealt to 713370ec 
Dealt to a2d31939 
Dealt to 5b1dc166 
5b1dc166: raises $0.08 to $0.13
Hero: folds
1d0da3a7: folds
2c7184d7: folds
713370ec: folds
a2d31939: folds
Uncalled bet ($0.08) returned to 5b1dc166
*** SHOWDOWN ***
5b1dc166 collected $0.12 from pot
*** SUMMARY ***
Total pot $0.12 | Rake $0 | Jackpot $0 | Bingo $0 | Fortune $0
Seat 1: Hero folded before Flop (didn't bet)
Seat 2: 1d0da3a7 folded before Flop (didn't bet)
Seat 3: 2c7184d7 (button) folded before Flop (didn't bet)
Seat 4: 713370ec (small blind) folded before Flop
Seat 5: a2d31939 (big blind) folded before Flop
Seat 6: 5b1dc166 collected ($0.12)


Poker Hand #HD1144627602: Hold'em No Limit  ($0.02/$0.05) - 2023/03/03 20:03:22
Table 'NLHBlue116' 6-max Seat #2 is the button
Seat 1: Hero ($5.07 in chips)
Seat 2: 1d0da3a7 ($6.92 in chips)
Seat 3: 2c7184d7 ($4.84 in chips)
Seat 4: 713370ec ($8.81 in chips)
Seat 5: a2d31939 ($12.65 in chips)
Seat 6: 5b1dc166 ($5.38 in chips)
2c7184d7: posts small blind $0.02
713370ec: posts big blind $0.05
*** HOLE CARDS ***
Dealt to Hero [6d Ts]
Dealt to 1d0da3a7 
Dealt to 2c7184d7 
Dealt to 713370ec 
Dealt to a2d31939 
Dealt to 5b1dc166 
a2d31939: folds
5b1dc166: folds
Hero: folds
1d0da3a7: folds
2c7184d7: folds
Uncalled bet ($0.03) returned to 713370ec
*** SHOWDOWN ***
713370ec collected $0.04 from pot
*** SUMMARY ***
Total pot $0.04 | Rake $0 | Jackpot $0 | Bingo $0 | Fortune $0
Seat 1: Hero folded before Flop (didn't bet)
Seat 2: 1d0da3a7 (button) folded before Flop (didn't bet)
Seat 3: 2c7184d7 (small blind) folded before Flop
Seat 4: 713370ec (big blind) collected ($0.04)
Seat 5: a2d31939 folded before Flop (didn't bet)
Seat 6: 5b1dc166 folded before Flop (didn't bet)


Poker Hand #HD1144627551: Hold'em No Limit  ($0.02/$0.05) - 2023/03/03 20:03:06
Table 'NLHBlue116' 6-max Seat #1 is the button
Seat 1: Hero ($5 in chips)
Seat 2: 1d0da3a7 ($6.94 in chips)
Seat 3: 2c7184d7 ($4.89 in chips)
Seat 4: 713370ec ($8.81 in chips)
Seat 5: a2d31939 ($12.65 in chips)
Seat 6: 5b1dc166 ($5.38 in chips)
1d0da3a7: posts small blind $0.02
2c7184d7: posts big blind $0.05
*** HOLE CARDS ***
Dealt to Hero [8d Qd]
Dealt to 1d0da3a7 
Dealt to 2c7184d7 
Dealt to 713370ec 
Dealt to a2d31939 
Dealt to 5b1dc166 
713370ec: folds
a2d31939: folds
5b1dc166: folds
Hero: raises $0.07 to $0.12
1d0da3a7: folds
2c7184d7: folds
Uncalled bet ($0.07) returned to Hero
*** SHOWDOWN ***
Hero collected $0.12 from pot
*** SUMMARY ***
Total pot $0.12 | Rake $0 | Jackpot $0 | Bingo $0 | Fortune $0
Seat 1: Hero (button) collected ($0.12)
Seat 2: 1d0da3a7 (small blind) folded before Flop
Seat 3: 2c7184d7 (big blind) folded before Flop
Seat 4: 713370ec folded before Flop (didn't bet)
Seat 5: a2d31939 folded before Flop (didn't bet)
Seat 6: 5b1dc166 folded before Flop (didn't bet)


Poker Hand #HD1144627487: Hold'em No Limit  ($0.02/$0.05) - 2023/03/03 20:02:43
Table 'NLHBlue116' 6-max Seat #6 is the button
Seat 1: Hero ($5 in chips)
Seat 2: 1d0da3a7 ($6.99 in chips)
Seat 3: 2c7184d7 ($4.89 in chips)
Seat 4: 713370ec ($8.81 in chips)
Seat 5: a2d31939 ($12.65 in chips)
Seat 6: 5b1dc166 ($5.31 in chips)
Hero: posts small blind $0.02
1d0da3a7: posts big blind $0.05
*** HOLE CARDS ***
Dealt to Hero [7d Ah]
Dealt to 1d0da3a7 
Dealt to 2c7184d7 
Dealt to 713370ec 
Dealt to a2d31939 
Dealt to 5b1dc166 
2c7184d7: folds
713370ec: folds
a2d31939: folds
5b1dc166: raises $0.08 to $0.13
Hero: folds
1d0da3a7: folds
Uncalled bet ($0.08) returned to 5b1dc166
*** SHOWDOWN ***
5b1dc166 collected $0.12 from pot
*** SUMMARY ***
Total pot $0.12 | Rake $0 | Jackpot $0 | Bingo $0 | Fortune $0
Seat 1: Hero (small blind) folded before Flop
Seat 2: 1d0da3a7 (big blind) folded before Flop
Seat 3: 2c7184d7 folded before Flop (didn't bet)
Seat 4: 713370ec folded before Flop (didn't bet)
Seat 5: a2d31939 folded before Flop (didn't bet)
Seat 6: 5b1dc166 (button) collected ($0.12)


Poker Hand #HD1144627388: Hold'em No Limit  ($0.02/$0.05) - 2023/03/03 20:02:11
Table 'NLHBlue116' 6-max Seat #5 is the button
Seat 1: Hero ($5 in chips)
Seat 2: 1d0da3a7 ($6.99 in chips)
Seat 3: 2c7184d7 ($4.89 in chips)
Seat 4: 713370ec ($8.81 in chips)
Seat 5: a2d31939 ($12.52 in chips)
Seat 6: 5b1dc166 ($5.33 in chips)
5b1dc166: posts small blind $0.02
Hero: posts big blind $0.05
*** HOLE CARDS ***
Dealt to Hero [Js Qd]
Dealt to 1d0da3a7 
Dealt to 2c7184d7 
Dealt to 713370ec 
Dealt to a2d31939 
Dealt to 5b1dc166 
1d0da3a7: folds
2c7184d7: folds
713370ec: folds
a2d31939: raises $0.07 to $0.12
5b1dc166: folds
Hero: calls $0.07
*** FLOP *** [6c 5d 9h]
Hero: checks
a2d31939: checks
*** TURN *** [6c 5d 9h] [Ks]
Hero: checks
a2d31939: bets $0.09
Hero: folds
Uncalled bet ($0.09) returned to a2d31939
*** SHOWDOWN ***
a2d31939 collected $0.25 from pot
*** SUMMARY ***
Total pot $0.26 | Rake $0.01 | Jackpot $0 | Bingo $0 | Fortune $0
Board [6c 5d 9h Ks]
Seat 1: Hero (big blind) folded on the Turn
Seat 2: 1d0da3a7 folded before Flop (didn't bet)
Seat 3: 2c7184d7 folded before Flop (didn't bet)
Seat 4: 713370ec folded before Flop (didn't bet)
Seat 5: a2d31939 (button) won ($0.25)
Seat 6: 5b1dc166 (small blind) folded before Flop


Poker Hand #HD1144627290: Hold'em No Limit  ($0.02/$0.05) - 2023/03/03 20:01:37
Table 'NLHBlue116' 6-max Seat #4 is the button
Seat 1: Hero ($5 in chips)
Seat 2: 1d0da3a7 ($6.99 in chips)
Seat 3: 2c7184d7 ($4.89 in chips)
Seat 4: 713370ec ($8.81 in chips)
Seat 5: a2d31939 ($12.4 in chips)
Seat 6: 5b1dc166 ($5.46 in chips)
a2d31939: posts small blind $0.02
5b1dc166: posts big blind $0.05
*** HOLE CARDS ***
Dealt to Hero [3c 9s]
Dealt to 1d0da3a7 
Dealt to 2c7184d7 
Dealt to 713370ec 
Dealt to a2d31939 
Dealt to 5b1dc166 
Hero: folds
1d0da3a7: folds
2c7184d7: folds
713370ec: folds
a2d31939: raises $0.08 to $0.13
5b1dc166: calls $0.08
*** FLOP *** [Kd 7h 4s]
a2d31939: bets $0.13
5b1dc166: folds
Uncalled bet ($0.13) returned to a2d31939
*** SHOWDOWN ***
a2d31939 collected $0.25 from pot
*** SUMMARY ***
Total pot $0.26 | Rake $0.01 | Jackpot $0 | Bingo $0 | Fortune $0
Board [Kd 7h 4s]
Seat 1: Hero folded before Flop (didn't bet)
Seat 2: 1d0da3a7 folded before Flop (didn't bet)
Seat 3: 2c7184d7 folded before Flop (didn't bet)
Seat 4: 713370ec (button) folded before Flop (didn't bet)
Seat 5: a2d31939 (small blind) won ($0.25)
Seat 6: 5b1dc166 (big blind) folded on the Flop


Poker Hand #HD1144627259: Hold'em No Limit  ($0.02/$0.05) - 2023/03/03 20:01:30
Table 'NLHBlue116' 6-max Seat #3 is the button
Seat 1: Hero ($5 in chips)
Seat 2: 1d0da3a7 ($6.99 in chips)
Seat 3: 2c7184d7 ($4.89 in chips)
Seat 4: 713370ec ($8.83 in chips)
Seat 5: a2d31939 ($12.38 in chips)
Seat 6: 5b1dc166 ($5.46 in chips)
713370ec: posts small blind $0.02
a2d31939: posts big blind $0.05
*** HOLE CARDS ***
Dealt to Hero [3c Th]
Dealt to 1d0da3a7 
Dealt to 2c7184d7 
Dealt to 713370ec 
Dealt to a2d31939 
Dealt to 5b1dc166 
5b1dc166: folds
Hero: folds
1d0da3a7: folds
2c7184d7: folds
713370ec: folds
Uncalled bet ($0.03) returned to a2d31939
*** SHOWDOWN ***
a2d31939 collected $0.04 from pot
*** SUMMARY ***
Total pot $0.04 | Rake $0 | Jackpot $0 | Bingo $0 | Fortune $0
Seat 1: Hero folded before Flop (didn't bet)
Seat 2: 1d0da3a7 folded before Flop (didn't bet)
Seat 3: 2c7184d7 (button) folded before Flop (didn't bet)
Seat 4: 713370ec (small blind) folded before Flop
Seat 5: a2d31939 (big blind) collected ($0.04)
Seat 6: 5b1dc166 folded before Flop (didn't bet)


Poker Hand #HD1144627118: Hold'em No Limit  ($0.02/$0.05) - 2023/03/03 20:00:41
Table 'NLHBlue116' 6-max Seat #2 is the button
Seat 1: Hero ($5 in chips)
Seat 2: 1d0da3a7 ($6.82 in chips)
Seat 3: 2c7184d7 ($5.02 in chips)
Seat 4: 713370ec ($8.88 in chips)
Seat 5: a2d31939 ($12.38 in chips)
Seat 6: 5b1dc166 ($5.46 in chips)
2c7184d7: posts small blind $0.02
713370ec: posts big blind $0.05
*** HOLE CARDS ***
Dealt to Hero [8c Jd]
Dealt to 1d0da3a7 
Dealt to 2c7184d7 
Dealt to 713370ec 
Dealt to a2d31939 
Dealt to 5b1dc166 
a2d31939: folds
5b1dc166: folds
Hero: folds
1d0da3a7: raises $0.08 to $0.13
2c7184d7: calls $0.11
713370ec: folds
*** FLOP *** [4s 5d 9h]
2c7184d7: checks
1d0da3a7: checks
*** TURN *** [4s 5d 9h] [Js]
2c7184d7: checks
1d0da3a7: bets $0.23
2c7184d7: folds
Uncalled bet ($0.23) returned to 1d0da3a7
*** SHOWDOWN ***
1d0da3a7 collected $0.3 from pot
*** SUMMARY ***
Total pot $0.31 | Rake $0.01 | Jackpot $0 | Bingo $0 | Fortune $0
Board [4s 5d 9h Js]
Seat 1: Hero folded before Flop (didn't bet)
Seat 2: 1d0da3a7 (button) won ($0.3)
Seat 3: 2c7184d7 (small blind) folded on the Turn
Seat 4: 713370ec (big blind) folded before Flop
Seat 5: a2d31939 folded before Flop (didn't bet)
Seat 6: 5b1dc166 folded before Flop (didn't bet)


Poker Hand #HD1144627059: Hold'em No Limit  ($0.02/$0.05) - 2023/03/03 20:00:20
Table 'NLHBlue116' 6-max Seat #1 is the button
Seat 1: Hero ($5 in chips)
Seat 2: 1d0da3a7 ($6.84 in chips)
Seat 3: 2c7184d7 ($5.07 in chips)
Seat 4: 713370ec ($8.88 in chips)
Seat 5: a2d31939 ($12.38 in chips)
Seat 6: 5b1dc166 ($5.39 in chips)
1d0da3a7: posts small blind $0.02
2c7184d7: posts big blind $0.05
*** HOLE CARDS ***
Dealt to Hero [Th Qd]
Dealt to 1d0da3a7 
Dealt to 2c7184d7 
Dealt to 713370ec 
Dealt to a2d31939 
Dealt to 5b1dc166 
713370ec: folds
a2d31939: folds
5b1dc166: raises $0.08 to $0.13
Hero: folds
1d0da3a7: folds
2c7184d7: folds
Uncalled bet ($0.08) returned to 5b1dc166
*** SHOWDOWN ***
5b1dc166 collected $0.12 from pot
*** SUMMARY ***
Total pot $0.12 | Rake $0 | Jackpot $0 | Bingo $0 | Fortune $0
Seat 1: Hero (button) folded before Flop (didn't bet)
Seat 2: 1d0da3a7 (small blind) folded before Flop
Seat 3: 2c7184d7 (big blind) folded before Flop
Seat 4: 713370ec folded before Flop (didn't bet)
Seat 5: a2d31939 folded before Flop (didn't bet)
Seat 6: 5b1dc166 collected ($0.12)


Poker Hand #HD1144627011: Hold'em No Limit  ($0.02/$0.05) - 2023/03/03 20:00:05
Table 'NLHBlue116' 6-max Seat #6 is the button
Seat 1: Hero ($5.02 in chips)
Seat 2: 1d0da3a7 ($6.89 in chips)
Seat 4: 713370ec ($8.88 in chips)
Seat 5: a2d31939 ($12.31 in chips)
Seat 6: 5b1dc166 ($5.39 in chips)
Hero: posts small blind $0.02
1d0da3a7: posts big blind $0.05
*** HOLE CARDS ***
Dealt to Hero [6h 5c]
Dealt to 1d0da3a7 
Dealt to 713370ec 
Dealt to a2d31939 
Dealt to 5b1dc166 
713370ec: folds
a2d31939: raises $0.08 to $0.13
5b1dc166: folds
Hero: folds
1d0da3a7: folds
Uncalled bet ($0.08) returned to a2d31939
*** SHOWDOWN ***
a2d31939 collected $0.12 from pot
*** SUMMARY ***
Total pot $0.12 | Rake $0 | Jackpot $0 | Bingo $0 | Fortune $0
Seat 1: Hero (small blind) folded before Flop
Seat 2: 1d0da3a7 (big blind) folded before Flop
Seat 4: 713370ec folded before Flop (didn't bet)
Seat 5: a2d31939 collected ($0.12)
Seat 6: 5b1dc166 (button) folded before Flop (didn't bet)


Poker Hand #HD1144626969: Hold'em No Limit  ($0.02/$0.05) - 2023/03/03 19:59:52
Table 'NLHBlue116' 6-max Seat #5 is the button
Seat 1: Hero ($5 in chips)
Seat 2: 1d0da3a7 ($6.89 in chips)
Seat 4: 713370ec ($8.88 in chips)
Seat 5: a2d31939 ($12.31 in chips)
Seat 6: 5b1dc166 ($5.41 in chips)
5b1dc166: posts small blind $0.02
Hero: posts big blind $0.05
*** HOLE CARDS ***
Dealt to Hero [5d Ad]
Dealt to 1d0da3a7 
Dealt to 713370ec 
Dealt to a2d31939 
Dealt to 5b1dc166 
1d0da3a7: folds
713370ec: folds
a2d31939: folds
5b1dc166: folds
Uncalled bet ($0.03) returned to Hero
*** SHOWDOWN ***
Hero collected $0.04 from pot
*** SUMMARY ***
Total pot $0.04 | Rake $0 | Jackpot $0 | Bingo $0 | Fortune $0
Seat 1: Hero (big blind) collected ($0.04)
Seat 2: 1d0da3a7 folded before Flop (didn't bet)
Seat 4: 713370ec folded before Flop (didn't bet)
Seat 5: a2d31939 (button) folded before Flop (didn't bet)
Seat 6: 5b1dc166 (small blind) folded before Flop


Poker Hand #HD1144626874: Hold'em No Limit  ($0.02/$0.05) - 2023/03/03 19:59:23
Table 'NLHBlue116' 6-max Seat #4 is the button
Seat 1: Hero ($5 in chips)
Seat 2: 1d0da3a7 ($6.89 in chips)
Seat 4: 713370ec ($9.03 in chips)
Seat 5: a2d31939 ($12.12 in chips)
Seat 6: 5b1dc166 ($5.46 in chips)
a2d31939: posts small blind $0.02
5b1dc166: posts big blind $0.05
*** HOLE CARDS ***
Dealt to Hero [5s 3c]
Dealt to 1d0da3a7 
Dealt to 713370ec 
Dealt to a2d31939 
Dealt to 5b1dc166 
Hero: folds
1d0da3a7: folds
713370ec: raises $0.1 to $0.15
a2d31939: raises $0.55 to $0.7
5b1dc166: folds
713370ec: folds
Uncalled bet ($0.55) returned to a2d31939
*** SHOWDOWN ***
a2d31939 collected $0.34 from pot
*** SUMMARY ***
Total pot $0.35 | Rake $0.01 | Jackpot $0 | Bingo $0 | Fortune $0
Seat 1: Hero folded before Flop (didn't bet)
Seat 2: 1d0da3a7 folded before Flop (didn't bet)
Seat 4: 713370ec (button) folded before Flop
Seat 5: a2d31939 (small blind) collected ($0.34)
Seat 6: 5b1dc166 (big blind) folded before Flop


Poker Hand #HD1144626647: Hold'em No Limit  ($0.02/$0.05) - 2023/03/03 19:58:07
Table 'NLHBlue116' 6-max Seat #2 is the button
Seat 1: Hero ($5 in chips)
Seat 2: 1d0da3a7 ($7.23 in chips)
Seat 4: 713370ec ($9.05 in chips)
Seat 5: a2d31939 ($11.67 in chips)
Seat 6: 5b1dc166 ($5.59 in chips)
713370ec: posts small blind $0.02
a2d31939: posts big blind $0.05
*** HOLE CARDS ***
Dealt to Hero [4c Jc]
Dealt to 1d0da3a7 
Dealt to 713370ec 
Dealt to a2d31939 
Dealt to 5b1dc166 
5b1dc166: raises $0.08 to $0.13
Hero: folds
1d0da3a7: calls $0.13
713370ec: folds
a2d31939: calls $0.08
*** FLOP *** [4h 9s 9c]
a2d31939: checks
5b1dc166: checks
1d0da3a7: checks
*** TURN *** [4h 9s 9c] [4d]
a2d31939: bets $0.21
5b1dc166: folds
1d0da3a7: calls $0.21
*** RIVER *** [4h 9s 9c 4d] [6d]
a2d31939: bets $0.83
1d0da3a7: folds
Uncalled bet ($0.83) returned to a2d31939
*** SHOWDOWN ***
a2d31939 collected $0.79 from pot
*** SUMMARY ***
Total pot $0.83 | Rake $0.04 | Jackpot $0 | Bingo $0 | Fortune $0
Board [4h 9s 9c 4d 6d]
Seat 1: Hero folded before Flop (didn't bet)
Seat 2: 1d0da3a7 (button) folded on the River
Seat 4: 713370ec (small blind) folded before Flop
Seat 5: a2d31939 (big blind) won ($0.79)
Seat 6: 5b1dc166 folded on the Turn


Poker Hand #HD1144626539: Hold'em No Limit  ($0.02/$0.05) - 2023/03/03 19:57:31
Table 'NLHBlue116' 6-max Seat #1 is the button
Seat 1: Hero ($5 in chips)
Seat 2: 1d0da3a7 ($6.76 in chips)
Seat 4: 713370ec ($9.17 in chips)
Seat 5: a2d31939 ($11.67 in chips)
Seat 6: 5b1dc166 ($5.59 in chips)
1d0da3a7: posts small blind $0.02
713370ec: posts big blind $0.05
*** HOLE CARDS ***
Dealt to Hero [9s Ks]
Dealt to 1d0da3a7 
Dealt to 713370ec 
Dealt to a2d31939 
Dealt to 5b1dc166 
a2d31939: folds
5b1dc166: folds
Hero: raises $0.07 to $0.12
1d0da3a7: calls $0.1
713370ec: calls $0.07
*** FLOP *** [8s 2d 6h]
1d0da3a7: checks
713370ec: checks
Hero: checks
*** TURN *** [8s 2d 6h] [7s]
1d0da3a7: bets $0.27
713370ec: folds
Hero: calls $0.27
*** RIVER *** [8s 2d 6h 7s] [2h]
1d0da3a7: bets $0.74
Hero: folds
Uncalled bet ($0.74) returned to 1d0da3a7
1d0da3a7: shows [Th] (Pair of Twos)
*** SHOWDOWN ***
1d0da3a7 collected $0.86 from pot
*** SUMMARY ***
Total pot $0.9 | Rake $0.04 | Jackpot $0 | Bingo $0 | Fortune $0
Board [8s 2d 6h 7s 2h]
Seat 1: Hero (button) folded on the River
Seat 2: 1d0da3a7 (small blind) showed [Th Qh] and won ($0.86) with Pair of Twos
Seat 4: 713370ec (big blind) folded on the Turn
Seat 5: a2d31939 folded before Flop (didn't bet)
Seat 6: 5b1dc166 folded before Flop (didn't bet)


Poker Hand #HD1144626473: Hold'em No Limit  ($0.02/$0.05) - 2023/03/03 19:57:10
Table 'NLHBlue116' 6-max Seat #6 is the button
Seat 1: Hero ($5 in chips)
Seat 2: 1d0da3a7 ($6.61 in chips)
Seat 4: 713370ec ($9.17 in chips)
Seat 5: a2d31939 ($11.67 in chips)
Seat 6: 5b1dc166 ($5.59 in chips)
Hero: posts small blind $0.02
1d0da3a7: posts big blind $0.05
*** HOLE CARDS ***
Dealt to Hero [Qh Td]
Dealt to 1d0da3a7 
Dealt to 713370ec 
Dealt to a2d31939 
Dealt to 5b1dc166 
713370ec: folds
a2d31939: folds
5b1dc166: folds
Hero: raises $0.11 to $0.16
1d0da3a7: raises $0.38 to $0.54
Hero: folds
Uncalled bet ($0.38) returned to 1d0da3a7
*** SHOWDOWN ***
1d0da3a7 collected $0.31 from pot
*** SUMMARY ***
Total pot $0.32 | Rake $0.01 | Jackpot $0 | Bingo $0 | Fortune $0
Seat 1: Hero (small blind) folded before Flop
Seat 2: 1d0da3a7 (big blind) collected ($0.31)
Seat 4: 713370ec folded before Flop (didn't bet)
Seat 5: a2d31939 folded before Flop (didn't bet)
Seat 6: 5b1dc166 (button) folded before Flop (didn't bet)


Poker Hand #HD1144626358: Hold'em No Limit  ($0.02/$0.05) - 2023/03/03 19:56:25
Table 'NLHBlue116' 6-max Seat #5 is the button
Seat 1: Hero ($5 in chips)
Seat 2: 1d0da3a7 ($6.54 in chips)
Seat 4: 713370ec ($9.17 in chips)
Seat 5: a2d31939 ($11.67 in chips)
Seat 6: 5b1dc166 ($5.61 in chips)
5b1dc166: posts small blind $0.02
Hero: posts big blind $0.05
*** HOLE CARDS ***
Dealt to Hero [3s Jc]
Dealt to 1d0da3a7 
Dealt to 713370ec 
Dealt to a2d31939 
Dealt to 5b1dc166 
1d0da3a7: raises $0.08 to $0.13
713370ec: folds
a2d31939: folds
5b1dc166: folds
Hero: folds
Uncalled bet ($0.08) returned to 1d0da3a7
*** SHOWDOWN ***
1d0da3a7 collected $0.12 from pot
*** SUMMARY ***
Total pot $0.12 | Rake $0 | Jackpot $0 | Bingo $0 | Fortune $0
Seat 1: Hero (big blind) folded before Flop
Seat 2: 1d0da3a7 collected ($0.12)
Seat 4: 713370ec folded before Flop (didn't bet)
Seat 5: a2d31939 (button) folded before Flop (didn't bet)
Seat 6: 5b1dc166 (small blind) folded before Flop


Poker Hand #HD1144626064: Hold'em No Limit  ($0.02/$0.05) - 2023/03/03 19:54:51
Table 'NLHBlue116' 6-max Seat #4 is the button
Seat 1: Hero ($5 in chips)
Seat 2: 1d0da3a7 ($6.54 in chips)
Seat 3: 4a9a77f4 ($3.96 in chips)
Seat 4: 713370ec ($9.39 in chips)
Seat 5: a2d31939 ($7.89 in chips)
Seat 6: 5b1dc166 ($5.66 in chips)
a2d31939: posts small blind $0.02
5b1dc166: posts big blind $0.05
*** HOLE CARDS ***
Dealt to Hero [8c 5d]
Dealt to 1d0da3a7 
Dealt to 4a9a77f4 
Dealt to 713370ec 
Dealt to a2d31939 
Dealt to 5b1dc166 
Hero: folds
1d0da3a7: folds
4a9a77f4: calls $0.05
713370ec: raises $0.17 to $0.22
a2d31939: raises $0.73 to $0.95
5b1dc166: folds
4a9a77f4: calls $0.9
713370ec: folds
*** FLOP *** [5h Td 9d]
a2d31939: checks
4a9a77f4: bets $3.01 and is all-in
a2d31939: calls $3.01
4a9a77f4: shows [Ts 8s] (Pair of Tens)
a2d31939: shows [Ad Kh] (Ace-High)
4a9a77f4: Chooses to EV Cashout 
*** TURN *** [5h Td 9d] [Jd]
4a9a77f4: Pays Cashout Risk ($0.56)
4a9a77f4: Chooses to EV Cashout 
*** RIVER *** [5h Td 9d Jd] [Ac]
4a9a77f4: Receives Cashout ($0.56)
*** SHOWDOWN ***
a2d31939 collected $7.74 from pot
*** SUMMARY ***
Total pot $8.19 | Rake $0.4 | Jackpot $0.05 | Bingo $0 | Fortune $0
Board [5h Td 9d Jd Ac]
Seat 1: Hero folded before Flop (didn't bet)
Seat 2: 1d0da3a7 folded before Flop (didn't bet)
Seat 3: 4a9a77f4 showed [Ts 8s] and lost with Pair of Tens, Cashout Risk ($0.56), EV Cashout ($0)
Seat 4: 713370ec (button) folded before Flop
Seat 5: a2d31939 (small blind) showed [Ad Kh] and won ($7.74) with Pair of Aces
Seat 6: 5b1dc166 (big blind) folded before Flop


Poker Hand #HD1144625894: Hold'em No Limit  ($0.02/$0.05) - 2023/03/03 19:53:55
Table 'NLHBlue116' 6-max Seat #3 is the button
Seat 1: Hero ($5 in chips)
Seat 2: 1d0da3a7 ($6.67 in chips)
Seat 3: 4a9a77f4 ($3.7 in chips)
Seat 4: 713370ec ($9.41 in chips)
Seat 5: a2d31939 ($8.02 in chips)
Seat 6: 5b1dc166 ($5.66 in chips)
713370ec: posts small blind $0.02
a2d31939: posts big blind $0.05
*** HOLE CARDS ***
Dealt to Hero [5d 8c]
Dealt to 1d0da3a7 
Dealt to 4a9a77f4 
Dealt to 713370ec 
Dealt to a2d31939 
Dealt to 5b1dc166 
5b1dc166: folds
Hero: folds
1d0da3a7: raises $0.08 to $0.13
4a9a77f4: calls $0.13
713370ec: folds
a2d31939: calls $0.08
*** FLOP *** [Jc Qh 4h]
a2d31939: checks
1d0da3a7: checks
4a9a77f4: bets $0.21
a2d31939: folds
1d0da3a7: folds
Uncalled bet ($0.21) returned to 4a9a77f4
*** SHOWDOWN ***
4a9a77f4 collected $0.39 from pot
*** SUMMARY ***
Total pot $0.41 | Rake $0.02 | Jackpot $0 | Bingo $0 | Fortune $0
Board [Jc Qh 4h]
Seat 1: Hero folded before Flop (didn't bet)
Seat 2: 1d0da3a7 folded on the Flop
Seat 3: 4a9a77f4 (button) won ($0.39)
Seat 4: 713370ec (small blind) folded before Flop
Seat 5: a2d31939 (big blind) folded on the Flop
Seat 6: 5b1dc166 folded before Flop (didn't bet)


Poker Hand #HD1144625773: Hold'em No Limit  ($0.02/$0.05) - 2023/03/03 19:53:15
Table 'NLHBlue116' 6-max Seat #2 is the button
Seat 1: Hero ($5.05 in chips)
Seat 2: 1d0da3a7 ($6.67 in chips)
Seat 3: 4a9a77f4 ($3.45 in chips)
Seat 4: 713370ec ($9.46 in chips)
Seat 5: a2d31939 ($8.02 in chips)
Seat 6: 5b1dc166 ($5.66 in chips)
4a9a77f4: posts small blind $0.02
713370ec: posts big blind $0.05
*** HOLE CARDS ***
Dealt to Hero [Jd Kh]
Dealt to 1d0da3a7 
Dealt to 4a9a77f4 
Dealt to 713370ec 
Dealt to a2d31939 
Dealt to 5b1dc166 
a2d31939: folds
5b1dc166: folds
Hero: raises $0.07 to $0.12
1d0da3a7: folds
4a9a77f4: raises $0.1 to $0.22
713370ec: folds
Hero: calls $0.1
*** FLOP *** [2h 2d Ad]
4a9a77f4: bets $0.37
Hero: folds
Uncalled bet ($0.37) returned to 4a9a77f4
*** SHOWDOWN ***
4a9a77f4 collected $0.47 from pot
*** SUMMARY ***
Total pot $0.49 | Rake $0.02 | Jackpot $0 | Bingo $0 | Fortune $0
Board [2h 2d Ad]
Seat 1: Hero folded on the Flop
Seat 2: 1d0da3a7 (button) folded before Flop (didn't bet)
Seat 3: 4a9a77f4 (small blind) won ($0.47)
Seat 4: 713370ec (big blind) folded before Flop
Seat 5: a2d31939 folded before Flop (didn't bet)
Seat 6: 5b1dc166 folded before Flop (didn't bet)


Poker Hand #HD1144625656: Hold'em No Limit  ($0.02/$0.05) - 2023/03/03 19:52:36
Table 'NLHBlue116' 6-max Seat #1 is the button
Seat 1: Hero ($5.05 in chips)
Seat 2: 1d0da3a7 ($6.69 in chips)
Seat 3: 4a9a77f4 ($3.58 in chips)
Seat 4: 713370ec ($9.46 in chips)
Seat 5: a2d31939 ($7.88 in chips)
Seat 6: 5b1dc166 ($5.66 in chips)
1d0da3a7: posts small blind $0.02
4a9a77f4: posts big blind $0.05
*** HOLE CARDS ***
Dealt to Hero [Jc 7d]
Dealt to 1d0da3a7 
Dealt to 4a9a77f4 
Dealt to 713370ec 
Dealt to a2d31939 
Dealt to 5b1dc166 
713370ec: folds
a2d31939: raises $0.08 to $0.13
5b1dc166: folds
Hero: folds
1d0da3a7: folds
4a9a77f4: calls $0.08
*** FLOP *** [5h 6s 3c]
4a9a77f4: checks
a2d31939: bets $0.14
4a9a77f4: folds
Uncalled bet ($0.14) returned to a2d31939
*** SHOWDOWN ***
a2d31939 collected $0.27 from pot
*** SUMMARY ***
Total pot $0.28 | Rake $0.01 | Jackpot $0 | Bingo $0 | Fortune $0
Board [5h 6s 3c]
Seat 1: Hero (button) folded before Flop (didn't bet)
Seat 2: 1d0da3a7 (small blind) folded before Flop
Seat 3: 4a9a77f4 (big blind) folded on the Flop
Seat 4: 713370ec folded before Flop (didn't bet)
Seat 5: a2d31939 won ($0.27)
Seat 6: 5b1dc166 folded before Flop (didn't bet)


Poker Hand #HD1144565609: Hold'em No Limit  ($0.02/$0.05) - 2023/03/03 19:52:22
Table 'NLHBlue116' 6-max Seat #6 is the button
Seat 1: Hero ($5 in chips)
Seat 2: 1d0da3a7 ($6.74 in chips)
Seat 4: 713370ec ($9.46 in chips)
Seat 5: a2d31939 ($7.88 in chips)
Seat 6: 5b1dc166 ($5.66 in chips)
Hero: posts small blind $0.02
1d0da3a7: posts big blind $0.05
*** HOLE CARDS ***
Dealt to Hero [Ad 7d]
Dealt to 1d0da3a7 
Dealt to 713370ec 
Dealt to a2d31939 
Dealt to 5b1dc166 
713370ec: folds
a2d31939: folds
5b1dc166: folds
Hero: raises $0.09 to $0.14
1d0da3a7: folds
Uncalled bet ($0.09) returned to Hero
*** SHOWDOWN ***
Hero collected $0.1 from pot
*** SUMMARY ***
Total pot $0.1 | Rake $0 | Jackpot $0 | Bingo $0 | Fortune $0
Seat 1: Hero (small blind) collected ($0.1)
Seat 2: 1d0da3a7 (big blind) folded before Flop
Seat 4: 713370ec folded before Flop (didn't bet)
Seat 5: a2d31939 folded before Flop (didn't bet)
Seat 6: 5b1dc166 (button) folded before Flop (didn't bet)


Poker Hand #HD1144565569: Hold'em No Limit  ($0.02/$0.05) - 2023/03/03 19:52:11
Table 'NLHBlue116' 6-max Seat #5 is the button
Seat 1: Hero ($5 in chips)
Seat 2: 1d0da3a7 ($6.74 in chips)
Seat 4: 713370ec ($9.46 in chips)
Seat 5: a2d31939 ($7.81 in chips)
Seat 6: 5b1dc166 ($5.68 in chips)
5b1dc166: posts small blind $0.02
Hero: posts big blind $0.05
*** HOLE CARDS ***
Dealt to Hero [7h 6c]
Dealt to 1d0da3a7 
Dealt to 713370ec 
Dealt to a2d31939 
Dealt to 5b1dc166 
1d0da3a7: folds
713370ec: folds
a2d31939: raises $0.07 to $0.12
5b1dc166: folds
Hero: folds
Uncalled bet ($0.07) returned to a2d31939
*** SHOWDOWN ***
a2d31939 collected $0.12 from pot
*** SUMMARY ***
Total pot $0.12 | Rake $0 | Jackpot $0 | Bingo $0 | Fortune $0
Seat 1: Hero (big blind) folded before Flop
Seat 2: 1d0da3a7 folded before Flop (didn't bet)
Seat 4: 713370ec folded before Flop (didn't bet)
Seat 5: a2d31939 (button) collected ($0.12)
Seat 6: 5b1dc166 (small blind) folded before Flop


Poker Hand #HD1144565502: Hold'em No Limit  ($0.02/$0.05) - 2023/03/03 19:51:49
Table 'NLHBlue116' 6-max Seat #4 is the button
Seat 1: Hero ($5 in chips)
Seat 2: 1d0da3a7 ($6.74 in chips)
Seat 4: 713370ec ($9.39 in chips)
Seat 5: a2d31939 ($7.83 in chips)
Seat 6: 5b1dc166 ($5.73 in chips)
a2d31939: posts small blind $0.02
5b1dc166: posts big blind $0.05
*** HOLE CARDS ***
Dealt to Hero [Th 4d]
Dealt to 1d0da3a7 
Dealt to 713370ec 
Dealt to a2d31939 
Dealt to 5b1dc166 
Hero: folds
1d0da3a7: folds
713370ec: raises $0.1 to $0.15
a2d31939: folds
5b1dc166: folds
Uncalled bet ($0.1) returned to 713370ec
*** SHOWDOWN ***
713370ec collected $0.12 from pot
*** SUMMARY ***
Total pot $0.12 | Rake $0 | Jackpot $0 | Bingo $0 | Fortune $0
Seat 1: Hero folded before Flop (didn't bet)
Seat 2: 1d0da3a7 folded before Flop (didn't bet)
Seat 4: 713370ec (button) collected ($0.12)
Seat 5: a2d31939 (small blind) folded before Flop
Seat 6: 5b1dc166 (big blind) folded before Flop


Poker Hand #HD1144565343: Hold'em No Limit  ($0.02/$0.05) - 2023/03/03 19:51:00
Table 'NLHBlue116' 6-max Seat #2 is the button
Seat 1: Hero ($5 in chips)
Seat 2: 1d0da3a7 ($6.74 in chips)
Seat 4: 713370ec ($9.69 in chips)
Seat 5: a2d31939 ($7.56 in chips)
Seat 6: 5b1dc166 ($5.73 in chips)
713370ec: posts small blind $0.02
a2d31939: posts big blind $0.05
*** HOLE CARDS ***
Dealt to Hero [2h 3d]
Dealt to 1d0da3a7 
Dealt to 713370ec 
Dealt to a2d31939 
Dealt to 5b1dc166 
5b1dc166: folds
Hero: folds
1d0da3a7: folds
713370ec: raises $0.1 to $0.15
a2d31939: calls $0.1
*** FLOP *** [7c Jh 5d]
713370ec: bets $0.15
a2d31939: raises $0.35 to $0.5
713370ec: folds
Uncalled bet ($0.35) returned to a2d31939
*** SHOWDOWN ***
a2d31939 collected $0.57 from pot
*** SUMMARY ***
Total pot $0.6 | Rake $0.03 | Jackpot $0 | Bingo $0 | Fortune $0
Board [7c Jh 5d]
Seat 1: Hero folded before Flop (didn't bet)
Seat 2: 1d0da3a7 (button) folded before Flop (didn't bet)
Seat 4: 713370ec (small blind) folded on the Flop
Seat 5: a2d31939 (big blind) won ($0.57)
Seat 6: 5b1dc166 folded before Flop (didn't bet)


Poker Hand #HD1144565314: Hold'em No Limit  ($0.02/$0.05) - 2023/03/03 19:50:53
Table 'NLHBlue116' 6-max Seat #1 is the button
Seat 1: Hero ($5 in chips)
Seat 2: 1d0da3a7 ($6.76 in chips)
Seat 4: 713370ec ($9.67 in chips)
Seat 5: a2d31939 ($7.56 in chips)
Seat 6: 5b1dc166 ($5.73 in chips)
1d0da3a7: posts small blind $0.02
713370ec: posts big blind $0.05
*** HOLE CARDS ***
Dealt to Hero [7s 5c]
Dealt to 1d0da3a7 
Dealt to 713370ec 
Dealt to a2d31939 
Dealt to 5b1dc166 
a2d31939: folds
5b1dc166: folds
Hero: folds
1d0da3a7: folds
Uncalled bet ($0.03) returned to 713370ec
*** SHOWDOWN ***
713370ec collected $0.04 from pot
*** SUMMARY ***
Total pot $0.04 | Rake $0 | Jackpot $0 | Bingo $0 | Fortune $0
Seat 1: Hero (button) folded before Flop (didn't bet)
Seat 2: 1d0da3a7 (small blind) folded before Flop
Seat 4: 713370ec (big blind) collected ($0.04)
Seat 5: a2d31939 folded before Flop (didn't bet)
Seat 6: 5b1dc166 folded before Flop (didn't bet)


Poker Hand #HD1144565281: Hold'em No Limit  ($0.02/$0.05) - 2023/03/03 19:50:43
Table 'NLHBlue116' 6-max Seat #6 is the button
Seat 1: Hero ($5 in chips)
Seat 2: 1d0da3a7 ($6.81 in chips)
Seat 4: 713370ec ($9.6 in chips)
Seat 5: a2d31939 ($7.56 in chips)
Seat 6: 5b1dc166 ($5.73 in chips)
Hero: posts small blind $0.02
1d0da3a7: posts big blind $0.05
*** HOLE CARDS ***
Dealt to Hero [Ad 3c]
Dealt to 1d0da3a7 
Dealt to 713370ec 
Dealt to a2d31939 
Dealt to 5b1dc166 
713370ec: raises $0.1 to $0.15
a2d31939: folds
5b1dc166: folds
Hero: folds
1d0da3a7: folds
Uncalled bet ($0.1) returned to 713370ec
*** SHOWDOWN ***
713370ec collected $0.12 from pot
*** SUMMARY ***
Total pot $0.12 | Rake $0 | Jackpot $0 | Bingo $0 | Fortune $0
Seat 1: Hero (small blind) folded before Flop
Seat 2: 1d0da3a7 (big blind) folded before Flop
Seat 4: 713370ec collected ($0.12)
Seat 5: a2d31939 folded before Flop (didn't bet)
Seat 6: 5b1dc166 (button) folded before Flop (didn't bet)


Poker Hand #HD1144565172: Hold'em No Limit  ($0.02/$0.05) - 2023/03/03 19:50:06
Table 'NLHBlue116' 6-max Seat #5 is the button
Seat 1: Hero ($5 in chips)
Seat 2: 1d0da3a7 ($6.81 in chips)
Seat 3: 4a9a77f4 ($3.58 in chips)
Seat 4: 713370ec ($9.6 in chips)
Seat 5: a2d31939 ($7.43 in chips)
Seat 6: 5b1dc166 ($5.75 in chips)
5b1dc166: posts small blind $0.02
Hero: posts big blind $0.05
*** HOLE CARDS ***
Dealt to Hero [9s Qd]
Dealt to 1d0da3a7 
Dealt to 4a9a77f4 
Dealt to 713370ec 
Dealt to a2d31939 
Dealt to 5b1dc166 
1d0da3a7: folds
4a9a77f4: folds
713370ec: folds
a2d31939: raises $0.07 to $0.12
5b1dc166: folds
Hero: calls $0.07
*** FLOP *** [Kh 7d Kd]
Hero: checks
a2d31939: checks
*** TURN *** [Kh 7d Kd] [4c]
Hero: checks
a2d31939: bets $0.13
Hero: folds
Uncalled bet ($0.13) returned to a2d31939
*** SHOWDOWN ***
a2d31939 collected $0.25 from pot
*** SUMMARY ***
Total pot $0.26 | Rake $0.01 | Jackpot $0 | Bingo $0 | Fortune $0
Board [Kh 7d Kd 4c]
Seat 1: Hero (big blind) folded on the Turn
Seat 2: 1d0da3a7 folded before Flop (didn't bet)
Seat 3: 4a9a77f4 folded before Flop (didn't bet)
Seat 4: 713370ec folded before Flop (didn't bet)
Seat 5: a2d31939 (button) won ($0.25)
Seat 6: 5b1dc166 (small blind) folded before Flop


Poker Hand #HD1144565069: Hold'em No Limit  ($0.02/$0.05) - 2023/03/03 19:49:37
Table 'NLHBlue116' 6-max Seat #4 is the button
Seat 1: Hero ($5 in chips)
Seat 2: 1d0da3a7 ($6.81 in chips)
Seat 3: 4a9a77f4 ($3.4 in chips)
Seat 4: 713370ec ($9.6 in chips)
Seat 5: a2d31939 ($7.45 in chips)
Seat 6: 5b1dc166 ($5.8 in chips)
a2d31939: posts small blind $0.02
5b1dc166: posts big blind $0.05
*** HOLE CARDS ***
Dealt to Hero [3c 3s]
Dealt to 1d0da3a7 
Dealt to 4a9a77f4 
Dealt to 713370ec 
Dealt to a2d31939 
Dealt to 5b1dc166 
Hero: raises $0.07 to $0.12
1d0da3a7: folds
4a9a77f4: calls $0.12
713370ec: folds
a2d31939: folds
5b1dc166: folds
*** FLOP *** [Kc Tc Jh]
Hero: checks
4a9a77f4: bets $0.11
Hero: folds
Uncalled bet ($0.11) returned to 4a9a77f4
*** SHOWDOWN ***
4a9a77f4 collected $0.3 from pot
*** SUMMARY ***
Total pot $0.31 | Rake $0.01 | Jackpot $0 | Bingo $0 | Fortune $0
Board [Kc Tc Jh]
Seat 1: Hero folded on the Flop
Seat 2: 1d0da3a7 folded before Flop (didn't bet)
Seat 3: 4a9a77f4 won ($0.3)
Seat 4: 713370ec (button) folded before Flop (didn't bet)
Seat 5: a2d31939 (small blind) folded before Flop
Seat 6: 5b1dc166 (big blind) folded before Flop


Poker Hand #HD1144564972: Hold'em No Limit  ($0.02/$0.05) - 2023/03/03 19:48:59
Table 'NLHBlue116' 6-max Seat #3 is the button
Seat 1: Hero ($5 in chips)
Seat 2: 1d0da3a7 ($6.94 in chips)
Seat 3: 4a9a77f4 ($3.4 in chips)
Seat 4: 713370ec ($9.62 in chips)
Seat 5: a2d31939 ($7.31 in chips)
Seat 6: 5b1dc166 ($5.8 in chips)
713370ec: posts small blind $0.02
a2d31939: posts big blind $0.05
*** HOLE CARDS ***
Dealt to Hero [Tc 9s]
Dealt to 1d0da3a7 
Dealt to 4a9a77f4 
Dealt to 713370ec 
Dealt to a2d31939 
Dealt to 5b1dc166 
5b1dc166: folds
Hero: folds
1d0da3a7: raises $0.08 to $0.13
4a9a77f4: folds
713370ec: folds
a2d31939: calls $0.08
*** FLOP *** [8c Kd 4s]
a2d31939: checks
1d0da3a7: checks
*** TURN *** [8c Kd 4s] [2h]
a2d31939: bets $0.1
1d0da3a7: folds
Uncalled bet ($0.1) returned to a2d31939
*** SHOWDOWN ***
a2d31939 collected $0.27 from pot
*** SUMMARY ***
Total pot $0.28 | Rake $0.01 | Jackpot $0 | Bingo $0 | Fortune $0
Board [8c Kd 4s 2h]
Seat 1: Hero folded before Flop (didn't bet)
Seat 2: 1d0da3a7 folded on the Turn
Seat 3: 4a9a77f4 (button) folded before Flop (didn't bet)
Seat 4: 713370ec (small blind) folded before Flop
Seat 5: a2d31939 (big blind) won ($0.27)
Seat 6: 5b1dc166 folded before Flop (didn't bet)


Poker Hand #HD1144564854: Hold'em No Limit  ($0.02/$0.05) - 2023/03/03 19:48:20
Table 'NLHBlue116' 6-max Seat #2 is the button
Seat 1: Hero ($5 in chips)
Seat 2: 1d0da3a7 ($6.94 in chips)
Seat 3: 4a9a77f4 ($2.7 in chips)
Seat 4: 713370ec ($9.67 in chips)
Seat 5: a2d31939 ($7.31 in chips)
Seat 6: 5b1dc166 ($5.8 in chips)
4a9a77f4: posts small blind $0.02
713370ec: posts big blind $0.05
*** HOLE CARDS ***
Dealt to Hero [9s Js]
Dealt to 1d0da3a7 
Dealt to 4a9a77f4 
Dealt to 713370ec 
Dealt to a2d31939 
Dealt to 5b1dc166 
a2d31939: folds
5b1dc166: folds
Hero: raises $0.07 to $0.12
1d0da3a7: folds
4a9a77f4: calls $0.1
713370ec: folds
*** FLOP *** [Kd 8c Qc]
4a9a77f4: bets $0.22
Hero: raises $0.38 to $0.6
4a9a77f4: calls $0.38
*** TURN *** [Kd 8c Qc] [2d]
4a9a77f4: bets $0.75
Hero: folds
Uncalled bet ($0.75) returned to 4a9a77f4
*** SHOWDOWN ***
4a9a77f4 collected $1.42 from pot
*** SUMMARY ***
Total pot $1.49 | Rake $0.07 | Jackpot $0 | Bingo $0 | Fortune $0
Board [Kd 8c Qc 2d]
Seat 1: Hero folded on the Turn
Seat 2: 1d0da3a7 (button) folded before Flop (didn't bet)
Seat 3: 4a9a77f4 (small blind) won ($1.42)
Seat 4: 713370ec (big blind) folded before Flop
Seat 5: a2d31939 folded before Flop (didn't bet)
Seat 6: 5b1dc166 folded before Flop (didn't bet)


Poker Hand #HD1144564818: Hold'em No Limit  ($0.02/$0.05) - 2023/03/03 19:48:06
Table 'NLHBlue116' 6-max Seat #1 is the button
Seat 1: Hero ($5 in chips)
Seat 2: 1d0da3a7 ($6.89 in chips)
Seat 3: 4a9a77f4 ($2.75 in chips)
Seat 4: 713370ec ($9.67 in chips)
Seat 5: a2d31939 ($7.31 in chips)
Seat 6: 5b1dc166 ($5.8 in chips)
1d0da3a7: posts small blind $0.02
4a9a77f4: posts big blind $0.05
*** HOLE CARDS ***
Dealt to Hero [Kd 9c]
Dealt to 1d0da3a7 
Dealt to 4a9a77f4 
Dealt to 713370ec 
Dealt to a2d31939 
Dealt to 5b1dc166 
713370ec: folds
a2d31939: folds
5b1dc166: folds
Hero: folds
1d0da3a7: raises $0.08 to $0.13
4a9a77f4: folds
Uncalled bet ($0.08) returned to 1d0da3a7
*** SHOWDOWN ***
1d0da3a7 collected $0.1 from pot
*** SUMMARY ***
Total pot $0.1 | Rake $0 | Jackpot $0 | Bingo $0 | Fortune $0
Seat 1: Hero (button) folded before Flop (didn't bet)
Seat 2: 1d0da3a7 (small blind) collected ($0.1)
Seat 3: 4a9a77f4 (big blind) folded before Flop
Seat 4: 713370ec folded before Flop (didn't bet)
Seat 5: a2d31939 folded before Flop (didn't bet)
Seat 6: 5b1dc166 folded before Flop (didn't bet)


Poker Hand #HD1144564720: Hold'em No Limit  ($0.02/$0.05) - 2023/03/03 19:47:32
Table 'NLHBlue116' 6-max Seat #6 is the button
Seat 1: Hero ($5 in chips)
Seat 2: 1d0da3a7 ($7.23 in chips)
Seat 3: 4a9a77f4 ($2.75 in chips)
Seat 4: 713370ec ($9.67 in chips)
Seat 5: a2d31939 ($7.31 in chips)
Seat 6: 5b1dc166 ($5.47 in chips)
Hero: posts small blind $0.02
1d0da3a7: posts big blind $0.05
*** HOLE CARDS ***
Dealt to Hero [Ah 5d]
Dealt to 1d0da3a7 
Dealt to 4a9a77f4 
Dealt to 713370ec 
Dealt to a2d31939 
Dealt to 5b1dc166 
4a9a77f4: folds
713370ec: folds
a2d31939: folds
5b1dc166: raises $0.08 to $0.13
Hero: folds
1d0da3a7: calls $0.08
*** FLOP *** [Th 6h 8s]
1d0da3a7: checks
5b1dc166: bets $0.21
1d0da3a7: calls $0.21
*** TURN *** [Th 6h 8s] [3c]
1d0da3a7: checks
5b1dc166: bets $0.53
1d0da3a7: folds
Uncalled bet ($0.53) returned to 5b1dc166
*** SHOWDOWN ***
5b1dc166 collected $0.67 from pot
*** SUMMARY ***
Total pot $0.7 | Rake $0.03 | Jackpot $0 | Bingo $0 | Fortune $0
Board [Th 6h 8s 3c]
Seat 1: Hero (small blind) folded before Flop
Seat 2: 1d0da3a7 (big blind) folded on the Turn
Seat 3: 4a9a77f4 folded before Flop (didn't bet)
Seat 4: 713370ec folded before Flop (didn't bet)
Seat 5: a2d31939 folded before Flop (didn't bet)
Seat 6: 5b1dc166 (button) won ($0.67)


Poker Hand #HD1144564517: Hold'em No Limit  ($0.02/$0.05) - 2023/03/03 19:46:23
Table 'NLHBlue116' 6-max Seat #5 is the button
Seat 1: Hero ($5.3 in chips)
Seat 2: 1d0da3a7 ($7.23 in chips)
Seat 3: 4a9a77f4 ($0.95 in chips)
Seat 4: 713370ec ($9.67 in chips)
Seat 5: a2d31939 ($7.31 in chips)
Seat 6: 5b1dc166 ($5.67 in chips)
5b1dc166: posts small blind $0.02
Hero: posts big blind $0.05
*** HOLE CARDS ***
Dealt to Hero [Jh Kd]
Dealt to 1d0da3a7 
Dealt to 4a9a77f4 
Dealt to 713370ec 
Dealt to a2d31939 
Dealt to 5b1dc166 
1d0da3a7: folds
4a9a77f4: calls $0.05
713370ec: folds
a2d31939: folds
5b1dc166: calls $0.03
Hero: raises $0.15 to $0.2
4a9a77f4: calls $0.15
5b1dc166: calls $0.15
*** FLOP *** [3d 4d Qh]
5b1dc166: checks
Hero: bets $0.2
4a9a77f4: raises $0.55 to $0.75 and is all-in
5b1dc166: folds
Hero: calls $0.55
4a9a77f4: shows [3s 2s] (Pair of Treys)
Hero: shows [Jh Kd] (King-High)
4a9a77f4: Chooses to EV Cashout 
*** TURN *** [3d 4d Qh] [Kh]
4a9a77f4: Receives Cashout ($0.8)
*** RIVER *** [3d 4d Qh Kh] [2h]
*** SHOWDOWN ***
4a9a77f4 collected $1.95 from pot
*** SUMMARY ***
Total pot $2.1 | Rake $0.1 | Jackpot $0.05 | Bingo $0 | Fortune $0
Board [3d 4d Qh Kh 2h]
Seat 1: Hero (big blind) showed [Jh Kd] and lost with Pair of Kings
Seat 2: 1d0da3a7 folded before Flop (didn't bet)
Seat 3: 4a9a77f4 showed [3s 2s] and won ($1.95) with Pair of Treys and Pair of Twos, EV Cashout ($0)
Seat 4: 713370ec folded before Flop (didn't bet)
Seat 5: a2d31939 (button) folded before Flop (didn't bet)
Seat 6: 5b1dc166 (small blind) folded on the Flop


Poker Hand #HD1144564400: Hold'em No Limit  ($0.02/$0.05) - 2023/03/03 19:45:44
Table 'NLHBlue116' 6-max Seat #4 is the button
Seat 1: Hero ($5 in chips)
Seat 2: 1d0da3a7 ($7.23 in chips)
Seat 3: 4a9a77f4 ($1 in chips)
Seat 4: 713370ec ($9.87 in chips)
Seat 5: a2d31939 ($7.33 in chips)
Seat 6: 5b1dc166 ($5.72 in chips)
a2d31939: posts small blind $0.02
5b1dc166: posts big blind $0.05
4a9a77f4: posts big blind $0.05
*** HOLE CARDS ***
Dealt to Hero [Ad Kh]
Dealt to 1d0da3a7 
Dealt to 4a9a77f4 
Dealt to 713370ec 
Dealt to a2d31939 
Dealt to 5b1dc166 
Hero: raises $0.15 to $0.2
1d0da3a7: folds
4a9a77f4: folds
713370ec: calls $0.2
a2d31939: folds
5b1dc166: folds
*** FLOP *** [9h Jd 9s]
Hero: bets $0.22
713370ec: folds
Uncalled bet ($0.22) returned to Hero
*** SHOWDOWN ***
Hero collected $0.5 from pot
*** SUMMARY ***
Total pot $0.52 | Rake $0.02 | Jackpot $0 | Bingo $0 | Fortune $0
Board [9h Jd 9s]
Seat 1: Hero won ($0.5)
Seat 2: 1d0da3a7 folded before Flop (didn't bet)
Seat 3: 4a9a77f4 folded before Flop
Seat 4: 713370ec (button) folded on the Flop
Seat 5: a2d31939 (small blind) folded before Flop
Seat 6: 5b1dc166 (big blind) folded before Flop


Poker Hand #HD1144564197: Hold'em No Limit  ($0.02/$0.05) - 2023/03/03 19:44:36
Table 'NLHBlue116' 6-max Seat #2 is the button
Seat 1: Hero ($5 in chips)
Seat 2: 1d0da3a7 ($7.23 in chips)
Seat 4: 713370ec ($9.89 in chips)
Seat 5: a2d31939 ($7.89 in chips)
Seat 6: 5b1dc166 ($5.19 in chips)
713370ec: posts small blind $0.02
a2d31939: posts big blind $0.05
*** HOLE CARDS ***
Dealt to Hero [Qs 6s]
Dealt to 1d0da3a7 
Dealt to 713370ec 
Dealt to a2d31939 
Dealt to 5b1dc166 
5b1dc166: raises $0.08 to $0.13
Hero: folds
1d0da3a7: folds
713370ec: folds
a2d31939: calls $0.08
*** FLOP *** [2s Qd 2c]
a2d31939: checks
5b1dc166: bets $0.2
a2d31939: calls $0.2
*** TURN *** [2s Qd 2c] [Ks]
a2d31939: checks
5b1dc166: checks
*** RIVER *** [2s Qd 2c Ks] [Kc]
a2d31939: bets $0.23
5b1dc166: calls $0.23
a2d31939: shows [3c 3d] (Pair of Kings and Pair of Treys)
5b1dc166: shows [7s 7h] (Pair of Kings and Pair of Sevens)
*** SHOWDOWN ***
5b1dc166 collected $1.09 from pot
*** SUMMARY ***
Total pot $1.14 | Rake $0.05 | Jackpot $0 | Bingo $0 | Fortune $0
Board [2s Qd 2c Ks Kc]
Seat 1: Hero folded before Flop (didn't bet)
Seat 2: 1d0da3a7 (button) folded before Flop (didn't bet)
Seat 4: 713370ec (small blind) folded before Flop
Seat 5: a2d31939 (big blind) showed [3c 3d] and lost with Pair of Kings and Pair of Treys
Seat 6: 5b1dc166 showed [7s 7h] and won ($1.09) with Pair of Kings and Pair of Sevens


Poker Hand #HD1144563884: Hold'em No Limit  ($0.02/$0.05) - 2023/03/03 19:42:46
Table 'NLHBlue116' 6-max Seat #1 is the button
Seat 1: Hero ($5 in chips)
Seat 2: 1d0da3a7 ($6.61 in chips)
Seat 4: 713370ec ($9.94 in chips)
Seat 5: a2d31939 ($8.52 in chips)
Seat 6: 5b1dc166 ($5.19 in chips)
1d0da3a7: posts small blind $0.02
713370ec: posts big blind $0.05
*** HOLE CARDS ***
Dealt to Hero [As 8d]
Dealt to 1d0da3a7 
Dealt to 713370ec 
Dealt to a2d31939 
Dealt to 5b1dc166 
a2d31939: raises $0.08 to $0.13
5b1dc166: folds
Hero: folds
1d0da3a7: calls $0.11
713370ec: folds
*** FLOP *** [4d 9c 6c]
1d0da3a7: checks
a2d31939: bets $0.11
1d0da3a7: raises $0.39 to $0.5
a2d31939: calls $0.39
*** TURN *** [4d 9c 6c] [3d]
1d0da3a7: checks
a2d31939: checks
*** RIVER *** [4d 9c 6c 3d] [Ah]
1d0da3a7: bets $1.1
a2d31939: folds
Uncalled bet ($1.1) returned to 1d0da3a7
*** SHOWDOWN ***
1d0da3a7 collected $1.25 from pot
*** SUMMARY ***
Total pot $1.31 | Rake $0.06 | Jackpot $0 | Bingo $0 | Fortune $0
Board [4d 9c 6c 3d Ah]
Seat 1: Hero (button) folded before Flop (didn't bet)
Seat 2: 1d0da3a7 (small blind) won ($1.25)
Seat 4: 713370ec (big blind) folded before Flop
Seat 5: a2d31939 folded on the River
Seat 6: 5b1dc166 folded before Flop (didn't bet)


Poker Hand #HD1144563675: Hold'em No Limit  ($0.02/$0.05) - 2023/03/03 19:41:38
Table 'NLHBlue116' 6-max Seat #6 is the button
Seat 1: Hero ($7.42 in chips)
Seat 2: 1d0da3a7 ($6.66 in chips)
Seat 3: 2c7184d7 ($5 in chips)
Seat 4: 713370ec ($9.94 in chips)
Seat 5: a2d31939 ($5.91 in chips)
Seat 6: 5b1dc166 ($5.19 in chips)
Hero: posts small blind $0.02
1d0da3a7: posts big blind $0.05
*** HOLE CARDS ***
Dealt to Hero [Js Jh]
Dealt to 1d0da3a7 
Dealt to 2c7184d7 
Dealt to 713370ec 
Dealt to a2d31939 
Dealt to 5b1dc166 
2c7184d7: folds
713370ec: folds
a2d31939: raises $0.08 to $0.13
5b1dc166: folds
Hero: raises $0.37 to $0.5
1d0da3a7: folds
a2d31939: raises $0.64 to $1.14
Hero: calls $0.64
*** FLOP *** [3s Tc 8s]
Hero: bets $1.75
a2d31939: raises $3.02 to $4.77 and is all-in
Hero: folds
Uncalled bet ($3.02) returned to a2d31939
*** SHOWDOWN ***
a2d31939 collected $5.5 from pot
*** SUMMARY ***
Total pot $5.83 | Rake $0.28 | Jackpot $0.05 | Bingo $0 | Fortune $0
Board [3s Tc 8s]
Seat 1: Hero (small blind) folded on the Flop
Seat 2: 1d0da3a7 (big blind) folded before Flop
Seat 3: 2c7184d7 folded before Flop (didn't bet)
Seat 4: 713370ec folded before Flop (didn't bet)
Seat 5: a2d31939 won ($5.5)
Seat 6: 5b1dc166 (button) folded before Flop (didn't bet)


Poker Hand #HD1144563535: Hold'em No Limit  ($0.02/$0.05) - 2023/03/03 19:40:52
Table 'NLHBlue116' 6-max Seat #5 is the button
Seat 1: Hero ($7.12 in chips)
Seat 2: 1d0da3a7 ($6.66 in chips)
Seat 3: 2c7184d7 ($4.58 in chips)
Seat 4: 713370ec ($10.25 in chips)
Seat 5: a2d31939 ($5.91 in chips)
Seat 6: 5b1dc166 ($5.21 in chips)
5b1dc166: posts small blind $0.02
Hero: posts big blind $0.05
*** HOLE CARDS ***
Dealt to Hero [5h 6h]
Dealt to 1d0da3a7 
Dealt to 2c7184d7 
Dealt to 713370ec 
Dealt to a2d31939 
Dealt to 5b1dc166 
1d0da3a7: folds
2c7184d7: folds
713370ec: raises $0.1 to $0.15
a2d31939: folds
5b1dc166: folds
Hero: calls $0.1
*** FLOP *** [3d 4c 7h]
Hero: checks
713370ec: bets $0.16
Hero: raises $0.64 to $0.8
713370ec: folds
Uncalled bet ($0.64) returned to Hero
*** SHOWDOWN ***
Hero collected $0.61 from pot
*** SUMMARY ***
Total pot $0.64 | Rake $0.03 | Jackpot $0 | Bingo $0 | Fortune $0
Board [3d 4c 7h]
Seat 1: Hero (big blind) won ($0.61)
Seat 2: 1d0da3a7 folded before Flop (didn't bet)
Seat 3: 2c7184d7 folded before Flop (didn't bet)
Seat 4: 713370ec folded on the Flop
Seat 5: a2d31939 (button) folded before Flop (didn't bet)
Seat 6: 5b1dc166 (small blind) folded before Flop


Poker Hand #HD1144563496: Hold'em No Limit  ($0.02/$0.05) - 2023/03/03 19:40:37
Table 'NLHBlue116' 6-max Seat #4 is the button
Seat 1: Hero ($7.12 in chips)
Seat 2: 1d0da3a7 ($6.66 in chips)
Seat 3: 2c7184d7 ($4.58 in chips)
Seat 4: 713370ec ($10.25 in chips)
Seat 5: a2d31939 ($5.93 in chips)
Seat 6: 5b1dc166 ($5.19 in chips)
a2d31939: posts small blind $0.02
5b1dc166: posts big blind $0.05
*** HOLE CARDS ***
Dealt to Hero [9h Qs]
Dealt to 1d0da3a7 
Dealt to 2c7184d7 
Dealt to 713370ec 
Dealt to a2d31939 
Dealt to 5b1dc166 
Hero: folds
1d0da3a7: folds
2c7184d7: folds
713370ec: folds
a2d31939: folds
Uncalled bet ($0.03) returned to 5b1dc166
*** SHOWDOWN ***
5b1dc166 collected $0.04 from pot
*** SUMMARY ***
Total pot $0.04 | Rake $0 | Jackpot $0 | Bingo $0 | Fortune $0
Seat 1: Hero folded before Flop (didn't bet)
Seat 2: 1d0da3a7 folded before Flop (didn't bet)
Seat 3: 2c7184d7 folded before Flop (didn't bet)
Seat 4: 713370ec (button) folded before Flop (didn't bet)
Seat 5: a2d31939 (small blind) folded before Flop
Seat 6: 5b1dc166 (big blind) collected ($0.04)


Poker Hand #HD1144563324: Hold'em No Limit  ($0.02/$0.05) - 2023/03/03 19:39:43
Table 'NLHBlue116' 6-max Seat #3 is the button
Seat 1: Hero ($7.12 in chips)
Seat 2: 1d0da3a7 ($6.66 in chips)
Seat 3: 2c7184d7 ($4.92 in chips)
Seat 4: 713370ec ($10.27 in chips)
Seat 5: a2d31939 ($5.6 in chips)
Seat 6: 5b1dc166 ($5.19 in chips)
713370ec: posts small blind $0.02
a2d31939: posts big blind $0.05
*** HOLE CARDS ***
Dealt to Hero [4s 5d]
Dealt to 1d0da3a7 
Dealt to 2c7184d7 
Dealt to 713370ec 
Dealt to a2d31939 
Dealt to 5b1dc166 
5b1dc166: folds
Hero: folds
1d0da3a7: folds
2c7184d7: raises $0.08 to $0.13
713370ec: folds
a2d31939: calls $0.08
*** FLOP *** [7s 8c 8s]
a2d31939: checks
2c7184d7: checks
*** TURN *** [7s 8c 8s] [6c]
a2d31939: checks
2c7184d7: bets $0.21
a2d31939: calls $0.21
*** RIVER *** [7s 8c 8s 6c] [2s]
a2d31939: checks
2c7184d7: checks
a2d31939: shows [6s Ks] (King High Flush)
2c7184d7: shows [9d As] (Pair of Eights)
*** SHOWDOWN ***
a2d31939 collected $0.67 from pot
*** SUMMARY ***
Total pot $0.7 | Rake $0.03 | Jackpot $0 | Bingo $0 | Fortune $0
Board [7s 8c 8s 6c 2s]
Seat 1: Hero folded before Flop (didn't bet)
Seat 2: 1d0da3a7 folded before Flop (didn't bet)
Seat 3: 2c7184d7 (button) showed [9d As] and lost with Pair of Eights
Seat 4: 713370ec (small blind) folded before Flop
Seat 5: a2d31939 (big blind) showed [6s Ks] and won ($0.67) with King High Flush
Seat 6: 5b1dc166 folded before Flop (didn't bet)


Poker Hand #HD1144563176: Hold'em No Limit  ($0.02/$0.05) - 2023/03/03 19:38:57
Table 'NLHBlue116' 6-max Seat #2 is the button
Seat 1: Hero ($7.12 in chips)
Seat 2: 1d0da3a7 ($6.66 in chips)
Seat 3: 2c7184d7 ($4.94 in chips)
Seat 4: 713370ec ($9.94 in chips)
Seat 5: a2d31939 ($5.6 in chips)
Seat 6: 5b1dc166 ($5.53 in chips)
2c7184d7: posts small blind $0.02
713370ec: posts big blind $0.05
*** HOLE CARDS ***
Dealt to Hero [3c 5h]
Dealt to 1d0da3a7 
Dealt to 2c7184d7 
Dealt to 713370ec 
Dealt to a2d31939 
Dealt to 5b1dc166 
a2d31939: folds
5b1dc166: raises $0.08 to $0.13
Hero: folds
1d0da3a7: folds
2c7184d7: folds
713370ec: calls $0.08
*** FLOP *** [8d 4h 9s]
713370ec: checks
5b1dc166: bets $0.21
713370ec: calls $0.21
*** TURN *** [8d 4h 9s] [9h]
713370ec: checks
5b1dc166: checks
*** RIVER *** [8d 4h 9s 9h] [3s]
713370ec: bets $0.35
5b1dc166: folds
Uncalled bet ($0.35) returned to 713370ec
*** SHOWDOWN ***
713370ec collected $0.67 from pot
*** SUMMARY ***
Total pot $0.7 | Rake $0.03 | Jackpot $0 | Bingo $0 | Fortune $0
Board [8d 4h 9s 9h 3s]
Seat 1: Hero folded before Flop (didn't bet)
Seat 2: 1d0da3a7 (button) folded before Flop (didn't bet)
Seat 3: 2c7184d7 (small blind) folded before Flop
Seat 4: 713370ec (big blind) won ($0.67)
Seat 5: a2d31939 folded before Flop (didn't bet)
Seat 6: 5b1dc166 folded on the River


Poker Hand #HD1144562980: Hold'em No Limit  ($0.02/$0.05) - 2023/03/03 19:37:58
Table 'NLHBlue116' 6-max Seat #1 is the button
Seat 1: Hero ($7.12 in chips)
Seat 2: 1d0da3a7 ($6.68 in chips)
Seat 3: 2c7184d7 ($4.99 in chips)
Seat 4: 713370ec ($9.94 in chips)
Seat 5: a2d31939 ($6.06 in chips)
Seat 6: 5b1dc166 ($5.05 in chips)
1d0da3a7: posts small blind $0.02
2c7184d7: posts big blind $0.05
*** HOLE CARDS ***
Dealt to Hero [Jh 9h]
Dealt to 1d0da3a7 
Dealt to 2c7184d7 
Dealt to 713370ec 
Dealt to a2d31939 
Dealt to 5b1dc166 
713370ec: folds
a2d31939: raises $0.08 to $0.13
5b1dc166: raises $0.33 to $0.46
Hero: folds
1d0da3a7: folds
2c7184d7: folds
a2d31939: calls $0.33
*** FLOP *** [5c 3d Ad]
a2d31939: checks
5b1dc166: bets $0.75
a2d31939: folds
Uncalled bet ($0.75) returned to 5b1dc166
*** SHOWDOWN ***
5b1dc166 collected $0.94 from pot
*** SUMMARY ***
Total pot $0.99 | Rake $0.05 | Jackpot $0 | Bingo $0 | Fortune $0
Board [5c 3d Ad]
Seat 1: Hero (button) folded before Flop (didn't bet)
Seat 2: 1d0da3a7 (small blind) folded before Flop
Seat 3: 2c7184d7 (big blind) folded before Flop
Seat 4: 713370ec folded before Flop (didn't bet)
Seat 5: a2d31939 folded on the Flop
Seat 6: 5b1dc166 won ($0.94)


Poker Hand #HD1144562956: Hold'em No Limit  ($0.02/$0.05) - 2023/03/03 19:37:51
Table 'NLHBlue116' 6-max Seat #6 is the button
Seat 1: Hero ($7.14 in chips)
Seat 2: 1d0da3a7 ($6.66 in chips)
Seat 3: 2c7184d7 ($4.99 in chips)
Seat 4: 713370ec ($9.94 in chips)
Seat 5: a2d31939 ($6.06 in chips)
Seat 6: 5b1dc166 ($5.05 in chips)
Hero: posts small blind $0.02
1d0da3a7: posts big blind $0.05
*** HOLE CARDS ***
Dealt to Hero [5s 9s]
Dealt to 1d0da3a7 
Dealt to 2c7184d7 
Dealt to 713370ec 
Dealt to a2d31939 
Dealt to 5b1dc166 
2c7184d7: folds
713370ec: folds
a2d31939: folds
5b1dc166: folds
Hero: folds
Uncalled bet ($0.03) returned to 1d0da3a7
*** SHOWDOWN ***
1d0da3a7 collected $0.04 from pot
*** SUMMARY ***
Total pot $0.04 | Rake $0 | Jackpot $0 | Bingo $0 | Fortune $0
Seat 1: Hero (small blind) folded before Flop
Seat 2: 1d0da3a7 (big blind) collected ($0.04)
Seat 3: 2c7184d7 folded before Flop (didn't bet)
Seat 4: 713370ec folded before Flop (didn't bet)
Seat 5: a2d31939 folded before Flop (didn't bet)
Seat 6: 5b1dc166 (button) folded before Flop (didn't bet)


Poker Hand #HD1144562903: Hold'em No Limit  ($0.02/$0.05) - 2023/03/03 19:37:30
Table 'NLHBlue116' 6-max Seat #5 is the button
Seat 1: Hero ($7.19 in chips)
Seat 2: 1d0da3a7 ($6.66 in chips)
Seat 3: 2c7184d7 ($4.99 in chips)
Seat 4: 713370ec ($9.94 in chips)
Seat 5: a2d31939 ($6.06 in chips)
Seat 6: 5b1dc166 ($5 in chips)
5b1dc166: posts small blind $0.02
Hero: posts big blind $0.05
*** HOLE CARDS ***
Dealt to Hero [7s 4c]
Dealt to 1d0da3a7 
Dealt to 2c7184d7 
Dealt to 713370ec 
Dealt to a2d31939 
Dealt to 5b1dc166 
1d0da3a7: folds
2c7184d7: folds
713370ec: folds
a2d31939: folds
5b1dc166: raises $0.08 to $0.13
Hero: folds
Uncalled bet ($0.08) returned to 5b1dc166
*** SHOWDOWN ***
5b1dc166 collected $0.1 from pot
*** SUMMARY ***
Total pot $0.1 | Rake $0 | Jackpot $0 | Bingo $0 | Fortune $0
Seat 1: Hero (big blind) folded before Flop
Seat 2: 1d0da3a7 folded before Flop (didn't bet)
Seat 3: 2c7184d7 folded before Flop (didn't bet)
Seat 4: 713370ec folded before Flop (didn't bet)
Seat 5: a2d31939 (button) folded before Flop (didn't bet)
Seat 6: 5b1dc166 (small blind) collected ($0.1)


Poker Hand #HD1144562819: Hold'em No Limit  ($0.02/$0.05) - 2023/03/03 19:37:04
Table 'NLHBlue116' 6-max Seat #4 is the button
Seat 1: Hero ($7.01 in chips)
Seat 2: 1d0da3a7 ($6.66 in chips)
Seat 3: 2c7184d7 ($5.11 in chips)
Seat 4: 713370ec ($9.94 in chips)
Seat 5: a2d31939 ($6.08 in chips)
Seat 6: 5b1dc166 ($5 in chips)
a2d31939: posts small blind $0.02
5b1dc166: posts big blind $0.05
*** HOLE CARDS ***
Dealt to Hero [Ac 3c]
Dealt to 1d0da3a7 
Dealt to 2c7184d7 
Dealt to 713370ec 
Dealt to a2d31939 
Dealt to 5b1dc166 
Hero: raises $0.07 to $0.12
1d0da3a7: folds
2c7184d7: calls $0.12
713370ec: folds
a2d31939: folds
5b1dc166: folds
*** FLOP *** [5d 8d 4s]
Hero: bets $0.16
2c7184d7: folds
Uncalled bet ($0.16) returned to Hero
*** SHOWDOWN ***
Hero collected $0.3 from pot
*** SUMMARY ***
Total pot $0.31 | Rake $0.01 | Jackpot $0 | Bingo $0 | Fortune $0
Board [5d 8d 4s]
Seat 1: Hero won ($0.3)
Seat 2: 1d0da3a7 folded before Flop (didn't bet)
Seat 3: 2c7184d7 folded on the Flop
Seat 4: 713370ec (button) folded before Flop (didn't bet)
Seat 5: a2d31939 (small blind) folded before Flop
Seat 6: 5b1dc166 (big blind) folded before Flop


Poker Hand #HD1144562769: Hold'em No Limit  ($0.02/$0.05) - 2023/03/03 19:36:45
Table 'NLHBlue116' 6-max Seat #3 is the button
Seat 1: Hero ($7.01 in chips)
Seat 2: 1d0da3a7 ($6.66 in chips)
Seat 3: 2c7184d7 ($5.11 in chips)
Seat 4: 713370ec ($9.96 in chips)
Seat 5: a2d31939 ($6.06 in chips)
Seat 6: 5b1dc166 ($5 in chips)
713370ec: posts small blind $0.02
a2d31939: posts big blind $0.05
*** HOLE CARDS ***
Dealt to Hero [9s 4c]
Dealt to 1d0da3a7 
Dealt to 2c7184d7 
Dealt to 713370ec 
Dealt to a2d31939 
Dealt to 5b1dc166 
5b1dc166: folds
Hero: folds
1d0da3a7: folds
2c7184d7: folds
713370ec: folds
Uncalled bet ($0.03) returned to a2d31939
*** SHOWDOWN ***
a2d31939 collected $0.04 from pot
*** SUMMARY ***
Total pot $0.04 | Rake $0 | Jackpot $0 | Bingo $0 | Fortune $0
Seat 1: Hero folded before Flop (didn't bet)
Seat 2: 1d0da3a7 folded before Flop (didn't bet)
Seat 3: 2c7184d7 (button) folded before Flop (didn't bet)
Seat 4: 713370ec (small blind) folded before Flop
Seat 5: a2d31939 (big blind) collected ($0.04)
Seat 6: 5b1dc166 folded before Flop (didn't bet)


Poker Hand #HD1144562620: Hold'em No Limit  ($0.02/$0.05) - 2023/03/03 19:36:00
Table 'NLHBlue116' 6-max Seat #2 is the button
Seat 1: Hero ($7.01 in chips)
Seat 2: 1d0da3a7 ($6.66 in chips)
Seat 3: 2c7184d7 ($5.13 in chips)
Seat 4: 713370ec ($9.96 in chips)
Seat 5: a2d31939 ($6.06 in chips)
Seat 6: 5b1dc166 ($5 in chips)
2c7184d7: posts small blind $0.02
713370ec: posts big blind $0.05
*** HOLE CARDS ***
Dealt to Hero [9s Js]
Dealt to 1d0da3a7 
Dealt to 2c7184d7 
Dealt to 713370ec 
Dealt to a2d31939 
Dealt to 5b1dc166 
a2d31939: folds
5b1dc166: folds
Hero: raises $0.07 to $0.12
1d0da3a7: folds
2c7184d7: folds
713370ec: calls $0.07
*** FLOP *** [3d Ks 8c]
713370ec: checks
Hero: checks
*** TURN *** [3d Ks 8c] [Jh]
713370ec: bets $0.13
Hero: calls $0.13
*** RIVER *** [3d Ks 8c Jh] [3s]
713370ec: checks
Hero: checks
713370ec: shows [Jd Qs] (Pair of Jacks and Pair of Treys)
Hero: shows [9s Js] (Pair of Jacks and Pair of Treys)
*** SHOWDOWN ***
713370ec collected $0.25 from pot
Hero collected $0.25 from pot
*** SUMMARY ***
Total pot $0.52 | Rake $0.02 | Jackpot $0 | Bingo $0 | Fortune $0
Board [3d Ks 8c Jh 3s]
Seat 1: Hero showed [9s Js] and won ($0.25) with Pair of Jacks and Pair of Treys
Seat 2: 1d0da3a7 (button) folded before Flop (didn't bet)
Seat 3: 2c7184d7 (small blind) folded before Flop
Seat 4: 713370ec (big blind) showed [Jd Qs] and won ($0.25) with Pair of Jacks and Pair of Treys
Seat 5: a2d31939 folded before Flop (didn't bet)
Seat 6: 5b1dc166 folded before Flop (didn't bet)


Poker Hand #HD1144562550: Hold'em No Limit  ($0.02/$0.05) - 2023/03/03 19:35:33
Table 'NLHBlue116' 6-max Seat #1 is the button
Seat 1: Hero ($7.13 in chips)
Seat 2: 1d0da3a7 ($6.68 in chips)
Seat 3: 2c7184d7 ($5 in chips)
Seat 4: 713370ec ($9.96 in chips)
Seat 5: a2d31939 ($6.06 in chips)
Seat 6: 5b1dc166 ($5 in chips)
1d0da3a7: posts small blind $0.02
2c7184d7: posts big blind $0.05
*** HOLE CARDS ***
Dealt to Hero [Kc Jh]
Dealt to 1d0da3a7 
Dealt to 2c7184d7 
Dealt to 713370ec 
Dealt to a2d31939 
Dealt to 5b1dc166 
713370ec: folds
a2d31939: folds
5b1dc166: folds
Hero: raises $0.07 to $0.12
1d0da3a7: folds
2c7184d7: raises $0.26 to $0.38
Hero: folds
Uncalled bet ($0.26) returned to 2c7184d7
*** SHOWDOWN ***
2c7184d7 collected $0.25 from pot
*** SUMMARY ***
Total pot $0.26 | Rake $0.01 | Jackpot $0 | Bingo $0 | Fortune $0
Seat 1: Hero (button) folded before Flop
Seat 2: 1d0da3a7 (small blind) folded before Flop
Seat 3: 2c7184d7 (big blind) collected ($0.25)
Seat 4: 713370ec folded before Flop (didn't bet)
Seat 5: a2d31939 folded before Flop (didn't bet)
Seat 6: 5b1dc166 folded before Flop (didn't bet)


Poker Hand #HD1144562426: Hold'em No Limit  ($0.02/$0.05) - 2023/03/03 19:34:53
Table 'NLHBlue116' 6-max Seat #6 is the button
Seat 1: Hero ($7.27 in chips)
Seat 2: 1d0da3a7 ($6.55 in chips)
Seat 3: 2c7184d7 ($5 in chips)
Seat 4: 713370ec ($9.96 in chips)
Seat 5: a2d31939 ($6.06 in chips)
Seat 6: 5b1dc166 ($5 in chips)
Hero: posts small blind $0.02
1d0da3a7: posts big blind $0.05
*** HOLE CARDS ***
Dealt to Hero [Jd Kh]
Dealt to 1d0da3a7 
Dealt to 2c7184d7 
Dealt to 713370ec 
Dealt to a2d31939 
Dealt to 5b1dc166 
2c7184d7: folds
713370ec: folds
a2d31939: folds
5b1dc166: folds
Hero: raises $0.09 to $0.14
1d0da3a7: calls $0.09
*** FLOP *** [7s 3s 8d]
Hero: checks
1d0da3a7: checks
*** TURN *** [7s 3s 8d] [9c]
Hero: checks
1d0da3a7: bets $0.21
Hero: folds
Uncalled bet ($0.21) returned to 1d0da3a7
*** SHOWDOWN ***
1d0da3a7 collected $0.27 from pot
*** SUMMARY ***
Total pot $0.28 | Rake $0.01 | Jackpot $0 | Bingo $0 | Fortune $0
Board [7s 3s 8d 9c]
Seat 1: Hero (small blind) folded on the Turn
Seat 2: 1d0da3a7 (big blind) won ($0.27)
Seat 3: 2c7184d7 folded before Flop (didn't bet)
Seat 4: 713370ec folded before Flop (didn't bet)
Seat 5: a2d31939 folded before Flop (didn't bet)
Seat 6: 5b1dc166 (button) folded before Flop (didn't bet)


Poker Hand #HD1144562266: Hold'em No Limit  ($0.02/$0.05) - 2023/03/03 19:33:55
Table 'NLHBlue116' 6-max Seat #5 is the button
Seat 1: Hero ($7.32 in chips)
Seat 2: 1d0da3a7 ($6.55 in chips)
Seat 3: 2c7184d7 ($3.49 in chips)
Seat 4: 713370ec ($9.96 in chips)
Seat 5: a2d31939 ($6.66 in chips)
Seat 6: 5b1dc166 ($5 in chips)
5b1dc166: posts small blind $0.02
Hero: posts big blind $0.05
*** HOLE CARDS ***
Dealt to Hero [6d 3s]
Dealt to 1d0da3a7 
Dealt to 2c7184d7 
Dealt to 713370ec 
Dealt to a2d31939 
Dealt to 5b1dc166 
1d0da3a7: folds
2c7184d7: raises $0.1 to $0.15
713370ec: folds
a2d31939: calls $0.15
5b1dc166: folds
Hero: folds
*** FLOP *** [Kc 9d 9s]
2c7184d7: bets $0.13
a2d31939: calls $0.13
*** TURN *** [Kc 9d 9s] [Ah]
2c7184d7: checks
a2d31939: bets $0.32
2c7184d7: calls $0.32
*** RIVER *** [Kc 9d 9s Ah] [Js]
2c7184d7: checks
a2d31939: checks
2c7184d7: shows [Qc Kd] (Pair of Kings and Pair of Nines)
a2d31939: shows [5s 5d] (Pair of Nines and Pair of Fives)
*** SHOWDOWN ***
2c7184d7 collected $1.2 from pot
*** SUMMARY ***
Total pot $1.27 | Rake $0.07 | Jackpot $0 | Bingo $0 | Fortune $0
Board [Kc 9d 9s Ah Js]
Seat 1: Hero (big blind) folded before Flop
Seat 2: 1d0da3a7 folded before Flop (didn't bet)
Seat 3: 2c7184d7 showed [Qc Kd] and won ($1.2) with Pair of Kings and Pair of Nines
Seat 4: 713370ec folded before Flop (didn't bet)
Seat 5: a2d31939 (button) showed [5s 5d] and lost with Pair of Nines and Pair of Fives
Seat 6: 5b1dc166 (small blind) folded before Flop


Poker Hand #HD1144561998: Hold'em No Limit  ($0.02/$0.05) - 2023/03/03 19:32:25
Table 'NLHBlue116' 6-max Seat #4 is the button
Seat 1: Hero ($7.32 in chips)
Seat 2: 1d0da3a7 ($5 in chips)
Seat 3: 2c7184d7 ($5.07 in chips)
Seat 4: 713370ec ($9.96 in chips)
Seat 5: a2d31939 ($6.79 in chips)
Seat 6: 5b1dc166 ($5.05 in chips)
a2d31939: posts small blind $0.02
5b1dc166: posts big blind $0.05
*** HOLE CARDS ***
Dealt to Hero [Qc 4h]
Dealt to 1d0da3a7 
Dealt to 2c7184d7 
Dealt to 713370ec 
Dealt to a2d31939 
Dealt to 5b1dc166 
Hero: folds
1d0da3a7: raises $0.08 to $0.13
2c7184d7: calls $0.13
713370ec: folds
a2d31939: calls $0.11
5b1dc166: folds
*** FLOP *** [9h Ac Ts]
a2d31939: checks
1d0da3a7: bets $0.25
2c7184d7: calls $0.25
a2d31939: folds
*** TURN *** [9h Ac Ts] [As]
1d0da3a7: bets $0.6
2c7184d7: raises $0.6 to $1.2
1d0da3a7: raises $3.42 to $4.62 and is all-in
2c7184d7: folds
Uncalled bet ($3.42) returned to 1d0da3a7
*** SHOWDOWN ***
1d0da3a7 collected $3.13 from pot
*** SUMMARY ***
Total pot $3.34 | Rake $0.16 | Jackpot $0.05 | Bingo $0 | Fortune $0
Board [9h Ac Ts As]
Seat 1: Hero folded before Flop (didn't bet)
Seat 2: 1d0da3a7 won ($3.13)
Seat 3: 2c7184d7 folded on the Turn
Seat 4: 713370ec (button) folded before Flop (didn't bet)
Seat 5: a2d31939 (small blind) folded on the Flop
Seat 6: 5b1dc166 (big blind) folded before Flop


Poker Hand #HD1144561968: Hold'em No Limit  ($0.02/$0.05) - 2023/03/03 19:32:13
Table 'NLHBlue116' 6-max Seat #3 is the button
Seat 1: Hero ($7.25 in chips)
Seat 2: 1d0da3a7 ($5 in chips)
Seat 3: 2c7184d7 ($5.07 in chips)
Seat 4: 713370ec ($9.98 in chips)
Seat 5: a2d31939 ($6.84 in chips)
Seat 6: 5b1dc166 ($5.05 in chips)
713370ec: posts small blind $0.02
a2d31939: posts big blind $0.05
*** HOLE CARDS ***
Dealt to Hero [Jd Jh]
Dealt to 1d0da3a7 
Dealt to 2c7184d7 
Dealt to 713370ec 
Dealt to a2d31939 
Dealt to 5b1dc166 
5b1dc166: folds
Hero: raises $0.07 to $0.12
1d0da3a7: folds
2c7184d7: folds
713370ec: folds
a2d31939: folds
Uncalled bet ($0.07) returned to Hero
*** SHOWDOWN ***
Hero collected $0.12 from pot
*** SUMMARY ***
Total pot $0.12 | Rake $0 | Jackpot $0 | Bingo $0 | Fortune $0
Seat 1: Hero collected ($0.12)
Seat 2: 1d0da3a7 folded before Flop (didn't bet)
Seat 3: 2c7184d7 (button) folded before Flop (didn't bet)
Seat 4: 713370ec (small blind) folded before Flop
Seat 5: a2d31939 (big blind) folded before Flop
Seat 6: 5b1dc166 folded before Flop (didn't bet)


Poker Hand #HD1144561939: Hold'em No Limit  ($0.02/$0.05) - 2023/03/03 19:32:01
Table 'NLHBlue116' 6-max Seat #2 is the button
Seat 1: Hero ($7.18 in chips)
Seat 2: 1d0da3a7 ($5 in chips)
Seat 3: 2c7184d7 ($5.09 in chips)
Seat 4: 713370ec ($10.03 in chips)
Seat 5: a2d31939 ($6.84 in chips)
Seat 6: 5b1dc166 ($5.05 in chips)
2c7184d7: posts small blind $0.02
713370ec: posts big blind $0.05
*** HOLE CARDS ***
Dealt to Hero [8h Ac]
Dealt to 1d0da3a7 
Dealt to 2c7184d7 
Dealt to 713370ec 
Dealt to a2d31939 
Dealt to 5b1dc166 
a2d31939: folds
5b1dc166: folds
Hero: raises $0.07 to $0.12
1d0da3a7: folds
2c7184d7: folds
713370ec: folds
Uncalled bet ($0.07) returned to Hero
*** SHOWDOWN ***
Hero collected $0.12 from pot
*** SUMMARY ***
Total pot $0.12 | Rake $0 | Jackpot $0 | Bingo $0 | Fortune $0
Seat 1: Hero collected ($0.12)
Seat 2: 1d0da3a7 (button) folded before Flop (didn't bet)
Seat 3: 2c7184d7 (small blind) folded before Flop
Seat 4: 713370ec (big blind) folded before Flop
Seat 5: a2d31939 folded before Flop (didn't bet)
Seat 6: 5b1dc166 folded before Flop (didn't bet)


Poker Hand #HD1144561906: Hold'em No Limit  ($0.02/$0.05) - 2023/03/03 19:31:50
Table 'NLHBlue116' 6-max Seat #1 is the button
Seat 1: Hero ($7.18 in chips)
Seat 2: 1d0da3a7 ($5.02 in chips)
Seat 3: 2c7184d7 ($5.07 in chips)
Seat 4: 713370ec ($10.03 in chips)
Seat 5: a2d31939 ($6.84 in chips)
Seat 6: 5b1dc166 ($5.05 in chips)
1d0da3a7: posts small blind $0.02
2c7184d7: posts big blind $0.05
*** HOLE CARDS ***
Dealt to Hero [5d 4s]
Dealt to 1d0da3a7 
Dealt to 2c7184d7 
Dealt to 713370ec 
Dealt to a2d31939 
Dealt to 5b1dc166 
713370ec: folds
a2d31939: folds
5b1dc166: folds
Hero: folds
1d0da3a7: folds
Uncalled bet ($0.03) returned to 2c7184d7
*** SHOWDOWN ***
2c7184d7 collected $0.04 from pot
*** SUMMARY ***
Total pot $0.04 | Rake $0 | Jackpot $0 | Bingo $0 | Fortune $0
Seat 1: Hero (button) folded before Flop (didn't bet)
Seat 2: 1d0da3a7 (small blind) folded before Flop
Seat 3: 2c7184d7 (big blind) collected ($0.04)
Seat 4: 713370ec folded before Flop (didn't bet)
Seat 5: a2d31939 folded before Flop (didn't bet)
Seat 6: 5b1dc166 folded before Flop (didn't bet)


Poker Hand #HD1144561875: Hold'em No Limit  ($0.02/$0.05) - 2023/03/03 19:31:40
Table 'NLHBlue116' 6-max Seat #6 is the button
Seat 1: Hero ($7.2 in chips)
Seat 2: 1d0da3a7 ($5.07 in chips)
Seat 3: 2c7184d7 ($5 in chips)
Seat 4: 713370ec ($10.03 in chips)
Seat 5: a2d31939 ($6.84 in chips)
Seat 6: 5b1dc166 ($5.05 in chips)
Hero: posts small blind $0.02
1d0da3a7: posts big blind $0.05
*** HOLE CARDS ***
Dealt to Hero [5s 4d]
Dealt to 1d0da3a7 
Dealt to 2c7184d7 
Dealt to 713370ec 
Dealt to a2d31939 
Dealt to 5b1dc166 
2c7184d7: raises $0.1 to $0.15
713370ec: folds
a2d31939: folds
5b1dc166: folds
Hero: folds
1d0da3a7: folds
Uncalled bet ($0.1) returned to 2c7184d7
*** SHOWDOWN ***
2c7184d7 collected $0.12 from pot
*** SUMMARY ***
Total pot $0.12 | Rake $0 | Jackpot $0 | Bingo $0 | Fortune $0
Seat 1: Hero (small blind) folded before Flop
Seat 2: 1d0da3a7 (big blind) folded before Flop
Seat 3: 2c7184d7 collected ($0.12)
Seat 4: 713370ec folded before Flop (didn't bet)
Seat 5: a2d31939 folded before Flop (didn't bet)
Seat 6: 5b1dc166 (button) folded before Flop (didn't bet)


Poker Hand #HD1144561821: Hold'em No Limit  ($0.02/$0.05) - 2023/03/03 19:31:22
Table 'NLHBlue116' 6-max Seat #5 is the button
Seat 1: Hero ($7.25 in chips)
Seat 2: 1d0da3a7 ($5 in chips)
Seat 3: 2c7184d7 ($5 in chips)
Seat 4: 713370ec ($10.03 in chips)
Seat 5: a2d31939 ($6.84 in chips)
Seat 6: 5b1dc166 ($5.07 in chips)
5b1dc166: posts small blind $0.02
Hero: posts big blind $0.05
*** HOLE CARDS ***
Dealt to Hero [Tc 7d]
Dealt to 1d0da3a7 
Dealt to 2c7184d7 
Dealt to 713370ec 
Dealt to a2d31939 
Dealt to 5b1dc166 
1d0da3a7: raises $0.08 to $0.13
2c7184d7: folds
713370ec: folds
a2d31939: folds
5b1dc166: folds
Hero: folds
Uncalled bet ($0.08) returned to 1d0da3a7
*** SHOWDOWN ***
1d0da3a7 collected $0.12 from pot
*** SUMMARY ***
Total pot $0.12 | Rake $0 | Jackpot $0 | Bingo $0 | Fortune $0
Seat 1: Hero (big blind) folded before Flop
Seat 2: 1d0da3a7 collected ($0.12)
Seat 3: 2c7184d7 folded before Flop (didn't bet)
Seat 4: 713370ec folded before Flop (didn't bet)
Seat 5: a2d31939 (button) folded before Flop (didn't bet)
Seat 6: 5b1dc166 (small blind) folded before Flop


Poker Hand #HD1144561790: Hold'em No Limit  ($0.02/$0.05) - 2023/03/03 19:31:10
Table 'NLHBlue116' 6-max Seat #4 is the button
Seat 1: Hero ($7.25 in chips)
Seat 2: 1d0da3a7 ($5 in chips)
Seat 3: 2c7184d7 ($4.93 in chips)
Seat 4: 713370ec ($9.96 in chips)
Seat 5: a2d31939 ($6.86 in chips)
Seat 6: 5b1dc166 ($5.12 in chips)
a2d31939: posts small blind $0.02
5b1dc166: posts big blind $0.05
*** HOLE CARDS ***
Dealt to Hero [9c 2d]
Dealt to 1d0da3a7 
Dealt to 2c7184d7 
Dealt to 713370ec 
Dealt to a2d31939 
Dealt to 5b1dc166 
Hero: folds
1d0da3a7: folds
2c7184d7: folds
713370ec: raises $0.1 to $0.15
a2d31939: folds
5b1dc166: folds
Uncalled bet ($0.1) returned to 713370ec
*** SHOWDOWN ***
713370ec collected $0.12 from pot
*** SUMMARY ***
Total pot $0.12 | Rake $0 | Jackpot $0 | Bingo $0 | Fortune $0
Seat 1: Hero folded before Flop (didn't bet)
Seat 2: 1d0da3a7 folded before Flop (didn't bet)
Seat 3: 2c7184d7 folded before Flop (didn't bet)
Seat 4: 713370ec (button) collected ($0.12)
Seat 5: a2d31939 (small blind) folded before Flop
Seat 6: 5b1dc166 (big blind) folded before Flop


Poker Hand #HD1144561619: Hold'em No Limit  ($0.02/$0.05) - 2023/03/03 19:30:10
Table 'NLHBlue116' 6-max Seat #3 is the button
Seat 1: Hero ($5.2 in chips)
Seat 2: 1d0da3a7 ($5 in chips)
Seat 3: 2c7184d7 ($4.93 in chips)
Seat 4: 713370ec ($9.98 in chips)
Seat 5: a2d31939 ($7.25 in chips)
Seat 6: 5b1dc166 ($5.12 in chips)
713370ec: posts small blind $0.02
a2d31939: posts big blind $0.05
*** HOLE CARDS ***
Dealt to Hero [Th Ah]
Dealt to 1d0da3a7 
Dealt to 2c7184d7 
Dealt to 713370ec 
Dealt to a2d31939 
Dealt to 5b1dc166 
5b1dc166: folds
Hero: raises $0.07 to $0.12
1d0da3a7: raises $0.27 to $0.39
2c7184d7: folds
713370ec: folds
a2d31939: calls $0.34
Hero: calls $0.27
*** FLOP *** [7s As Jc]
a2d31939: checks
Hero: checks
1d0da3a7: bets $0.4
a2d31939: folds
Hero: calls $0.4
*** TURN *** [7s As Jc] [Kh]
Hero: checks
1d0da3a7: bets $1.1
Hero: calls $1.1
*** RIVER *** [7s As Jc Kh] [Qs]
Hero: checks
1d0da3a7: checks
Hero: shows [Th Ah] (Aces-High Straight)
1d0da3a7: shows [Jd Jh] (Three Jacks)
*** SHOWDOWN ***
Hero collected $3.94 from pot
*** SUMMARY ***
Total pot $4.19 | Rake $0.2 | Jackpot $0.05 | Bingo $0 | Fortune $0
Board [7s As Jc Kh Qs]
Seat 1: Hero showed [Th Ah] and won ($3.94) with Aces-High Straight
Seat 2: 1d0da3a7 showed [Jd Jh] and lost with Three Jacks
Seat 3: 2c7184d7 (button) folded before Flop (didn't bet)
Seat 4: 713370ec (small blind) folded before Flop
Seat 5: a2d31939 (big blind) folded on the Flop
Seat 6: 5b1dc166 folded before Flop (didn't bet)


Poker Hand #HD1144561477: Hold'em No Limit  ($0.02/$0.05) - 2023/03/03 19:29:20
Table 'NLHBlue116' 6-max Seat #2 is the button
Seat 1: Hero ($5.2 in chips)
Seat 2: 1d0da3a7 ($5 in chips)
Seat 3: 2c7184d7 ($4.95 in chips)
Seat 4: 713370ec ($9.39 in chips)
Seat 5: a2d31939 ($7.88 in chips)
Seat 6: 5b1dc166 ($5.12 in chips)
2c7184d7: posts small blind $0.02
713370ec: posts big blind $0.05
*** HOLE CARDS ***
Dealt to Hero [8s Kd]
Dealt to 1d0da3a7 
Dealt to 2c7184d7 
Dealt to 713370ec 
Dealt to a2d31939 
Dealt to 5b1dc166 
a2d31939: raises $0.08 to $0.13
5b1dc166: folds
Hero: folds
1d0da3a7: folds
2c7184d7: folds
713370ec: calls $0.08
*** FLOP *** [5s 4h 3c]
713370ec: checks
a2d31939: checks
*** TURN *** [5s 4h 3c] [9h]
713370ec: bets $0.18
a2d31939: calls $0.18
*** RIVER *** [5s 4h 3c 9h] [Ah]
713370ec: checks
a2d31939: bets $0.32
713370ec: calls $0.32
a2d31939: shows [6d 6h] (Pair of Sixes)
713370ec: shows [Ad Qc] (Pair of Aces)
*** SHOWDOWN ***
713370ec collected $1.22 from pot
*** SUMMARY ***
Total pot $1.28 | Rake $0.06 | Jackpot $0 | Bingo $0 | Fortune $0
Board [5s 4h 3c 9h Ah]
Seat 1: Hero folded before Flop (didn't bet)
Seat 2: 1d0da3a7 (button) folded before Flop (didn't bet)
Seat 3: 2c7184d7 (small blind) folded before Flop
Seat 4: 713370ec (big blind) showed [Ad Qc] and won ($1.22) with Pair of Aces
Seat 5: a2d31939 showed [6d 6h] and lost with Pair of Sixes
Seat 6: 5b1dc166 folded before Flop (didn't bet)


Poker Hand #HD1144561442: Hold'em No Limit  ($0.02/$0.05) - 2023/03/03 19:29:08
Table 'NLHBlue116' 6-max Seat #1 is the button
Seat 1: Hero ($5.13 in chips)
Seat 2: 1d0da3a7 ($5.02 in chips)
Seat 3: 2c7184d7 ($5 in chips)
Seat 4: 713370ec ($9.39 in chips)
Seat 5: a2d31939 ($7.88 in chips)
Seat 6: 5b1dc166 ($5.12 in chips)
1d0da3a7: posts small blind $0.02
2c7184d7: posts big blind $0.05
*** HOLE CARDS ***
Dealt to Hero [8h Jh]
Dealt to 1d0da3a7 
Dealt to 2c7184d7 
Dealt to 713370ec 
Dealt to a2d31939 
Dealt to 5b1dc166 
713370ec: folds
a2d31939: folds
5b1dc166: folds
Hero: raises $0.07 to $0.12
1d0da3a7: folds
2c7184d7: folds
Uncalled bet ($0.07) returned to Hero
*** SHOWDOWN ***
Hero collected $0.12 from pot
*** SUMMARY ***
Total pot $0.12 | Rake $0 | Jackpot $0 | Bingo $0 | Fortune $0
Seat 1: Hero (button) collected ($0.12)
Seat 2: 1d0da3a7 (small blind) folded before Flop
Seat 3: 2c7184d7 (big blind) folded before Flop
Seat 4: 713370ec folded before Flop (didn't bet)
Seat 5: a2d31939 folded before Flop (didn't bet)
Seat 6: 5b1dc166 folded before Flop (didn't bet)


Poker Hand #HD1144561396: Hold'em No Limit  ($0.02/$0.05) - 2023/03/03 19:28:53
Table 'NLHBlue116' 6-max Seat #6 is the button
Seat 1: Hero ($5.15 in chips)
Seat 2: 1d0da3a7 ($5.07 in chips)
Seat 4: 713370ec ($9.39 in chips)
Seat 5: a2d31939 ($7.81 in chips)
Seat 6: 5b1dc166 ($5.12 in chips)
Hero: posts small blind $0.02
1d0da3a7: posts big blind $0.05
*** HOLE CARDS ***
Dealt to Hero [4s Jc]
Dealt to 1d0da3a7 
Dealt to 713370ec 
Dealt to a2d31939 
Dealt to 5b1dc166 
713370ec: folds
a2d31939: raises $0.08 to $0.13
5b1dc166: folds
Hero: folds
1d0da3a7: folds
Uncalled bet ($0.08) returned to a2d31939
*** SHOWDOWN ***
a2d31939 collected $0.12 from pot
*** SUMMARY ***
Total pot $0.12 | Rake $0 | Jackpot $0 | Bingo $0 | Fortune $0
Seat 1: Hero (small blind) folded before Flop
Seat 2: 1d0da3a7 (big blind) folded before Flop
Seat 4: 713370ec folded before Flop (didn't bet)
Seat 5: a2d31939 collected ($0.12)
Seat 6: 5b1dc166 (button) folded before Flop (didn't bet)


Poker Hand #HD1144561339: Hold'em No Limit  ($0.02/$0.05) - 2023/03/03 19:28:34
Table 'NLHBlue116' 6-max Seat #5 is the button
Seat 1: Hero ($5.2 in chips)
Seat 2: 1d0da3a7 ($5 in chips)
Seat 4: 713370ec ($9.39 in chips)
Seat 5: a2d31939 ($7.81 in chips)
Seat 6: 5b1dc166 ($5.14 in chips)
5b1dc166: posts small blind $0.02
Hero: posts big blind $0.05
*** HOLE CARDS ***
Dealt to Hero [Kd 9c]
Dealt to 1d0da3a7 
Dealt to 713370ec 
Dealt to a2d31939 
Dealt to 5b1dc166 
1d0da3a7: raises $0.08 to $0.13
713370ec: folds
a2d31939: folds
5b1dc166: folds
Hero: folds
Uncalled bet ($0.08) returned to 1d0da3a7
*** SHOWDOWN ***
1d0da3a7 collected $0.12 from pot
*** SUMMARY ***
Total pot $0.12 | Rake $0 | Jackpot $0 | Bingo $0 | Fortune $0
Seat 1: Hero (big blind) folded before Flop
Seat 2: 1d0da3a7 collected ($0.12)
Seat 4: 713370ec folded before Flop (didn't bet)
Seat 5: a2d31939 (button) folded before Flop (didn't bet)
Seat 6: 5b1dc166 (small blind) folded before Flop


Poker Hand #HD1144561239: Hold'em No Limit  ($0.02/$0.05) - 2023/03/03 19:27:58
Table 'NLHBlue116' 6-max Seat #4 is the button
Seat 1: Hero ($5.2 in chips)
Seat 2: 1d0da3a7 ($5 in chips)
Seat 3: b30c8b60 ($6.38 in chips)
Seat 4: 713370ec ($9.39 in chips)
Seat 5: a2d31939 ($7.64 in chips)
Seat 6: 5b1dc166 ($5.19 in chips)
a2d31939: posts small blind $0.02
5b1dc166: posts big blind $0.05
*** HOLE CARDS ***
Dealt to Hero [6c Jd]
Dealt to 1d0da3a7 
Dealt to b30c8b60 
Dealt to 713370ec 
Dealt to a2d31939 
Dealt to 5b1dc166 
Hero: folds
1d0da3a7: raises $0.08 to $0.13
b30c8b60: folds
713370ec: folds
a2d31939: raises $0.39 to $0.52
5b1dc166: folds
1d0da3a7: folds
Uncalled bet ($0.39) returned to a2d31939
*** SHOWDOWN ***
a2d31939 collected $0.3 from pot
*** SUMMARY ***
Total pot $0.31 | Rake $0.01 | Jackpot $0 | Bingo $0 | Fortune $0
Seat 1: Hero folded before Flop (didn't bet)
Seat 2: 1d0da3a7 folded before Flop
Seat 3: b30c8b60 folded before Flop (didn't bet)
Seat 4: 713370ec (button) folded before Flop (didn't bet)
Seat 5: a2d31939 (small blind) collected ($0.3)
Seat 6: 5b1dc166 (big blind) folded before Flop


Poker Hand #HD1144561168: Hold'em No Limit  ($0.02/$0.05) - 2023/03/03 19:27:30
Table 'NLHBlue116' 6-max Seat #3 is the button
Seat 1: Hero ($5.07 in chips)
Seat 2: 1d0da3a7 ($5 in chips)
Seat 3: b30c8b60 ($6.38 in chips)
Seat 4: 713370ec ($9.41 in chips)
Seat 5: a2d31939 ($7.76 in chips)
Seat 6: 5b1dc166 ($5.19 in chips)
713370ec: posts small blind $0.02
a2d31939: posts big blind $0.05
*** HOLE CARDS ***
Dealt to Hero [Ah 6h]
Dealt to 1d0da3a7 
Dealt to b30c8b60 
Dealt to 713370ec 
Dealt to a2d31939 
Dealt to 5b1dc166 
5b1dc166: folds
Hero: raises $0.07 to $0.12
1d0da3a7: folds
b30c8b60: folds
713370ec: folds
a2d31939: calls $0.07
*** FLOP *** [5h Qc 9h]
a2d31939: checks
Hero: bets $0.13
a2d31939: folds
Uncalled bet ($0.13) returned to Hero
*** SHOWDOWN ***
Hero collected $0.25 from pot
*** SUMMARY ***
Total pot $0.26 | Rake $0.01 | Jackpot $0 | Bingo $0 | Fortune $0
Board [5h Qc 9h]
Seat 1: Hero won ($0.25)
Seat 2: 1d0da3a7 folded before Flop (didn't bet)
Seat 3: b30c8b60 (button) folded before Flop (didn't bet)
Seat 4: 713370ec (small blind) folded before Flop
Seat 5: a2d31939 (big blind) folded on the Flop
Seat 6: 5b1dc166 folded before Flop (didn't bet)


Poker Hand #HD1144561129: Hold'em No Limit  ($0.02/$0.05) - 2023/03/03 19:27:19
Table 'NLHBlue116' 6-max Seat #2 is the button
Seat 1: Hero ($5.07 in chips)
Seat 2: 1d0da3a7 ($5 in chips)
Seat 3: b30c8b60 ($6.4 in chips)
Seat 4: 713370ec ($9.39 in chips)
Seat 5: a2d31939 ($7.76 in chips)
Seat 6: 5b1dc166 ($5.19 in chips)
b30c8b60: posts small blind $0.02
713370ec: posts big blind $0.05
*** HOLE CARDS ***
Dealt to Hero [8d Kc]
Dealt to 1d0da3a7 
Dealt to b30c8b60 
Dealt to 713370ec 
Dealt to a2d31939 
Dealt to 5b1dc166 
a2d31939: folds
5b1dc166: folds
Hero: folds
1d0da3a7: folds
b30c8b60: folds
Uncalled bet ($0.03) returned to 713370ec
*** SHOWDOWN ***
713370ec collected $0.04 from pot
*** SUMMARY ***
Total pot $0.04 | Rake $0 | Jackpot $0 | Bingo $0 | Fortune $0
Seat 1: Hero folded before Flop (didn't bet)
Seat 2: 1d0da3a7 (button) folded before Flop (didn't bet)
Seat 3: b30c8b60 (small blind) folded before Flop
Seat 4: 713370ec (big blind) collected ($0.04)
Seat 5: a2d31939 folded before Flop (didn't bet)
Seat 6: 5b1dc166 folded before Flop (didn't bet)


Poker Hand #HD1144561011: Hold'em No Limit  ($0.02/$0.05) - 2023/03/03 19:26:37
Table 'NLHBlue116' 6-max Seat #1 is the button
Seat 1: Hero ($5 in chips)
Seat 2: 1d0da3a7 ($5 in chips)
Seat 3: b30c8b60 ($6.45 in chips)
Seat 4: 713370ec ($9.39 in chips)
Seat 5: a2d31939 ($7.76 in chips)
Seat 6: 5b1dc166 ($5.19 in chips)
1d0da3a7: posts small blind $0.02
b30c8b60: posts big blind $0.05
*** HOLE CARDS ***
Dealt to Hero [7s 8s]
Dealt to 1d0da3a7 
Dealt to b30c8b60 
Dealt to 713370ec 
Dealt to a2d31939 
Dealt to 5b1dc166 
713370ec: folds
a2d31939: folds
5b1dc166: folds
Hero: raises $0.07 to $0.12
1d0da3a7: folds
b30c8b60: folds
Uncalled bet ($0.07) returned to Hero
*** SHOWDOWN ***
Hero collected $0.12 from pot
*** SUMMARY ***
Total pot $0.12 | Rake $0 | Jackpot $0 | Bingo $0 | Fortune $0
Seat 1: Hero (button) collected ($0.12)
Seat 2: 1d0da3a7 (small blind) folded before Flop
Seat 3: b30c8b60 (big blind) folded before Flop
Seat 4: 713370ec folded before Flop (didn't bet)
Seat 5: a2d31939 folded before Flop (didn't bet)
Seat 6: 5b1dc166 folded before Flop (didn't bet)


Poker Hand #HD1144560885: Hold'em No Limit  ($0.02/$0.05) - 2023/03/03 19:25:54
Table 'NLHBlue116' 6-max Seat #6 is the button
Seat 1: Hero ($5 in chips)
Seat 2: 1d0da3a7 ($5 in chips)
Seat 3: b30c8b60 ($6.58 in chips)
Seat 4: 713370ec ($9.39 in chips)
Seat 5: a2d31939 ($7.57 in chips)
Seat 6: 5b1dc166 ($5.19 in chips)
Hero: posts small blind $0.02
1d0da3a7: posts big blind $0.05
*** HOLE CARDS ***
Dealt to Hero [Ac 5h]
Dealt to 1d0da3a7 
Dealt to b30c8b60 
Dealt to 713370ec 
Dealt to a2d31939 
Dealt to 5b1dc166 
b30c8b60: raises $0.08 to $0.13
713370ec: folds
a2d31939: raises $0.32 to $0.45
5b1dc166: folds
Hero: folds
1d0da3a7: folds
b30c8b60: folds
Uncalled bet ($0.32) returned to a2d31939
*** SHOWDOWN ***
a2d31939 collected $0.32 from pot
*** SUMMARY ***
Total pot $0.33 | Rake $0.01 | Jackpot $0 | Bingo $0 | Fortune $0
Seat 1: Hero (small blind) folded before Flop
Seat 2: 1d0da3a7 (big blind) folded before Flop
Seat 3: b30c8b60 folded before Flop
Seat 4: 713370ec folded before Flop (didn't bet)
Seat 5: a2d31939 collected ($0.32)
Seat 6: 5b1dc166 (button) folded before Flop (didn't bet)


Poker Hand #HD1144560838: Hold'em No Limit  ($0.02/$0.05) - 2023/03/03 19:25:36
Table 'NLHBlue116' 6-max Seat #5 is the button
Seat 1: Hero ($5 in chips)
Seat 2: 1d0da3a7 ($5 in chips)
Seat 3: b30c8b60 ($6.58 in chips)
Seat 4: 713370ec ($9.39 in chips)
Seat 5: a2d31939 ($7.5 in chips)
Seat 6: 5b1dc166 ($5.21 in chips)
5b1dc166: posts small blind $0.02
Hero: posts big blind $0.05
*** HOLE CARDS ***
Dealt to Hero [3c 8s]
Dealt to 1d0da3a7 
Dealt to b30c8b60 
Dealt to 713370ec 
Dealt to a2d31939 
Dealt to 5b1dc166 
1d0da3a7: folds
b30c8b60: folds
713370ec: folds
a2d31939: raises $0.07 to $0.12
5b1dc166: folds
Hero: folds
Uncalled bet ($0.07) returned to a2d31939
*** SHOWDOWN ***
a2d31939 collected $0.12 from pot
*** SUMMARY ***
Total pot $0.12 | Rake $0 | Jackpot $0 | Bingo $0 | Fortune $0
Seat 1: Hero (big blind) folded before Flop
Seat 2: 1d0da3a7 folded before Flop (didn't bet)
Seat 3: b30c8b60 folded before Flop (didn't bet)
Seat 4: 713370ec folded before Flop (didn't bet)
Seat 5: a2d31939 (button) collected ($0.12)
Seat 6: 5b1dc166 (small blind) folded before Flop


