Poker Hand #HD1199296850: Hold'em No Limit  ($0.02/$0.05) - 2023/04/11 21:48:07
Table 'NLHBlue32' 6-max Seat #3 is the button
Seat 1: 36ca22b6 ($2.96 in chips)
Seat 2: 2bf0da0a ($8.32 in chips)
Seat 3: ea1cc8c1 ($5 in chips)
Seat 4: c86f76e6 ($2.99 in chips)
Seat 5: a6bde6ad ($6.1 in chips)
Seat 6: Hero ($9 in chips)
c86f76e6: posts small blind $0.02
a6bde6ad: posts big blind $0.05
*** HOLE CARDS ***
Dealt to 36ca22b6 
Dealt to 2bf0da0a 
Dealt to ea1cc8c1 
Dealt to c86f76e6 
Dealt to a6bde6ad 
Dealt to Hero [3d Ah]
Hero: folds
36ca22b6: raises $0.08 to $0.13
2bf0da0a: folds
ea1cc8c1: folds
c86f76e6: folds
a6bde6ad: folds
Uncalled bet ($0.08) returned to 36ca22b6
*** SHOWDOWN ***
36ca22b6 collected $0.12 from pot
*** SUMMARY ***
Total pot $0.12 | Rake $0 | Jackpot $0 | Bingo $0 | Fortune $0
Seat 1: 36ca22b6 collected ($0.12)
Seat 2: 2bf0da0a folded before Flop (didn't bet)
Seat 3: ea1cc8c1 (button) folded before Flop (didn't bet)
Seat 4: c86f76e6 (small blind) folded before Flop
Seat 5: a6bde6ad (big blind) folded before Flop
Seat 6: Hero folded before Flop (didn't bet)


Poker Hand #HD1199296809: Hold'em No Limit  ($0.02/$0.05) - 2023/04/11 21:47:49
Table 'NLHBlue32' 6-max Seat #2 is the button
Seat 1: 36ca22b6 ($2.89 in chips)
Seat 2: 2bf0da0a ($8.32 in chips)
Seat 3: ea1cc8c1 ($5.02 in chips)
Seat 4: c86f76e6 ($3.04 in chips)
Seat 5: a6bde6ad ($6.1 in chips)
Seat 6: Hero ($9 in chips)
ea1cc8c1: posts small blind $0.02
c86f76e6: posts big blind $0.05
*** HOLE CARDS ***
Dealt to 36ca22b6 
Dealt to 2bf0da0a 
Dealt to ea1cc8c1 
Dealt to c86f76e6 
Dealt to a6bde6ad 
Dealt to Hero [3d Js]
a6bde6ad: folds
Hero: folds
36ca22b6: raises $0.08 to $0.13
2bf0da0a: folds
ea1cc8c1: folds
c86f76e6: folds
Uncalled bet ($0.08) returned to 36ca22b6
*** SHOWDOWN ***
36ca22b6 collected $0.12 from pot
*** SUMMARY ***
Total pot $0.12 | Rake $0 | Jackpot $0 | Bingo $0 | Fortune $0
Seat 1: 36ca22b6 collected ($0.12)
Seat 2: 2bf0da0a (button) folded before Flop (didn't bet)
Seat 3: ea1cc8c1 (small blind) folded before Flop
Seat 4: c86f76e6 (big blind) folded before Flop
Seat 5: a6bde6ad folded before Flop (didn't bet)
Seat 6: Hero folded before Flop (didn't bet)


Poker Hand #HD1199296753: Hold'em No Limit  ($0.02/$0.05) - 2023/04/11 21:47:21
Table 'NLHBlue32' 6-max Seat #1 is the button
Seat 1: 36ca22b6 ($2.89 in chips)
Seat 2: 2bf0da0a ($8.27 in chips)
Seat 3: ea1cc8c1 ($5.07 in chips)
Seat 4: c86f76e6 ($3.04 in chips)
Seat 5: a6bde6ad ($6.1 in chips)
Seat 6: Hero ($9 in chips)
2bf0da0a: posts small blind $0.02
ea1cc8c1: posts big blind $0.05
*** HOLE CARDS ***
Dealt to 36ca22b6 
Dealt to 2bf0da0a 
Dealt to ea1cc8c1 
Dealt to c86f76e6 
Dealt to a6bde6ad 
Dealt to Hero [7d 4c]
c86f76e6: folds
a6bde6ad: folds
Hero: folds
36ca22b6: folds
2bf0da0a: raises $0.1 to $0.15
ea1cc8c1: folds
Uncalled bet ($0.1) returned to 2bf0da0a
*** SHOWDOWN ***
2bf0da0a collected $0.1 from pot
*** SUMMARY ***
Total pot $0.1 | Rake $0 | Jackpot $0 | Bingo $0 | Fortune $0
Seat 1: 36ca22b6 (button) folded before Flop (didn't bet)
Seat 2: 2bf0da0a (small blind) collected ($0.1)
Seat 3: ea1cc8c1 (big blind) folded before Flop
Seat 4: c86f76e6 folded before Flop (didn't bet)
Seat 5: a6bde6ad folded before Flop (didn't bet)
Seat 6: Hero folded before Flop (didn't bet)


Poker Hand #HD1199296735: Hold'em No Limit  ($0.02/$0.05) - 2023/04/11 21:47:09
Table 'NLHBlue32' 6-max Seat #6 is the button
Seat 1: 36ca22b6 ($2.91 in chips)
Seat 2: 2bf0da0a ($8.32 in chips)
Seat 3: ea1cc8c1 ($5.07 in chips)
Seat 4: c86f76e6 ($2.97 in chips)
Seat 5: a6bde6ad ($6.1 in chips)
Seat 6: Hero ($9 in chips)
36ca22b6: posts small blind $0.02
2bf0da0a: posts big blind $0.05
*** HOLE CARDS ***
Dealt to 36ca22b6 
Dealt to 2bf0da0a 
Dealt to ea1cc8c1 
Dealt to c86f76e6 
Dealt to a6bde6ad 
Dealt to Hero [Td 9h]
ea1cc8c1: folds
c86f76e6: raises $0.09 to $0.14
a6bde6ad: folds
Hero: folds
36ca22b6: folds
2bf0da0a: folds
Uncalled bet ($0.09) returned to c86f76e6
*** SHOWDOWN ***
c86f76e6 collected $0.12 from pot
*** SUMMARY ***
Total pot $0.12 | Rake $0 | Jackpot $0 | Bingo $0 | Fortune $0
Seat 1: 36ca22b6 (small blind) folded before Flop
Seat 2: 2bf0da0a (big blind) folded before Flop
Seat 3: ea1cc8c1 folded before Flop (didn't bet)
Seat 4: c86f76e6 collected ($0.12)
Seat 5: a6bde6ad folded before Flop (didn't bet)
Seat 6: Hero (button) folded before Flop (didn't bet)


Poker Hand #HD1199296668: Hold'em No Limit  ($0.02/$0.05) - 2023/04/11 21:46:40
Table 'NLHBlue32' 6-max Seat #5 is the button
Seat 1: 36ca22b6 ($2.5 in chips)
Seat 2: 2bf0da0a ($8.32 in chips)
Seat 3: ea1cc8c1 ($5.07 in chips)
Seat 4: c86f76e6 ($2.97 in chips)
Seat 5: a6bde6ad ($6.1 in chips)
Seat 6: Hero ($9.45 in chips)
Hero: posts small blind $0.02
36ca22b6: posts big blind $0.05
*** HOLE CARDS ***
Dealt to 36ca22b6 
Dealt to 2bf0da0a 
Dealt to ea1cc8c1 
Dealt to c86f76e6 
Dealt to a6bde6ad 
Dealt to Hero [8h 8d]
2bf0da0a: folds
ea1cc8c1: folds
c86f76e6: folds
a6bde6ad: folds
Hero: raises $0.09 to $0.14
36ca22b6: raises $0.31 to $0.45
Hero: calls $0.31
*** FLOP *** [6d 7h Qh]
Hero: checks
36ca22b6: bets $0.48
Hero: folds
Uncalled bet ($0.48) returned to 36ca22b6
*** SHOWDOWN ***
36ca22b6 collected $0.86 from pot
*** SUMMARY ***
Total pot $0.9 | Rake $0.04 | Jackpot $0 | Bingo $0 | Fortune $0
Board [6d 7h Qh]
Seat 1: 36ca22b6 (big blind) won ($0.86)
Seat 2: 2bf0da0a folded before Flop (didn't bet)
Seat 3: ea1cc8c1 folded before Flop (didn't bet)
Seat 4: c86f76e6 folded before Flop (didn't bet)
Seat 5: a6bde6ad (button) folded before Flop (didn't bet)
Seat 6: Hero (small blind) folded on the Flop


Poker Hand #HD1199296624: Hold'em No Limit  ($0.02/$0.05) - 2023/04/11 21:46:19
Table 'NLHBlue32' 6-max Seat #4 is the button
Seat 1: cd001826 ($1.77 in chips)
Seat 2: 2bf0da0a ($8.32 in chips)
Seat 3: ea1cc8c1 ($5.07 in chips)
Seat 4: c86f76e6 ($2.97 in chips)
Seat 5: a6bde6ad ($6.12 in chips)
Seat 6: Hero ($9.43 in chips)
a6bde6ad: posts small blind $0.02
Hero: posts big blind $0.05
*** HOLE CARDS ***
Dealt to cd001826 
Dealt to 2bf0da0a 
Dealt to ea1cc8c1 
Dealt to c86f76e6 
Dealt to a6bde6ad 
Dealt to Hero [Tc 7s]
cd001826: folds
2bf0da0a: folds
ea1cc8c1: folds
c86f76e6: folds
a6bde6ad: folds
Uncalled bet ($0.03) returned to Hero
*** SHOWDOWN ***
Hero collected $0.04 from pot
*** SUMMARY ***
Total pot $0.04 | Rake $0 | Jackpot $0 | Bingo $0 | Fortune $0
Seat 1: cd001826 folded before Flop (didn't bet)
Seat 2: 2bf0da0a folded before Flop (didn't bet)
Seat 3: ea1cc8c1 folded before Flop (didn't bet)
Seat 4: c86f76e6 (button) folded before Flop (didn't bet)
Seat 5: a6bde6ad (small blind) folded before Flop
Seat 6: Hero (big blind) collected ($0.04)


Poker Hand #HD1199296582: Hold'em No Limit  ($0.02/$0.05) - 2023/04/11 21:45:55
Table 'NLHBlue32' 6-max Seat #3 is the button
Seat 1: cd001826 ($1.77 in chips)
Seat 2: 2bf0da0a ($8.32 in chips)
Seat 3: ea1cc8c1 ($5 in chips)
Seat 4: c86f76e6 ($2.99 in chips)
Seat 5: a6bde6ad ($6.17 in chips)
Seat 6: Hero ($9.43 in chips)
c86f76e6: posts small blind $0.02
a6bde6ad: posts big blind $0.05
*** HOLE CARDS ***
Dealt to cd001826 
Dealt to 2bf0da0a 
Dealt to ea1cc8c1 
Dealt to c86f76e6 
Dealt to a6bde6ad 
Dealt to Hero [7s 6s]
Hero: folds
cd001826: folds
2bf0da0a: folds
ea1cc8c1: raises $0.08 to $0.13
c86f76e6: folds
a6bde6ad: folds
Uncalled bet ($0.08) returned to ea1cc8c1
*** SHOWDOWN ***
ea1cc8c1 collected $0.12 from pot
*** SUMMARY ***
Total pot $0.12 | Rake $0 | Jackpot $0 | Bingo $0 | Fortune $0
Seat 1: cd001826 folded before Flop (didn't bet)
Seat 2: 2bf0da0a folded before Flop (didn't bet)
Seat 3: ea1cc8c1 (button) collected ($0.12)
Seat 4: c86f76e6 (small blind) folded before Flop
Seat 5: a6bde6ad (big blind) folded before Flop
Seat 6: Hero folded before Flop (didn't bet)


Poker Hand #HD1199296496: Hold'em No Limit  ($0.02/$0.05) - 2023/04/11 21:45:14
Table 'NLHBlue32' 6-max Seat #2 is the button
Seat 1: cd001826 ($2.01 in chips)
Seat 2: 2bf0da0a ($8.32 in chips)
Seat 3: ea1cc8c1 ($5 in chips)
Seat 4: c86f76e6 ($3.04 in chips)
Seat 5: a6bde6ad ($6.17 in chips)
Seat 6: Hero ($9.14 in chips)
ea1cc8c1: posts small blind $0.02
c86f76e6: posts big blind $0.05
*** HOLE CARDS ***
Dealt to cd001826 
Dealt to 2bf0da0a 
Dealt to ea1cc8c1 
Dealt to c86f76e6 
Dealt to a6bde6ad 
Dealt to Hero [5h Ah]
a6bde6ad: folds
Hero: raises $0.07 to $0.12
cd001826: calls $0.12
2bf0da0a: folds
ea1cc8c1: folds
c86f76e6: folds
*** FLOP *** [7c Ad Qh]
Hero: bets $0.12
cd001826: calls $0.12
*** TURN *** [7c Ad Qh] [Qc]
Hero: checks
cd001826: checks
*** RIVER *** [7c Ad Qh Qc] [Kc]
Hero: bets $0.2
cd001826: folds
Uncalled bet ($0.2) returned to Hero
*** SHOWDOWN ***
Hero collected $0.53 from pot
*** SUMMARY ***
Total pot $0.55 | Rake $0.02 | Jackpot $0 | Bingo $0 | Fortune $0
Board [7c Ad Qh Qc Kc]
Seat 1: cd001826 folded on the River
Seat 2: 2bf0da0a (button) folded before Flop (didn't bet)
Seat 3: ea1cc8c1 (small blind) folded before Flop
Seat 4: c86f76e6 (big blind) folded before Flop
Seat 5: a6bde6ad folded before Flop (didn't bet)
Seat 6: Hero won ($0.53)


Poker Hand #HD1199296453: Hold'em No Limit  ($0.02/$0.05) - 2023/04/11 21:44:53
Table 'NLHBlue32' 6-max Seat #1 is the button
Seat 1: cd001826 ($1.94 in chips)
Seat 2: 2bf0da0a ($8.34 in chips)
Seat 3: ea1cc8c1 ($5 in chips)
Seat 4: c86f76e6 ($3.04 in chips)
Seat 5: a6bde6ad ($6.17 in chips)
Seat 6: Hero ($9.14 in chips)
2bf0da0a: posts small blind $0.02
ea1cc8c1: posts big blind $0.05
*** HOLE CARDS ***
Dealt to cd001826 
Dealt to 2bf0da0a 
Dealt to ea1cc8c1 
Dealt to c86f76e6 
Dealt to a6bde6ad 
Dealt to Hero [4c 7s]
c86f76e6: folds
a6bde6ad: folds
Hero: folds
cd001826: raises $0.1 to $0.15
2bf0da0a: folds
ea1cc8c1: folds
Uncalled bet ($0.1) returned to cd001826
*** SHOWDOWN ***
cd001826 collected $0.12 from pot
*** SUMMARY ***
Total pot $0.12 | Rake $0 | Jackpot $0 | Bingo $0 | Fortune $0
Seat 1: cd001826 (button) collected ($0.12)
Seat 2: 2bf0da0a (small blind) folded before Flop
Seat 3: ea1cc8c1 (big blind) folded before Flop
Seat 4: c86f76e6 folded before Flop (didn't bet)
Seat 5: a6bde6ad folded before Flop (didn't bet)
Seat 6: Hero folded before Flop (didn't bet)


Poker Hand #HD1199296305: Hold'em No Limit  ($0.02/$0.05) - 2023/04/11 21:43:42
Table 'NLHBlue32' 6-max Seat #6 is the button
Seat 1: cd001826 ($3.54 in chips)
Seat 2: 2bf0da0a ($8.39 in chips)
Seat 3: ea1cc8c1 ($5 in chips)
Seat 4: c86f76e6 ($1.6 in chips)
Seat 5: a6bde6ad ($6.17 in chips)
Seat 6: Hero ($9.14 in chips)
cd001826: posts small blind $0.02
2bf0da0a: posts big blind $0.05
*** HOLE CARDS ***
Dealt to cd001826 
Dealt to 2bf0da0a 
Dealt to ea1cc8c1 
Dealt to c86f76e6 
Dealt to a6bde6ad 
Dealt to Hero [7c Tc]
ea1cc8c1: folds
c86f76e6: raises $0.09 to $0.14
a6bde6ad: folds
Hero: folds
cd001826: calls $0.12
2bf0da0a: folds
*** FLOP *** [4h 3s 2s]
cd001826: bets $3.4 and is all-in
c86f76e6: calls $1.46 and is all-in
Uncalled bet ($1.94) returned to cd001826
cd001826: shows [Kd As] (Ace-High)
c86f76e6: shows [8d 8s] (Pair of Eights)
*** FIRST TURN *** [4h 3s 2s] [Jd]
*** FIRST RIVER *** [4h 3s 2s Jd] [9h]
*** SECOND TURN *** [4h 3s 2s] [4s]
*** SECOND RIVER *** [4h 3s 2s 4s] [6h]
*** FIRST SHOWDOWN ***
c86f76e6 collected $1.52 from pot
*** SECOND SHOWDOWN ***
c86f76e6 collected $1.52 from pot
*** SUMMARY ***
Total pot $3.25 | Rake $0.16 | Jackpot $0.05 | Bingo $0 | Fortune $0
Hand was run two times
FIRST Board [4h 3s 2s Jd 9h]
SECOND Board [4s 6h]
Seat 1: cd001826 (small blind) showed [Kd As] and lost with Ace-High, and lost
Seat 2: 2bf0da0a (big blind) folded before Flop
Seat 3: ea1cc8c1 folded before Flop (didn't bet)
Seat 4: c86f76e6 showed [8d 8s] and won ($1.52) with Pair of Eights, and won ($1.52)
Seat 5: a6bde6ad folded before Flop (didn't bet)
Seat 6: Hero (button) folded before Flop (didn't bet)


Poker Hand #HD1199296222: Hold'em No Limit  ($0.02/$0.05) - 2023/04/11 21:43:03
Table 'NLHBlue32' 6-max Seat #5 is the button
Seat 1: cd001826 ($3 in chips)
Seat 2: 2bf0da0a ($8.39 in chips)
Seat 3: ea1cc8c1 ($5 in chips)
Seat 4: c86f76e6 ($1.6 in chips)
Seat 5: a6bde6ad ($6.17 in chips)
Seat 6: Hero ($9.74 in chips)
Hero: posts small blind $0.02
cd001826: posts big blind $0.05
*** HOLE CARDS ***
Dealt to cd001826 
Dealt to 2bf0da0a 
Dealt to ea1cc8c1 
Dealt to c86f76e6 
Dealt to a6bde6ad 
Dealt to Hero [9c Jc]
2bf0da0a: folds
ea1cc8c1: folds
c86f76e6: folds
a6bde6ad: folds
Hero: raises $0.09 to $0.14
cd001826: calls $0.09
*** FLOP *** [3d 4d Td]
Hero: checks
cd001826: checks
*** TURN *** [3d 4d Td] [4s]
Hero: bets $0.14
cd001826: calls $0.14
*** RIVER *** [3d 4d Td 4s] [Kc]
Hero: bets $0.32
cd001826: raises $0.9 to $1.22
Hero: folds
Uncalled bet ($0.9) returned to cd001826
*** SHOWDOWN ***
cd001826 collected $1.14 from pot
*** SUMMARY ***
Total pot $1.2 | Rake $0.06 | Jackpot $0 | Bingo $0 | Fortune $0
Board [3d 4d Td 4s Kc]
Seat 1: cd001826 (big blind) won ($1.14)
Seat 2: 2bf0da0a folded before Flop (didn't bet)
Seat 3: ea1cc8c1 folded before Flop (didn't bet)
Seat 4: c86f76e6 folded before Flop (didn't bet)
Seat 5: a6bde6ad (button) folded before Flop (didn't bet)
Seat 6: Hero (small blind) folded on the River


Poker Hand #HD1199296193: Hold'em No Limit  ($0.02/$0.05) - 2023/04/11 21:42:48
Table 'NLHBlue32' 6-max Seat #4 is the button
Seat 2: 2bf0da0a ($8.39 in chips)
Seat 3: ea1cc8c1 ($5 in chips)
Seat 4: c86f76e6 ($1.6 in chips)
Seat 5: a6bde6ad ($6.19 in chips)
Seat 6: Hero ($9.72 in chips)
a6bde6ad: posts small blind $0.02
Hero: posts big blind $0.05
*** HOLE CARDS ***
Dealt to 2bf0da0a 
Dealt to ea1cc8c1 
Dealt to c86f76e6 
Dealt to a6bde6ad 
Dealt to Hero [2s 7c]
2bf0da0a: folds
ea1cc8c1: folds
c86f76e6: folds
a6bde6ad: folds
Uncalled bet ($0.03) returned to Hero
*** SHOWDOWN ***
Hero collected $0.04 from pot
*** SUMMARY ***
Total pot $0.04 | Rake $0 | Jackpot $0 | Bingo $0 | Fortune $0
Seat 2: 2bf0da0a folded before Flop (didn't bet)
Seat 3: ea1cc8c1 folded before Flop (didn't bet)
Seat 4: c86f76e6 (button) folded before Flop (didn't bet)
Seat 5: a6bde6ad (small blind) folded before Flop
Seat 6: Hero (big blind) collected ($0.04)


Poker Hand #HD1199296172: Hold'em No Limit  ($0.02/$0.05) - 2023/04/11 21:42:37
Table 'NLHBlue32' 6-max Seat #3 is the button
Seat 2: 2bf0da0a ($8.39 in chips)
Seat 3: ea1cc8c1 ($5 in chips)
Seat 4: c86f76e6 ($1.62 in chips)
Seat 5: a6bde6ad ($6.17 in chips)
Seat 6: Hero ($9.72 in chips)
c86f76e6: posts small blind $0.02
a6bde6ad: posts big blind $0.05
*** HOLE CARDS ***
Dealt to 2bf0da0a 
Dealt to ea1cc8c1 
Dealt to c86f76e6 
Dealt to a6bde6ad 
Dealt to Hero [Tc 2c]
Hero: folds
2bf0da0a: folds
ea1cc8c1: folds
c86f76e6: folds
Uncalled bet ($0.03) returned to a6bde6ad
*** SHOWDOWN ***
a6bde6ad collected $0.04 from pot
*** SUMMARY ***
Total pot $0.04 | Rake $0 | Jackpot $0 | Bingo $0 | Fortune $0
Seat 2: 2bf0da0a folded before Flop (didn't bet)
Seat 3: ea1cc8c1 (button) folded before Flop (didn't bet)
Seat 4: c86f76e6 (small blind) folded before Flop
Seat 5: a6bde6ad (big blind) collected ($0.04)
Seat 6: Hero folded before Flop (didn't bet)


Poker Hand #HD1199296151: Hold'em No Limit  ($0.02/$0.05) - 2023/04/11 21:42:28
Table 'NLHBlue32' 6-max Seat #2 is the button
Seat 2: 2bf0da0a ($8.32 in chips)
Seat 3: ea1cc8c1 ($5 in chips)
Seat 4: c86f76e6 ($1.67 in chips)
Seat 5: a6bde6ad ($6.17 in chips)
Seat 6: Hero ($9.72 in chips)
ea1cc8c1: posts small blind $0.02
c86f76e6: posts big blind $0.05
*** HOLE CARDS ***
Dealt to 2bf0da0a 
Dealt to ea1cc8c1 
Dealt to c86f76e6 
Dealt to a6bde6ad 
Dealt to Hero [Td 7c]
a6bde6ad: folds
Hero: folds
2bf0da0a: raises $0.08 to $0.13
ea1cc8c1: folds
c86f76e6: folds
Uncalled bet ($0.08) returned to 2bf0da0a
*** SHOWDOWN ***
2bf0da0a collected $0.12 from pot
*** SUMMARY ***
Total pot $0.12 | Rake $0 | Jackpot $0 | Bingo $0 | Fortune $0
Seat 2: 2bf0da0a (button) collected ($0.12)
Seat 3: ea1cc8c1 (small blind) folded before Flop
Seat 4: c86f76e6 (big blind) folded before Flop
Seat 5: a6bde6ad folded before Flop (didn't bet)
Seat 6: Hero folded before Flop (didn't bet)


Poker Hand #HD1199296111: Hold'em No Limit  ($0.02/$0.05) - 2023/04/11 21:42:11
Table 'NLHBlue32' 6-max Seat #6 is the button
Seat 1: 786d72 ($5 in chips)
Seat 2: 2bf0da0a ($8.37 in chips)
Seat 3: ea1cc8c1 ($5 in chips)
Seat 4: c86f76e6 ($1.67 in chips)
Seat 5: a6bde6ad ($6.17 in chips)
Seat 6: Hero ($9.65 in chips)
786d72: posts small blind $0.02
2bf0da0a: posts big blind $0.05
*** HOLE CARDS ***
Dealt to 786d72 
Dealt to 2bf0da0a 
Dealt to ea1cc8c1 
Dealt to c86f76e6 
Dealt to a6bde6ad 
Dealt to Hero [Ah Kd]
ea1cc8c1: folds
c86f76e6: folds
a6bde6ad: folds
Hero: raises $0.07 to $0.12
786d72: folds
2bf0da0a: folds
Uncalled bet ($0.07) returned to Hero
*** SHOWDOWN ***
Hero collected $0.12 from pot
*** SUMMARY ***
Total pot $0.12 | Rake $0 | Jackpot $0 | Bingo $0 | Fortune $0
Seat 1: 786d72 (small blind) folded before Flop
Seat 2: 2bf0da0a (big blind) folded before Flop
Seat 3: ea1cc8c1 folded before Flop (didn't bet)
Seat 4: c86f76e6 folded before Flop (didn't bet)
Seat 5: a6bde6ad folded before Flop (didn't bet)
Seat 6: Hero (button) collected ($0.12)


Poker Hand #HD1199296055: Hold'em No Limit  ($0.02/$0.05) - 2023/04/11 21:41:45
Table 'NLHBlue32' 6-max Seat #5 is the button
Seat 1: 786d72 ($5.07 in chips)
Seat 2: 2bf0da0a ($8.23 in chips)
Seat 3: ea1cc8c1 ($5 in chips)
Seat 4: c86f76e6 ($1.67 in chips)
Seat 5: a6bde6ad ($6.17 in chips)
Seat 6: Hero ($9.67 in chips)
Hero: posts small blind $0.02
786d72: posts big blind $0.05
*** HOLE CARDS ***
Dealt to 786d72 
Dealt to 2bf0da0a 
Dealt to ea1cc8c1 
Dealt to c86f76e6 
Dealt to a6bde6ad 
Dealt to Hero [6d Ac]
2bf0da0a: raises $0.08 to $0.13
ea1cc8c1: folds
c86f76e6: folds
a6bde6ad: folds
Hero: folds
786d72: calls $0.08
*** FLOP *** [Ks 2c 7c]
786d72: checks
2bf0da0a: bets $0.18
786d72: folds
Uncalled bet ($0.18) returned to 2bf0da0a
*** SHOWDOWN ***
2bf0da0a collected $0.27 from pot
*** SUMMARY ***
Total pot $0.28 | Rake $0.01 | Jackpot $0 | Bingo $0 | Fortune $0
Board [Ks 2c 7c]
Seat 1: 786d72 (big blind) folded on the Flop
Seat 2: 2bf0da0a won ($0.27)
Seat 3: ea1cc8c1 folded before Flop (didn't bet)
Seat 4: c86f76e6 folded before Flop (didn't bet)
Seat 5: a6bde6ad (button) folded before Flop (didn't bet)
Seat 6: Hero (small blind) folded before Flop


Poker Hand #HD1199296035: Hold'em No Limit  ($0.02/$0.05) - 2023/04/11 21:41:34
Table 'NLHBlue32' 6-max Seat #4 is the button
Seat 1: 786d72 ($5.07 in chips)
Seat 2: 2bf0da0a ($8.23 in chips)
Seat 3: ea1cc8c1 ($5 in chips)
Seat 4: c86f76e6 ($1.67 in chips)
Seat 5: a6bde6ad ($6.19 in chips)
Seat 6: Hero ($9.65 in chips)
a6bde6ad: posts small blind $0.02
Hero: posts big blind $0.05
*** HOLE CARDS ***
Dealt to 786d72 
Dealt to 2bf0da0a 
Dealt to ea1cc8c1 
Dealt to c86f76e6 
Dealt to a6bde6ad 
Dealt to Hero [7c 3s]
786d72: folds
2bf0da0a: folds
ea1cc8c1: folds
c86f76e6: folds
a6bde6ad: folds
Uncalled bet ($0.03) returned to Hero
*** SHOWDOWN ***
Hero collected $0.04 from pot
*** SUMMARY ***
Total pot $0.04 | Rake $0 | Jackpot $0 | Bingo $0 | Fortune $0
Seat 1: 786d72 folded before Flop (didn't bet)
Seat 2: 2bf0da0a folded before Flop (didn't bet)
Seat 3: ea1cc8c1 folded before Flop (didn't bet)
Seat 4: c86f76e6 (button) folded before Flop (didn't bet)
Seat 5: a6bde6ad (small blind) folded before Flop
Seat 6: Hero (big blind) collected ($0.04)


Poker Hand #HD1199295992: Hold'em No Limit  ($0.02/$0.05) - 2023/04/11 21:41:16
Table 'NLHBlue32' 6-max Seat #3 is the button
Seat 1: 786d72 ($5.07 in chips)
Seat 2: 2bf0da0a ($8.23 in chips)
Seat 3: ea1cc8c1 ($5.12 in chips)
Seat 4: c86f76e6 ($1.69 in chips)
Seat 5: a6bde6ad ($6.05 in chips)
Seat 6: Hero ($9.65 in chips)
c86f76e6: posts small blind $0.02
a6bde6ad: posts big blind $0.05
*** HOLE CARDS ***
Dealt to 786d72 
Dealt to 2bf0da0a 
Dealt to ea1cc8c1 
Dealt to c86f76e6 
Dealt to a6bde6ad 
Dealt to Hero [Qc Jh]
Hero: folds
786d72: folds
2bf0da0a: folds
ea1cc8c1: raises $0.08 to $0.13
c86f76e6: folds
a6bde6ad: raises $0.28 to $0.41
ea1cc8c1: folds
Uncalled bet ($0.28) returned to a6bde6ad
*** SHOWDOWN ***
a6bde6ad collected $0.27 from pot
*** SUMMARY ***
Total pot $0.28 | Rake $0.01 | Jackpot $0 | Bingo $0 | Fortune $0
Seat 1: 786d72 folded before Flop (didn't bet)
Seat 2: 2bf0da0a folded before Flop (didn't bet)
Seat 3: ea1cc8c1 (button) folded before Flop
Seat 4: c86f76e6 (small blind) folded before Flop
Seat 5: a6bde6ad (big blind) collected ($0.27)
Seat 6: Hero folded before Flop (didn't bet)


Poker Hand #HD1199295969: Hold'em No Limit  ($0.02/$0.05) - 2023/04/11 21:41:00
Table 'NLHBlue32' 6-max Seat #2 is the button
Seat 1: 786d72 ($5.07 in chips)
Seat 2: 2bf0da0a ($8.23 in chips)
Seat 3: ea1cc8c1 ($5.14 in chips)
Seat 4: c86f76e6 ($1.74 in chips)
Seat 5: a6bde6ad ($5.98 in chips)
Seat 6: Hero ($9.65 in chips)
ea1cc8c1: posts small blind $0.02
c86f76e6: posts big blind $0.05
*** HOLE CARDS ***
Dealt to 786d72 
Dealt to 2bf0da0a 
Dealt to ea1cc8c1 
Dealt to c86f76e6 
Dealt to a6bde6ad 
Dealt to Hero [7h 2h]
a6bde6ad: raises $0.08 to $0.13
Hero: folds
786d72: folds
2bf0da0a: folds
ea1cc8c1: folds
c86f76e6: folds
Uncalled bet ($0.08) returned to a6bde6ad
*** SHOWDOWN ***
a6bde6ad collected $0.12 from pot
*** SUMMARY ***
Total pot $0.12 | Rake $0 | Jackpot $0 | Bingo $0 | Fortune $0
Seat 1: 786d72 folded before Flop (didn't bet)
Seat 2: 2bf0da0a (button) folded before Flop (didn't bet)
Seat 3: ea1cc8c1 (small blind) folded before Flop
Seat 4: c86f76e6 (big blind) folded before Flop
Seat 5: a6bde6ad collected ($0.12)
Seat 6: Hero folded before Flop (didn't bet)


Poker Hand #HD1199295905: Hold'em No Limit  ($0.02/$0.05) - 2023/04/11 21:40:31
Table 'NLHBlue32' 6-max Seat #1 is the button
Seat 1: 786d72 ($5.07 in chips)
Seat 2: 2bf0da0a ($8.38 in chips)
Seat 3: ea1cc8c1 ($5 in chips)
Seat 4: c86f76e6 ($1.74 in chips)
Seat 5: a6bde6ad ($5.98 in chips)
Seat 6: Hero ($9.65 in chips)
2bf0da0a: posts small blind $0.02
ea1cc8c1: posts big blind $0.05
*** HOLE CARDS ***
Dealt to 786d72 
Dealt to 2bf0da0a 
Dealt to ea1cc8c1 
Dealt to c86f76e6 
Dealt to a6bde6ad 
Dealt to Hero [8h Qs]
c86f76e6: folds
a6bde6ad: folds
Hero: folds
786d72: folds
2bf0da0a: raises $0.1 to $0.15
ea1cc8c1: calls $0.1
*** FLOP *** [3h Ts 8d]
2bf0da0a: checks
ea1cc8c1: bets $0.24
2bf0da0a: folds
Uncalled bet ($0.24) returned to ea1cc8c1
*** SHOWDOWN ***
ea1cc8c1 collected $0.29 from pot
*** SUMMARY ***
Total pot $0.3 | Rake $0.01 | Jackpot $0 | Bingo $0 | Fortune $0
Board [3h Ts 8d]
Seat 1: 786d72 (button) folded before Flop (didn't bet)
Seat 2: 2bf0da0a (small blind) folded on the Flop
Seat 3: ea1cc8c1 (big blind) won ($0.29)
Seat 4: c86f76e6 folded before Flop (didn't bet)
Seat 5: a6bde6ad folded before Flop (didn't bet)
Seat 6: Hero folded before Flop (didn't bet)


Poker Hand #HD1199295882: Hold'em No Limit  ($0.02/$0.05) - 2023/04/11 21:40:17
Table 'NLHBlue32' 6-max Seat #6 is the button
Seat 1: 786d72 ($5.02 in chips)
Seat 2: 2bf0da0a ($8.43 in chips)
Seat 4: c86f76e6 ($1.74 in chips)
Seat 5: a6bde6ad ($5.98 in chips)
Seat 6: Hero ($9.65 in chips)
786d72: posts small blind $0.02
2bf0da0a: posts big blind $0.05
*** HOLE CARDS ***
Dealt to 786d72 
Dealt to 2bf0da0a 
Dealt to c86f76e6 
Dealt to a6bde6ad 
Dealt to Hero [Qc 9s]
c86f76e6: folds
a6bde6ad: folds
Hero: folds
786d72: raises $0.1 to $0.15
2bf0da0a: folds
Uncalled bet ($0.1) returned to 786d72
*** SHOWDOWN ***
786d72 collected $0.1 from pot
*** SUMMARY ***
Total pot $0.1 | Rake $0 | Jackpot $0 | Bingo $0 | Fortune $0
Seat 1: 786d72 (small blind) collected ($0.1)
Seat 2: 2bf0da0a (big blind) folded before Flop
Seat 4: c86f76e6 folded before Flop (didn't bet)
Seat 5: a6bde6ad folded before Flop (didn't bet)
Seat 6: Hero (button) folded before Flop (didn't bet)


Poker Hand #HD1199295864: Hold'em No Limit  ($0.02/$0.05) - 2023/04/11 21:40:11
Table 'NLHBlue32' 6-max Seat #5 is the button
Seat 1: 786d72 ($5 in chips)
Seat 2: 2bf0da0a ($8.43 in chips)
Seat 4: c86f76e6 ($1.74 in chips)
Seat 5: a6bde6ad ($5.98 in chips)
Seat 6: Hero ($9.67 in chips)
Hero: posts small blind $0.02
786d72: posts big blind $0.05
*** HOLE CARDS ***
Dealt to 786d72 
Dealt to 2bf0da0a 
Dealt to c86f76e6 
Dealt to a6bde6ad 
Dealt to Hero [Td 4d]
2bf0da0a: folds
c86f76e6: folds
a6bde6ad: folds
Hero: folds
Uncalled bet ($0.03) returned to 786d72
*** SHOWDOWN ***
786d72 collected $0.04 from pot
*** SUMMARY ***
Total pot $0.04 | Rake $0 | Jackpot $0 | Bingo $0 | Fortune $0
Seat 1: 786d72 (big blind) collected ($0.04)
Seat 2: 2bf0da0a folded before Flop (didn't bet)
Seat 4: c86f76e6 folded before Flop (didn't bet)
Seat 5: a6bde6ad (button) folded before Flop (didn't bet)
Seat 6: Hero (small blind) folded before Flop


Poker Hand #HD1199295847: Hold'em No Limit  ($0.02/$0.05) - 2023/04/11 21:40:01
Table 'NLHBlue32' 6-max Seat #4 is the button
Seat 1: 786d72 ($5 in chips)
Seat 2: 2bf0da0a ($8.43 in chips)
Seat 4: c86f76e6 ($1.67 in chips)
Seat 5: a6bde6ad ($6 in chips)
Seat 6: Hero ($9.72 in chips)
a6bde6ad: posts small blind $0.02
Hero: posts big blind $0.05
*** HOLE CARDS ***
Dealt to 786d72 
Dealt to 2bf0da0a 
Dealt to c86f76e6 
Dealt to a6bde6ad 
Dealt to Hero [6c Qs]
786d72: folds
2bf0da0a: folds
c86f76e6: raises $0.09 to $0.14
a6bde6ad: folds
Hero: folds
Uncalled bet ($0.09) returned to c86f76e6
*** SHOWDOWN ***
c86f76e6 collected $0.12 from pot
*** SUMMARY ***
Total pot $0.12 | Rake $0 | Jackpot $0 | Bingo $0 | Fortune $0
Seat 1: 786d72 folded before Flop (didn't bet)
Seat 2: 2bf0da0a folded before Flop (didn't bet)
Seat 4: c86f76e6 (button) collected ($0.12)
Seat 5: a6bde6ad (small blind) folded before Flop
Seat 6: Hero (big blind) folded before Flop


Poker Hand #HD1199295728: Hold'em No Limit  ($0.02/$0.05) - 2023/04/11 21:39:14
Table 'NLHBlue32' 6-max Seat #2 is the button
Seat 1: 786d72 ($5 in chips)
Seat 2: 2bf0da0a ($7.35 in chips)
Seat 4: c86f76e6 ($2.86 in chips)
Seat 5: a6bde6ad ($6.05 in chips)
Seat 6: Hero ($9.72 in chips)
c86f76e6: posts small blind $0.02
a6bde6ad: posts big blind $0.05
*** HOLE CARDS ***
Dealt to 786d72 
Dealt to 2bf0da0a 
Dealt to c86f76e6 
Dealt to a6bde6ad 
Dealt to Hero [6c 3s]
Hero: folds
786d72: folds
2bf0da0a: raises $0.08 to $0.13
c86f76e6: raises $0.33 to $0.46
a6bde6ad: folds
2bf0da0a: calls $0.33
*** FLOP *** [As 3d 8s]
c86f76e6: bets $0.73
2bf0da0a: calls $0.73
*** TURN *** [As 3d 8s] [5d]
c86f76e6: checks
2bf0da0a: bets $1.84
c86f76e6: folds
Uncalled bet ($1.84) returned to 2bf0da0a
*** SHOWDOWN ***
2bf0da0a collected $2.27 from pot
*** SUMMARY ***
Total pot $2.43 | Rake $0.11 | Jackpot $0.05 | Bingo $0 | Fortune $0
Board [As 3d 8s 5d]
Seat 1: 786d72 folded before Flop (didn't bet)
Seat 2: 2bf0da0a (button) won ($2.27)
Seat 4: c86f76e6 (small blind) folded on the Turn
Seat 5: a6bde6ad (big blind) folded before Flop
Seat 6: Hero folded before Flop (didn't bet)


Poker Hand #HD1199295651: Hold'em No Limit  ($0.02/$0.05) - 2023/04/11 21:38:36
Table 'NLHBlue32' 6-max Seat #1 is the button
Seat 1: 786d72 ($5.06 in chips)
Seat 2: 2bf0da0a ($6.81 in chips)
Seat 4: c86f76e6 ($2.91 in chips)
Seat 5: a6bde6ad ($6.05 in chips)
Seat 6: Hero ($9.72 in chips)
2bf0da0a: posts small blind $0.02
c86f76e6: posts big blind $0.05
*** HOLE CARDS ***
Dealt to 786d72 
Dealt to 2bf0da0a 
Dealt to c86f76e6 
Dealt to a6bde6ad 
Dealt to Hero [Kh 9s]
a6bde6ad: folds
Hero: folds
786d72: raises $0.08 to $0.13
2bf0da0a: raises $0.41 to $0.54
c86f76e6: folds
786d72: calls $0.41
*** FLOP *** [3h Ah 9h]
2bf0da0a: bets $0.34
786d72: folds
Uncalled bet ($0.34) returned to 2bf0da0a
*** SHOWDOWN ***
2bf0da0a collected $1.08 from pot
*** SUMMARY ***
Total pot $1.13 | Rake $0.05 | Jackpot $0 | Bingo $0 | Fortune $0
Board [3h Ah 9h]
Seat 1: 786d72 (button) folded on the Flop
Seat 2: 2bf0da0a (small blind) won ($1.08)
Seat 4: c86f76e6 (big blind) folded before Flop
Seat 5: a6bde6ad folded before Flop (didn't bet)
Seat 6: Hero folded before Flop (didn't bet)


Poker Hand #HD1199225616: Hold'em No Limit  ($0.02/$0.05) - 2023/04/11 21:38:23
Table 'NLHBlue32' 6-max Seat #6 is the button
Seat 1: 786d72 ($5.08 in chips)
Seat 2: 2bf0da0a ($6.79 in chips)
Seat 3: 88370224 ($6.22 in chips)
Seat 4: c86f76e6 ($2.91 in chips)
Seat 5: a6bde6ad ($6.05 in chips)
Seat 6: Hero ($9.72 in chips)
786d72: posts small blind $0.02
2bf0da0a: posts big blind $0.05
*** HOLE CARDS ***
Dealt to 786d72 
Dealt to 2bf0da0a 
Dealt to 88370224 
Dealt to c86f76e6 
Dealt to a6bde6ad 
Dealt to Hero [2c Jc]
88370224: folds
c86f76e6: folds
a6bde6ad: folds
Hero: folds
786d72: folds
Uncalled bet ($0.03) returned to 2bf0da0a
*** SHOWDOWN ***
2bf0da0a collected $0.04 from pot
*** SUMMARY ***
Total pot $0.04 | Rake $0 | Jackpot $0 | Bingo $0 | Fortune $0
Seat 1: 786d72 (small blind) folded before Flop
Seat 2: 2bf0da0a (big blind) collected ($0.04)
Seat 3: 88370224 folded before Flop (didn't bet)
Seat 4: c86f76e6 folded before Flop (didn't bet)
Seat 5: a6bde6ad folded before Flop (didn't bet)
Seat 6: Hero (button) folded before Flop (didn't bet)


Poker Hand #HD1199225433: Hold'em No Limit  ($0.02/$0.05) - 2023/04/11 21:36:51
Table 'NLHBlue32' 6-max Seat #5 is the button
Seat 1: 786d72 ($6.67 in chips)
Seat 2: 2bf0da0a ($5.38 in chips)
Seat 3: 88370224 ($6.22 in chips)
Seat 4: c86f76e6 ($2.91 in chips)
Seat 5: a6bde6ad ($6.05 in chips)
Seat 6: Hero ($9.74 in chips)
Hero: posts small blind $0.02
786d72: posts big blind $0.05
*** HOLE CARDS ***
Dealt to 786d72 
Dealt to 2bf0da0a 
Dealt to 88370224 
Dealt to c86f76e6 
Dealt to a6bde6ad 
Dealt to Hero [2d 5h]
2bf0da0a: raises $0.08 to $0.13
88370224: folds
c86f76e6: folds
a6bde6ad: folds
Hero: folds
786d72: calls $0.08
*** FLOP *** [6s Ts 9c]
786d72: checks
2bf0da0a: bets $0.18
786d72: calls $0.18
*** TURN *** [6s Ts 9c] [Kh]
786d72: checks
2bf0da0a: bets $0.48
786d72: raises $0.8 to $1.28
2bf0da0a: calls $0.8
*** RIVER *** [6s Ts 9c Kh] [3h]
786d72: checks
2bf0da0a: bets $0.6
786d72: folds
Uncalled bet ($0.6) returned to 2bf0da0a
*** SHOWDOWN ***
2bf0da0a collected $3 from pot
*** SUMMARY ***
Total pot $3.2 | Rake $0.15 | Jackpot $0.05 | Bingo $0 | Fortune $0
Board [6s Ts 9c Kh 3h]
Seat 1: 786d72 (big blind) folded on the River
Seat 2: 2bf0da0a won ($3)
Seat 3: 88370224 folded before Flop (didn't bet)
Seat 4: c86f76e6 folded before Flop (didn't bet)
Seat 5: a6bde6ad (button) folded before Flop (didn't bet)
Seat 6: Hero (small blind) folded before Flop


Poker Hand #HD1199225418: Hold'em No Limit  ($0.02/$0.05) - 2023/04/11 21:36:44
Table 'NLHBlue32' 6-max Seat #4 is the button
Seat 1: 786d72 ($6.67 in chips)
Seat 2: 2bf0da0a ($5.38 in chips)
Seat 3: 88370224 ($6.22 in chips)
Seat 4: c86f76e6 ($2.91 in chips)
Seat 5: a6bde6ad ($6.07 in chips)
Seat 6: Hero ($9.72 in chips)
a6bde6ad: posts small blind $0.02
Hero: posts big blind $0.05
*** HOLE CARDS ***
Dealt to 786d72 
Dealt to 2bf0da0a 
Dealt to 88370224 
Dealt to c86f76e6 
Dealt to a6bde6ad 
Dealt to Hero [9c 5h]
786d72: folds
2bf0da0a: folds
88370224: folds
c86f76e6: folds
a6bde6ad: folds
Uncalled bet ($0.03) returned to Hero
*** SHOWDOWN ***
Hero collected $0.04 from pot
*** SUMMARY ***
Total pot $0.04 | Rake $0 | Jackpot $0 | Bingo $0 | Fortune $0
Seat 1: 786d72 folded before Flop (didn't bet)
Seat 2: 2bf0da0a folded before Flop (didn't bet)
Seat 3: 88370224 folded before Flop (didn't bet)
Seat 4: c86f76e6 (button) folded before Flop (didn't bet)
Seat 5: a6bde6ad (small blind) folded before Flop
Seat 6: Hero (big blind) collected ($0.04)


Poker Hand #HD1199225389: Hold'em No Limit  ($0.02/$0.05) - 2023/04/11 21:36:28
Table 'NLHBlue32' 6-max Seat #3 is the button
Seat 1: 786d72 ($6.67 in chips)
Seat 2: 2bf0da0a ($5.38 in chips)
Seat 3: 88370224 ($6.22 in chips)
Seat 4: c86f76e6 ($2.86 in chips)
Seat 5: a6bde6ad ($6.12 in chips)
Seat 6: Hero ($9.72 in chips)
c86f76e6: posts small blind $0.02
a6bde6ad: posts big blind $0.05
*** HOLE CARDS ***
Dealt to 786d72 
Dealt to 2bf0da0a 
Dealt to 88370224 
Dealt to c86f76e6 
Dealt to a6bde6ad 
Dealt to Hero [9c Qc]
Hero: folds
786d72: folds
2bf0da0a: folds
88370224: folds
c86f76e6: raises $0.08 to $0.13
a6bde6ad: folds
Uncalled bet ($0.08) returned to c86f76e6
*** SHOWDOWN ***
c86f76e6 collected $0.1 from pot
*** SUMMARY ***
Total pot $0.1 | Rake $0 | Jackpot $0 | Bingo $0 | Fortune $0
Seat 1: 786d72 folded before Flop (didn't bet)
Seat 2: 2bf0da0a folded before Flop (didn't bet)
Seat 3: 88370224 (button) folded before Flop (didn't bet)
Seat 4: c86f76e6 (small blind) collected ($0.1)
Seat 5: a6bde6ad (big blind) folded before Flop
Seat 6: Hero folded before Flop (didn't bet)


Poker Hand #HD1199225302: Hold'em No Limit  ($0.02/$0.05) - 2023/04/11 21:35:41
Table 'NLHBlue32' 6-max Seat #2 is the button
Seat 1: 786d72 ($6.67 in chips)
Seat 2: 2bf0da0a ($5.38 in chips)
Seat 3: 88370224 ($6.24 in chips)
Seat 4: c86f76e6 ($2.49 in chips)
Seat 5: a6bde6ad ($6.5 in chips)
Seat 6: Hero ($9.72 in chips)
88370224: posts small blind $0.02
c86f76e6: posts big blind $0.05
*** HOLE CARDS ***
Dealt to 786d72 
Dealt to 2bf0da0a 
Dealt to 88370224 
Dealt to c86f76e6 
Dealt to a6bde6ad 
Dealt to Hero [7c 9h]
a6bde6ad: raises $0.08 to $0.13
Hero: folds
786d72: folds
2bf0da0a: folds
88370224: folds
c86f76e6: raises $0.25 to $0.38
a6bde6ad: calls $0.25
*** FLOP *** [3d Tc 6c]
c86f76e6: bets $0.59
a6bde6ad: folds
Uncalled bet ($0.59) returned to c86f76e6
*** SHOWDOWN ***
c86f76e6 collected $0.75 from pot
*** SUMMARY ***
Total pot $0.78 | Rake $0.03 | Jackpot $0 | Bingo $0 | Fortune $0
Board [3d Tc 6c]
Seat 1: 786d72 folded before Flop (didn't bet)
Seat 2: 2bf0da0a (button) folded before Flop (didn't bet)
Seat 3: 88370224 (small blind) folded before Flop
Seat 4: c86f76e6 (big blind) won ($0.75)
Seat 5: a6bde6ad folded on the Flop
Seat 6: Hero folded before Flop (didn't bet)


Poker Hand #HD1199225199: Hold'em No Limit  ($0.02/$0.05) - 2023/04/11 21:34:52
Table 'NLHBlue32' 6-max Seat #1 is the button
Seat 1: 786d72 ($6.67 in chips)
Seat 2: 2bf0da0a ($5.65 in chips)
Seat 3: 88370224 ($5.99 in chips)
Seat 4: c86f76e6 ($2.49 in chips)
Seat 5: a6bde6ad ($6.5 in chips)
Seat 6: Hero ($9.72 in chips)
2bf0da0a: posts small blind $0.02
88370224: posts big blind $0.05
*** HOLE CARDS ***
Dealt to 786d72 
Dealt to 2bf0da0a 
Dealt to 88370224 
Dealt to c86f76e6 
Dealt to a6bde6ad 
Dealt to Hero [Ts 9h]
c86f76e6: folds
a6bde6ad: folds
Hero: folds
786d72: folds
2bf0da0a: raises $0.1 to $0.15
88370224: calls $0.1
*** FLOP *** [5s Kc 9d]
2bf0da0a: checks
88370224: bets $0.12
2bf0da0a: calls $0.12
*** TURN *** [5s Kc 9d] [7s]
2bf0da0a: checks
88370224: bets $0.4
2bf0da0a: folds
Uncalled bet ($0.4) returned to 88370224
*** SHOWDOWN ***
88370224 collected $0.52 from pot
*** SUMMARY ***
Total pot $0.54 | Rake $0.02 | Jackpot $0 | Bingo $0 | Fortune $0
Board [5s Kc 9d 7s]
Seat 1: 786d72 (button) folded before Flop (didn't bet)
Seat 2: 2bf0da0a (small blind) folded on the Turn
Seat 3: 88370224 (big blind) won ($0.52)
Seat 4: c86f76e6 folded before Flop (didn't bet)
Seat 5: a6bde6ad folded before Flop (didn't bet)
Seat 6: Hero folded before Flop (didn't bet)


Poker Hand #HD1199225179: Hold'em No Limit  ($0.02/$0.05) - 2023/04/11 21:34:44
Table 'NLHBlue32' 6-max Seat #6 is the button
Seat 1: 786d72 ($6.69 in chips)
Seat 2: 2bf0da0a ($5.63 in chips)
Seat 3: 88370224 ($5.99 in chips)
Seat 4: c86f76e6 ($2.49 in chips)
Seat 5: a6bde6ad ($6.5 in chips)
Seat 6: Hero ($9.72 in chips)
786d72: posts small blind $0.02
2bf0da0a: posts big blind $0.05
*** HOLE CARDS ***
Dealt to 786d72 
Dealt to 2bf0da0a 
Dealt to 88370224 
Dealt to c86f76e6 
Dealt to a6bde6ad 
Dealt to Hero [2h 3s]
88370224: folds
c86f76e6: folds
a6bde6ad: folds
Hero: folds
786d72: folds
Uncalled bet ($0.03) returned to 2bf0da0a
*** SHOWDOWN ***
2bf0da0a collected $0.04 from pot
*** SUMMARY ***
Total pot $0.04 | Rake $0 | Jackpot $0 | Bingo $0 | Fortune $0
Seat 1: 786d72 (small blind) folded before Flop
Seat 2: 2bf0da0a (big blind) collected ($0.04)
Seat 3: 88370224 folded before Flop (didn't bet)
Seat 4: c86f76e6 folded before Flop (didn't bet)
Seat 5: a6bde6ad folded before Flop (didn't bet)
Seat 6: Hero (button) folded before Flop (didn't bet)


Poker Hand #HD1199225105: Hold'em No Limit  ($0.02/$0.05) - 2023/04/11 21:34:04
Table 'NLHBlue32' 6-max Seat #5 is the button
Seat 1: 786d72 ($6.74 in chips)
Seat 2: 2bf0da0a ($5.63 in chips)
Seat 3: 88370224 ($5.99 in chips)
Seat 4: c86f76e6 ($2.49 in chips)
Seat 5: a6bde6ad ($6.43 in chips)
Seat 6: Hero ($9.74 in chips)
Hero: posts small blind $0.02
786d72: posts big blind $0.05
*** HOLE CARDS ***
Dealt to 786d72 
Dealt to 2bf0da0a 
Dealt to 88370224 
Dealt to c86f76e6 
Dealt to a6bde6ad 
Dealt to Hero [Tc Js]
2bf0da0a: folds
88370224: folds
c86f76e6: folds
a6bde6ad: raises $0.08 to $0.13
Hero: folds
786d72: folds
Uncalled bet ($0.08) returned to a6bde6ad
*** SHOWDOWN ***
a6bde6ad collected $0.12 from pot
*** SUMMARY ***
Total pot $0.12 | Rake $0 | Jackpot $0 | Bingo $0 | Fortune $0
Seat 1: 786d72 (big blind) folded before Flop
Seat 2: 2bf0da0a folded before Flop (didn't bet)
Seat 3: 88370224 folded before Flop (didn't bet)
Seat 4: c86f76e6 folded before Flop (didn't bet)
Seat 5: a6bde6ad (button) collected ($0.12)
Seat 6: Hero (small blind) folded before Flop


Poker Hand #HD1199225063: Hold'em No Limit  ($0.02/$0.05) - 2023/04/11 21:33:47
Table 'NLHBlue32' 6-max Seat #4 is the button
Seat 1: 786d72 ($6.74 in chips)
Seat 2: 2bf0da0a ($5.63 in chips)
Seat 3: 88370224 ($5.99 in chips)
Seat 4: c86f76e6 ($2.42 in chips)
Seat 5: a6bde6ad ($6.45 in chips)
Seat 6: Hero ($9.79 in chips)
a6bde6ad: posts small blind $0.02
Hero: posts big blind $0.05
*** HOLE CARDS ***
Dealt to 786d72 
Dealt to 2bf0da0a 
Dealt to 88370224 
Dealt to c86f76e6 
Dealt to a6bde6ad 
Dealt to Hero [5d 2s]
786d72: folds
2bf0da0a: folds
88370224: folds
c86f76e6: raises $0.07 to $0.12
a6bde6ad: folds
Hero: folds
Uncalled bet ($0.07) returned to c86f76e6
*** SHOWDOWN ***
c86f76e6 collected $0.12 from pot
*** SUMMARY ***
Total pot $0.12 | Rake $0 | Jackpot $0 | Bingo $0 | Fortune $0
Seat 1: 786d72 folded before Flop (didn't bet)
Seat 2: 2bf0da0a folded before Flop (didn't bet)
Seat 3: 88370224 folded before Flop (didn't bet)
Seat 4: c86f76e6 (button) collected ($0.12)
Seat 5: a6bde6ad (small blind) folded before Flop
Seat 6: Hero (big blind) folded before Flop


Poker Hand #HD1199225017: Hold'em No Limit  ($0.02/$0.05) - 2023/04/11 21:33:23
Table 'NLHBlue32' 6-max Seat #3 is the button
Seat 1: 786d72 ($6.67 in chips)
Seat 2: 2bf0da0a ($5.63 in chips)
Seat 3: 88370224 ($5.99 in chips)
Seat 4: c86f76e6 ($2.44 in chips)
Seat 5: a6bde6ad ($6.5 in chips)
Seat 6: Hero ($9.79 in chips)
c86f76e6: posts small blind $0.02
a6bde6ad: posts big blind $0.05
*** HOLE CARDS ***
Dealt to 786d72 
Dealt to 2bf0da0a 
Dealt to 88370224 
Dealt to c86f76e6 
Dealt to a6bde6ad 
Dealt to Hero [Tc Qd]
Hero: folds
786d72: raises $0.08 to $0.13
2bf0da0a: folds
88370224: folds
c86f76e6: folds
a6bde6ad: folds
Uncalled bet ($0.08) returned to 786d72
*** SHOWDOWN ***
786d72 collected $0.12 from pot
*** SUMMARY ***
Total pot $0.12 | Rake $0 | Jackpot $0 | Bingo $0 | Fortune $0
Seat 1: 786d72 collected ($0.12)
Seat 2: 2bf0da0a folded before Flop (didn't bet)
Seat 3: 88370224 (button) folded before Flop (didn't bet)
Seat 4: c86f76e6 (small blind) folded before Flop
Seat 5: a6bde6ad (big blind) folded before Flop
Seat 6: Hero folded before Flop (didn't bet)


Poker Hand #HD1199224951: Hold'em No Limit  ($0.02/$0.05) - 2023/04/11 21:32:48
Table 'NLHBlue32' 6-max Seat #2 is the button
Seat 1: 786d72 ($6.67 in chips)
Seat 2: 2bf0da0a ($5.25 in chips)
Seat 3: 88370224 ($6.35 in chips)
Seat 4: c86f76e6 ($2.49 in chips)
Seat 5: a6bde6ad ($6.5 in chips)
Seat 6: Hero ($9.79 in chips)
88370224: posts small blind $0.02
c86f76e6: posts big blind $0.05
*** HOLE CARDS ***
Dealt to 786d72 
Dealt to 2bf0da0a 
Dealt to 88370224 
Dealt to c86f76e6 
Dealt to a6bde6ad 
Dealt to Hero [Th 6c]
a6bde6ad: folds
Hero: folds
786d72: folds
2bf0da0a: raises $0.08 to $0.13
88370224: calls $0.11
c86f76e6: folds
*** FLOP *** [9h 3d 9d]
88370224: checks
2bf0da0a: checks
*** TURN *** [9h 3d 9d] [Tc]
88370224: bets $0.23
2bf0da0a: calls $0.23
*** RIVER *** [9h 3d 9d Tc] [5d]
88370224: checks
2bf0da0a: checks
88370224: shows [7c 8c] (Pair of Nines)
2bf0da0a: shows [Ts Ad] (Pair of Tens and Pair of Nines)
*** SHOWDOWN ***
2bf0da0a collected $0.74 from pot
*** SUMMARY ***
Total pot $0.77 | Rake $0.03 | Jackpot $0 | Bingo $0 | Fortune $0
Board [9h 3d 9d Tc 5d]
Seat 1: 786d72 folded before Flop (didn't bet)
Seat 2: 2bf0da0a (button) showed [Ts Ad] and won ($0.74) with Pair of Tens and Pair of Nines
Seat 3: 88370224 (small blind) showed [7c 8c] and lost with Pair of Nines
Seat 4: c86f76e6 (big blind) folded before Flop
Seat 5: a6bde6ad folded before Flop (didn't bet)
Seat 6: Hero folded before Flop (didn't bet)


Poker Hand #HD1199224862: Hold'em No Limit  ($0.02/$0.05) - 2023/04/11 21:32:02
Table 'NLHBlue32' 6-max Seat #1 is the button
Seat 1: 786d72 ($5.87 in chips)
Seat 2: 2bf0da0a ($6.13 in chips)
Seat 3: 88370224 ($6.4 in chips)
Seat 4: c86f76e6 ($2.49 in chips)
Seat 5: a6bde6ad ($6.5 in chips)
Seat 6: Hero ($9.79 in chips)
2bf0da0a: posts small blind $0.02
88370224: posts big blind $0.05
*** HOLE CARDS ***
Dealt to 786d72 
Dealt to 2bf0da0a 
Dealt to 88370224 
Dealt to c86f76e6 
Dealt to a6bde6ad 
Dealt to Hero [Ts 2s]
c86f76e6: folds
a6bde6ad: folds
Hero: folds
786d72: raises $0.08 to $0.13
2bf0da0a: raises $0.41 to $0.54
88370224: folds
786d72: calls $0.41
*** FLOP *** [Ad 2d 7h]
2bf0da0a: bets $0.34
786d72: calls $0.34
*** TURN *** [Ad 2d 7h] [4d]
2bf0da0a: checks
786d72: checks
*** RIVER *** [Ad 2d 7h 4d] [Js]
2bf0da0a: checks
786d72: checks
2bf0da0a: shows [8s 8h] (Pair of Eights)
786d72: shows [Td Th] (Pair of Tens)
*** SHOWDOWN ***
786d72 collected $1.68 from pot
*** SUMMARY ***
Total pot $1.81 | Rake $0.08 | Jackpot $0.05 | Bingo $0 | Fortune $0
Board [Ad 2d 7h 4d Js]
Seat 1: 786d72 (button) showed [Td Th] and won ($1.68) with Pair of Tens
Seat 2: 2bf0da0a (small blind) showed [8s 8h] and lost with Pair of Eights
Seat 3: 88370224 (big blind) folded before Flop
Seat 4: c86f76e6 folded before Flop (didn't bet)
Seat 5: a6bde6ad folded before Flop (didn't bet)
Seat 6: Hero folded before Flop (didn't bet)


Poker Hand #HD1199224794: Hold'em No Limit  ($0.02/$0.05) - 2023/04/11 21:31:29
Table 'NLHBlue32' 6-max Seat #6 is the button
Seat 1: 786d72 ($5.89 in chips)
Seat 2: 2bf0da0a ($6 in chips)
Seat 3: 88370224 ($6.4 in chips)
Seat 4: c86f76e6 ($2.49 in chips)
Seat 5: a6bde6ad ($6.5 in chips)
Seat 6: Hero ($9.91 in chips)
786d72: posts small blind $0.02
2bf0da0a: posts big blind $0.05
*** HOLE CARDS ***
Dealt to 786d72 
Dealt to 2bf0da0a 
Dealt to 88370224 
Dealt to c86f76e6 
Dealt to a6bde6ad 
Dealt to Hero [3s 4s]
88370224: folds
c86f76e6: folds
a6bde6ad: folds
Hero: raises $0.07 to $0.12
786d72: folds
2bf0da0a: raises $0.34 to $0.46
Hero: folds
Uncalled bet ($0.34) returned to 2bf0da0a
*** SHOWDOWN ***
2bf0da0a collected $0.25 from pot
*** SUMMARY ***
Total pot $0.26 | Rake $0.01 | Jackpot $0 | Bingo $0 | Fortune $0
Seat 1: 786d72 (small blind) folded before Flop
Seat 2: 2bf0da0a (big blind) collected ($0.25)
Seat 3: 88370224 folded before Flop (didn't bet)
Seat 4: c86f76e6 folded before Flop (didn't bet)
Seat 5: a6bde6ad folded before Flop (didn't bet)
Seat 6: Hero (button) folded before Flop


Poker Hand #HD1199224715: Hold'em No Limit  ($0.02/$0.05) - 2023/04/11 21:30:53
Table 'NLHBlue32' 6-max Seat #5 is the button
Seat 1: 786d72 ($5.62 in chips)
Seat 2: 2bf0da0a ($6 in chips)
Seat 3: 88370224 ($6.4 in chips)
Seat 4: c86f76e6 ($2.49 in chips)
Seat 5: a6bde6ad ($6.77 in chips)
Seat 6: Hero ($9.93 in chips)
Hero: posts small blind $0.02
786d72: posts big blind $0.05
*** HOLE CARDS ***
Dealt to 786d72 
Dealt to 2bf0da0a 
Dealt to 88370224 
Dealt to c86f76e6 
Dealt to a6bde6ad 
Dealt to Hero [3d Jc]
2bf0da0a: folds
88370224: folds
c86f76e6: folds
a6bde6ad: raises $0.08 to $0.13
Hero: folds
786d72: calls $0.08
*** FLOP *** [9s Jd 9c]
786d72: checks
a6bde6ad: bets $0.14
786d72: raises $0.28 to $0.42
a6bde6ad: folds
Uncalled bet ($0.28) returned to 786d72
*** SHOWDOWN ***
786d72 collected $0.54 from pot
*** SUMMARY ***
Total pot $0.56 | Rake $0.02 | Jackpot $0 | Bingo $0 | Fortune $0
Board [9s Jd 9c]
Seat 1: 786d72 (big blind) won ($0.54)
Seat 2: 2bf0da0a folded before Flop (didn't bet)
Seat 3: 88370224 folded before Flop (didn't bet)
Seat 4: c86f76e6 folded before Flop (didn't bet)
Seat 5: a6bde6ad (button) folded on the Flop
Seat 6: Hero (small blind) folded before Flop


Poker Hand #HD1199224666: Hold'em No Limit  ($0.02/$0.05) - 2023/04/11 21:30:35
Table 'NLHBlue32' 6-max Seat #4 is the button
Seat 1: 786d72 ($5.62 in chips)
Seat 2: 2bf0da0a ($6 in chips)
Seat 3: 88370224 ($6.4 in chips)
Seat 4: c86f76e6 ($2.49 in chips)
Seat 5: a6bde6ad ($6.79 in chips)
Seat 6: Hero ($9.91 in chips)
a6bde6ad: posts small blind $0.02
Hero: posts big blind $0.05
*** HOLE CARDS ***
Dealt to 786d72 
Dealt to 2bf0da0a 
Dealt to 88370224 
Dealt to c86f76e6 
Dealt to a6bde6ad 
Dealt to Hero [Tc 3c]
786d72: folds
2bf0da0a: folds
88370224: folds
c86f76e6: folds
a6bde6ad: folds
Uncalled bet ($0.03) returned to Hero
*** SHOWDOWN ***
Hero collected $0.04 from pot
*** SUMMARY ***
Total pot $0.04 | Rake $0 | Jackpot $0 | Bingo $0 | Fortune $0
Seat 1: 786d72 folded before Flop (didn't bet)
Seat 2: 2bf0da0a folded before Flop (didn't bet)
Seat 3: 88370224 folded before Flop (didn't bet)
Seat 4: c86f76e6 (button) folded before Flop (didn't bet)
Seat 5: a6bde6ad (small blind) folded before Flop
Seat 6: Hero (big blind) collected ($0.04)


Poker Hand #HD1199224644: Hold'em No Limit  ($0.02/$0.05) - 2023/04/11 21:30:23
Table 'NLHBlue32' 6-max Seat #3 is the button
Seat 1: 786d72 ($5.62 in chips)
Seat 2: 2bf0da0a ($5.93 in chips)
Seat 3: 88370224 ($6.4 in chips)
Seat 4: c86f76e6 ($2.51 in chips)
Seat 5: a6bde6ad ($6.84 in chips)
Seat 6: Hero ($9.91 in chips)
c86f76e6: posts small blind $0.02
a6bde6ad: posts big blind $0.05
*** HOLE CARDS ***
Dealt to 786d72 
Dealt to 2bf0da0a 
Dealt to 88370224 
Dealt to c86f76e6 
Dealt to a6bde6ad 
Dealt to Hero [Td 8d]
Hero: folds
786d72: folds
2bf0da0a: raises $0.08 to $0.13
88370224: folds
c86f76e6: folds
a6bde6ad: folds
Uncalled bet ($0.08) returned to 2bf0da0a
*** SHOWDOWN ***
2bf0da0a collected $0.12 from pot
*** SUMMARY ***
Total pot $0.12 | Rake $0 | Jackpot $0 | Bingo $0 | Fortune $0
Seat 1: 786d72 folded before Flop (didn't bet)
Seat 2: 2bf0da0a collected ($0.12)
Seat 3: 88370224 (button) folded before Flop (didn't bet)
Seat 4: c86f76e6 (small blind) folded before Flop
Seat 5: a6bde6ad (big blind) folded before Flop
Seat 6: Hero folded before Flop (didn't bet)


Poker Hand #HD1199224601: Hold'em No Limit  ($0.02/$0.05) - 2023/04/11 21:29:56
Table 'NLHBlue32' 6-max Seat #2 is the button
Seat 1: 786d72 ($5.62 in chips)
Seat 2: 2bf0da0a ($5.93 in chips)
Seat 3: 88370224 ($6.74 in chips)
Seat 4: c86f76e6 ($2.56 in chips)
Seat 5: a6bde6ad ($6.84 in chips)
Seat 6: Hero ($9.55 in chips)
88370224: posts small blind $0.02
c86f76e6: posts big blind $0.05
*** HOLE CARDS ***
Dealt to 786d72 
Dealt to 2bf0da0a 
Dealt to 88370224 
Dealt to c86f76e6 
Dealt to a6bde6ad 
Dealt to Hero [Jd Js]
a6bde6ad: folds
Hero: raises $0.07 to $0.12
786d72: folds
2bf0da0a: folds
88370224: raises $0.22 to $0.34
c86f76e6: folds
Hero: raises $0.82 to $1.16
88370224: folds
Uncalled bet ($0.82) returned to Hero
*** SHOWDOWN ***
Hero collected $0.7 from pot
*** SUMMARY ***
Total pot $0.73 | Rake $0.03 | Jackpot $0 | Bingo $0 | Fortune $0
Seat 1: 786d72 folded before Flop (didn't bet)
Seat 2: 2bf0da0a (button) folded before Flop (didn't bet)
Seat 3: 88370224 (small blind) folded before Flop
Seat 4: c86f76e6 (big blind) folded before Flop
Seat 5: a6bde6ad folded before Flop (didn't bet)
Seat 6: Hero collected ($0.7)


Poker Hand #HD1199224584: Hold'em No Limit  ($0.02/$0.05) - 2023/04/11 21:29:48
Table 'NLHBlue32' 6-max Seat #1 is the button
Seat 1: 786d72 ($5.62 in chips)
Seat 2: 2bf0da0a ($5.95 in chips)
Seat 3: 88370224 ($6.72 in chips)
Seat 4: c86f76e6 ($2.56 in chips)
Seat 5: a6bde6ad ($6.84 in chips)
Seat 6: Hero ($9.55 in chips)
2bf0da0a: posts small blind $0.02
88370224: posts big blind $0.05
*** HOLE CARDS ***
Dealt to 786d72 
Dealt to 2bf0da0a 
Dealt to 88370224 
Dealt to c86f76e6 
Dealt to a6bde6ad 
Dealt to Hero [Ah 4c]
c86f76e6: folds
a6bde6ad: folds
Hero: folds
786d72: folds
2bf0da0a: folds
Uncalled bet ($0.03) returned to 88370224
*** SHOWDOWN ***
88370224 collected $0.04 from pot
*** SUMMARY ***
Total pot $0.04 | Rake $0 | Jackpot $0 | Bingo $0 | Fortune $0
Seat 1: 786d72 (button) folded before Flop (didn't bet)
Seat 2: 2bf0da0a (small blind) folded before Flop
Seat 3: 88370224 (big blind) collected ($0.04)
Seat 4: c86f76e6 folded before Flop (didn't bet)
Seat 5: a6bde6ad folded before Flop (didn't bet)
Seat 6: Hero folded before Flop (didn't bet)


Poker Hand #HD1199224546: Hold'em No Limit  ($0.02/$0.05) - 2023/04/11 21:29:32
Table 'NLHBlue32' 6-max Seat #6 is the button
Seat 1: 786d72 ($5.64 in chips)
Seat 2: 2bf0da0a ($6 in chips)
Seat 3: 88370224 ($6.72 in chips)
Seat 4: c86f76e6 ($2.56 in chips)
Seat 5: a6bde6ad ($6.77 in chips)
Seat 6: Hero ($9.55 in chips)
786d72: posts small blind $0.02
2bf0da0a: posts big blind $0.05
*** HOLE CARDS ***
Dealt to 786d72 
Dealt to 2bf0da0a 
Dealt to 88370224 
Dealt to c86f76e6 
Dealt to a6bde6ad 
Dealt to Hero [4s Ah]
88370224: folds
c86f76e6: folds
a6bde6ad: raises $0.08 to $0.13
Hero: folds
786d72: folds
2bf0da0a: folds
Uncalled bet ($0.08) returned to a6bde6ad
*** SHOWDOWN ***
a6bde6ad collected $0.12 from pot
*** SUMMARY ***
Total pot $0.12 | Rake $0 | Jackpot $0 | Bingo $0 | Fortune $0
Seat 1: 786d72 (small blind) folded before Flop
Seat 2: 2bf0da0a (big blind) folded before Flop
Seat 3: 88370224 folded before Flop (didn't bet)
Seat 4: c86f76e6 folded before Flop (didn't bet)
Seat 5: a6bde6ad collected ($0.12)
Seat 6: Hero (button) folded before Flop (didn't bet)


Poker Hand #HD1199224447: Hold'em No Limit  ($0.02/$0.05) - 2023/04/11 21:28:43
Table 'NLHBlue32' 6-max Seat #5 is the button
Seat 1: 786d72 ($5.69 in chips)
Seat 2: 2bf0da0a ($5.18 in chips)
Seat 3: 88370224 ($6.72 in chips)
Seat 4: c86f76e6 ($3.44 in chips)
Seat 5: a6bde6ad ($6.77 in chips)
Seat 6: Hero ($9.57 in chips)
Hero: posts small blind $0.02
786d72: posts big blind $0.05
*** HOLE CARDS ***
Dealt to 786d72 
Dealt to 2bf0da0a 
Dealt to 88370224 
Dealt to c86f76e6 
Dealt to a6bde6ad 
Dealt to Hero [Ac 6c]
2bf0da0a: raises $0.08 to $0.13
88370224: folds
c86f76e6: calls $0.13
a6bde6ad: folds
Hero: folds
786d72: folds
*** FLOP *** [9d 6h 8h]
2bf0da0a: bets $0.2
c86f76e6: calls $0.2
*** TURN *** [9d 6h 8h] [Qd]
2bf0da0a: checks
c86f76e6: bets $0.55
2bf0da0a: calls $0.55
*** RIVER *** [9d 6h 8h Qd] [Qs]
2bf0da0a: checks
c86f76e6: checks
2bf0da0a: shows [Jh Jc] (Pair of Queens and Pair of Jacks)
c86f76e6: shows [6s 5s] (Pair of Queens and Pair of Sixes)
*** SHOWDOWN ***
2bf0da0a collected $1.7 from pot
*** SUMMARY ***
Total pot $1.83 | Rake $0.08 | Jackpot $0.05 | Bingo $0 | Fortune $0
Board [9d 6h 8h Qd Qs]
Seat 1: 786d72 (big blind) folded before Flop
Seat 2: 2bf0da0a showed [Jh Jc] and won ($1.7) with Pair of Queens and Pair of Jacks
Seat 3: 88370224 folded before Flop (didn't bet)
Seat 4: c86f76e6 showed [6s 5s] and lost with Pair of Queens and Pair of Sixes
Seat 5: a6bde6ad (button) folded before Flop (didn't bet)
Seat 6: Hero (small blind) folded before Flop


Poker Hand #HD1199224428: Hold'em No Limit  ($0.02/$0.05) - 2023/04/11 21:28:36
Table 'NLHBlue32' 6-max Seat #4 is the button
Seat 1: 786d72 ($5.69 in chips)
Seat 2: 2bf0da0a ($5.18 in chips)
Seat 3: 88370224 ($6.72 in chips)
Seat 4: c86f76e6 ($3.44 in chips)
Seat 5: a6bde6ad ($6.79 in chips)
Seat 6: Hero ($9.55 in chips)
a6bde6ad: posts small blind $0.02
Hero: posts big blind $0.05
*** HOLE CARDS ***
Dealt to 786d72 
Dealt to 2bf0da0a 
Dealt to 88370224 
Dealt to c86f76e6 
Dealt to a6bde6ad 
Dealt to Hero [Kc 9h]
786d72: folds
2bf0da0a: folds
88370224: folds
c86f76e6: folds
a6bde6ad: folds
Uncalled bet ($0.03) returned to Hero
*** SHOWDOWN ***
Hero collected $0.04 from pot
*** SUMMARY ***
Total pot $0.04 | Rake $0 | Jackpot $0 | Bingo $0 | Fortune $0
Seat 1: 786d72 folded before Flop (didn't bet)
Seat 2: 2bf0da0a folded before Flop (didn't bet)
Seat 3: 88370224 folded before Flop (didn't bet)
Seat 4: c86f76e6 (button) folded before Flop (didn't bet)
Seat 5: a6bde6ad (small blind) folded before Flop
Seat 6: Hero (big blind) collected ($0.04)


Poker Hand #HD1199224397: Hold'em No Limit  ($0.02/$0.05) - 2023/04/11 21:28:22
Table 'NLHBlue32' 6-max Seat #3 is the button
Seat 1: 786d72 ($5.62 in chips)
Seat 2: 2bf0da0a ($5.18 in chips)
Seat 3: 88370224 ($6.72 in chips)
Seat 4: c86f76e6 ($3.46 in chips)
Seat 5: a6bde6ad ($6.84 in chips)
Seat 6: Hero ($9.55 in chips)
c86f76e6: posts small blind $0.02
a6bde6ad: posts big blind $0.05
*** HOLE CARDS ***
Dealt to 786d72 
Dealt to 2bf0da0a 
Dealt to 88370224 
Dealt to c86f76e6 
Dealt to a6bde6ad 
Dealt to Hero [9d 6h]
Hero: folds
786d72: raises $0.08 to $0.13
2bf0da0a: folds
88370224: folds
c86f76e6: folds
a6bde6ad: folds
Uncalled bet ($0.08) returned to 786d72
*** SHOWDOWN ***
786d72 collected $0.12 from pot
*** SUMMARY ***
Total pot $0.12 | Rake $0 | Jackpot $0 | Bingo $0 | Fortune $0
Seat 1: 786d72 collected ($0.12)
Seat 2: 2bf0da0a folded before Flop (didn't bet)
Seat 3: 88370224 (button) folded before Flop (didn't bet)
Seat 4: c86f76e6 (small blind) folded before Flop
Seat 5: a6bde6ad (big blind) folded before Flop
Seat 6: Hero folded before Flop (didn't bet)


Poker Hand #HD1199224336: Hold'em No Limit  ($0.02/$0.05) - 2023/04/11 21:27:52
Table 'NLHBlue32' 6-max Seat #2 is the button
Seat 1: 786d72 ($5.62 in chips)
Seat 2: 2bf0da0a ($5.18 in chips)
Seat 3: 88370224 ($6.74 in chips)
Seat 4: c86f76e6 ($3.59 in chips)
Seat 5: a6bde6ad ($6.7 in chips)
Seat 6: Hero ($9.55 in chips)
88370224: posts small blind $0.02
c86f76e6: posts big blind $0.05
*** HOLE CARDS ***
Dealt to 786d72 
Dealt to 2bf0da0a 
Dealt to 88370224 
Dealt to c86f76e6 
Dealt to a6bde6ad 
Dealt to Hero [Qd 9h]
a6bde6ad: raises $0.08 to $0.13
Hero: folds
786d72: folds
2bf0da0a: folds
88370224: folds
c86f76e6: calls $0.08
*** FLOP *** [2h 6h Jh]
c86f76e6: checks
a6bde6ad: bets $0.14
c86f76e6: folds
Uncalled bet ($0.14) returned to a6bde6ad
*** SHOWDOWN ***
a6bde6ad collected $0.27 from pot
*** SUMMARY ***
Total pot $0.28 | Rake $0.01 | Jackpot $0 | Bingo $0 | Fortune $0
Board [2h 6h Jh]
Seat 1: 786d72 folded before Flop (didn't bet)
Seat 2: 2bf0da0a (button) folded before Flop (didn't bet)
Seat 3: 88370224 (small blind) folded before Flop
Seat 4: c86f76e6 (big blind) folded on the Flop
Seat 5: a6bde6ad won ($0.27)
Seat 6: Hero folded before Flop (didn't bet)


Poker Hand #HD1199224287: Hold'em No Limit  ($0.02/$0.05) - 2023/04/11 21:27:31
Table 'NLHBlue32' 6-max Seat #1 is the button
Seat 1: 786d72 ($5.62 in chips)
Seat 2: 2bf0da0a ($5 in chips)
Seat 3: 88370224 ($6.79 in chips)
Seat 4: c86f76e6 ($3.73 in chips)
Seat 5: a6bde6ad ($6.7 in chips)
Seat 6: Hero ($9.55 in chips)
2bf0da0a: posts small blind $0.02
88370224: posts big blind $0.05
*** HOLE CARDS ***
Dealt to 786d72 
Dealt to 2bf0da0a 
Dealt to 88370224 
Dealt to c86f76e6 
Dealt to a6bde6ad 
Dealt to Hero [Kh 6d]
c86f76e6: raises $0.09 to $0.14
a6bde6ad: folds
Hero: folds
786d72: folds
2bf0da0a: raises $0.42 to $0.56
88370224: folds
c86f76e6: folds
Uncalled bet ($0.42) returned to 2bf0da0a
*** SHOWDOWN ***
2bf0da0a collected $0.32 from pot
*** SUMMARY ***
Total pot $0.33 | Rake $0.01 | Jackpot $0 | Bingo $0 | Fortune $0
Seat 1: 786d72 (button) folded before Flop (didn't bet)
Seat 2: 2bf0da0a (small blind) collected ($0.32)
Seat 3: 88370224 (big blind) folded before Flop
Seat 4: c86f76e6 folded before Flop
Seat 5: a6bde6ad folded before Flop (didn't bet)
Seat 6: Hero folded before Flop (didn't bet)


Poker Hand #HD1199224257: Hold'em No Limit  ($0.02/$0.05) - 2023/04/11 21:27:14
Table 'NLHBlue32' 6-max Seat #6 is the button
Seat 1: 786d72 ($5.64 in chips)
Seat 2: 2bf0da0a ($5 in chips)
Seat 3: 88370224 ($6.72 in chips)
Seat 4: c86f76e6 ($3.73 in chips)
Seat 5: a6bde6ad ($6.7 in chips)
Seat 6: Hero ($9.55 in chips)
786d72: posts small blind $0.02
2bf0da0a: posts big blind $0.05
*** HOLE CARDS ***
Dealt to 786d72 
Dealt to 2bf0da0a 
Dealt to 88370224 
Dealt to c86f76e6 
Dealt to a6bde6ad 
Dealt to Hero [Jd 4s]
88370224: raises $0.05 to $0.1
c86f76e6: folds
a6bde6ad: folds
Hero: folds
786d72: folds
2bf0da0a: folds
Uncalled bet ($0.05) returned to 88370224
*** SHOWDOWN ***
88370224 collected $0.12 from pot
*** SUMMARY ***
Total pot $0.12 | Rake $0 | Jackpot $0 | Bingo $0 | Fortune $0
Seat 1: 786d72 (small blind) folded before Flop
Seat 2: 2bf0da0a (big blind) folded before Flop
Seat 3: 88370224 collected ($0.12)
Seat 4: c86f76e6 folded before Flop (didn't bet)
Seat 5: a6bde6ad folded before Flop (didn't bet)
Seat 6: Hero (button) folded before Flop (didn't bet)


Poker Hand #HD1199224208: Hold'em No Limit  ($0.02/$0.05) - 2023/04/11 21:26:52
Table 'NLHBlue32' 6-max Seat #5 is the button
Seat 1: 786d72 ($5.69 in chips)
Seat 2: 2bf0da0a ($5 in chips)
Seat 3: 88370224 ($6.72 in chips)
Seat 4: c86f76e6 ($3.66 in chips)
Seat 5: a6bde6ad ($6.7 in chips)
Seat 6: Hero ($9.57 in chips)
Hero: posts small blind $0.02
786d72: posts big blind $0.05
*** HOLE CARDS ***
Dealt to 786d72 
Dealt to 2bf0da0a 
Dealt to 88370224 
Dealt to c86f76e6 
Dealt to a6bde6ad 
Dealt to Hero [7c Ks]
2bf0da0a: folds
88370224: folds
c86f76e6: raises $0.09 to $0.14
a6bde6ad: folds
Hero: folds
786d72: folds
Uncalled bet ($0.09) returned to c86f76e6
*** SHOWDOWN ***
c86f76e6 collected $0.12 from pot
*** SUMMARY ***
Total pot $0.12 | Rake $0 | Jackpot $0 | Bingo $0 | Fortune $0
Seat 1: 786d72 (big blind) folded before Flop
Seat 2: 2bf0da0a folded before Flop (didn't bet)
Seat 3: 88370224 folded before Flop (didn't bet)
Seat 4: c86f76e6 collected ($0.12)
Seat 5: a6bde6ad (button) folded before Flop (didn't bet)
Seat 6: Hero (small blind) folded before Flop


Poker Hand #HD1199224176: Hold'em No Limit  ($0.02/$0.05) - 2023/04/11 21:26:33
Table 'NLHBlue32' 6-max Seat #4 is the button
Seat 1: 786d72 ($5.69 in chips)
Seat 2: 2bf0da0a ($5 in chips)
Seat 3: 88370224 ($6.72 in chips)
Seat 4: c86f76e6 ($3.66 in chips)
Seat 5: a6bde6ad ($6.65 in chips)
Seat 6: Hero ($9.62 in chips)
a6bde6ad: posts small blind $0.02
Hero: posts big blind $0.05
*** HOLE CARDS ***
Dealt to 786d72 
Dealt to 2bf0da0a 
Dealt to 88370224 
Dealt to c86f76e6 
Dealt to a6bde6ad 
Dealt to Hero [9d 6h]
786d72: folds
2bf0da0a: folds
88370224: folds
c86f76e6: folds
a6bde6ad: raises $0.08 to $0.13
Hero: folds
Uncalled bet ($0.08) returned to a6bde6ad
*** SHOWDOWN ***
a6bde6ad collected $0.1 from pot
*** SUMMARY ***
Total pot $0.1 | Rake $0 | Jackpot $0 | Bingo $0 | Fortune $0
Seat 1: 786d72 folded before Flop (didn't bet)
Seat 2: 2bf0da0a folded before Flop (didn't bet)
Seat 3: 88370224 folded before Flop (didn't bet)
Seat 4: c86f76e6 (button) folded before Flop (didn't bet)
Seat 5: a6bde6ad (small blind) collected ($0.1)
Seat 6: Hero (big blind) folded before Flop


Poker Hand #HD1199224151: Hold'em No Limit  ($0.02/$0.05) - 2023/04/11 21:26:22
Table 'NLHBlue32' 6-max Seat #3 is the button
Seat 1: 786d72 ($5.69 in chips)
Seat 2: 2bf0da0a ($5 in chips)
Seat 3: 88370224 ($6.72 in chips)
Seat 4: c86f76e6 ($3.68 in chips)
Seat 5: a6bde6ad ($6.7 in chips)
Seat 6: Hero ($9.55 in chips)
c86f76e6: posts small blind $0.02
a6bde6ad: posts big blind $0.05
*** HOLE CARDS ***
Dealt to 786d72 
Dealt to 2bf0da0a 
Dealt to 88370224 
Dealt to c86f76e6 
Dealt to a6bde6ad 
Dealt to Hero [6h Ah]
Hero: raises $0.07 to $0.12
786d72: folds
2bf0da0a: folds
88370224: folds
c86f76e6: folds
a6bde6ad: folds
Uncalled bet ($0.07) returned to Hero
*** SHOWDOWN ***
Hero collected $0.12 from pot
*** SUMMARY ***
Total pot $0.12 | Rake $0 | Jackpot $0 | Bingo $0 | Fortune $0
Seat 1: 786d72 folded before Flop (didn't bet)
Seat 2: 2bf0da0a folded before Flop (didn't bet)
Seat 3: 88370224 (button) folded before Flop (didn't bet)
Seat 4: c86f76e6 (small blind) folded before Flop
Seat 5: a6bde6ad (big blind) folded before Flop
Seat 6: Hero collected ($0.12)


Poker Hand #HD1199224089: Hold'em No Limit  ($0.02/$0.05) - 2023/04/11 21:25:54
Table 'NLHBlue32' 6-max Seat #2 is the button
Seat 1: 786d72 ($5.23 in chips)
Seat 2: 2bf0da0a ($5 in chips)
Seat 3: 88370224 ($6.74 in chips)
Seat 4: c86f76e6 ($3.73 in chips)
Seat 5: a6bde6ad ($6.7 in chips)
Seat 6: Hero ($9.55 in chips)
88370224: posts small blind $0.02
c86f76e6: posts big blind $0.05
*** HOLE CARDS ***
Dealt to 786d72 
Dealt to 2bf0da0a 
Dealt to 88370224 
Dealt to c86f76e6 
Dealt to a6bde6ad 
Dealt to Hero [Kh 7s]
a6bde6ad: folds
Hero: folds
786d72: raises $0.08 to $0.13
2bf0da0a: raises $0.3 to $0.43
88370224: folds
c86f76e6: folds
786d72: raises $0.51 to $0.94
2bf0da0a: folds
Uncalled bet ($0.51) returned to 786d72
*** SHOWDOWN ***
786d72 collected $0.89 from pot
*** SUMMARY ***
Total pot $0.93 | Rake $0.04 | Jackpot $0 | Bingo $0 | Fortune $0
Seat 1: 786d72 collected ($0.89)
Seat 2: 2bf0da0a (button) folded before Flop
Seat 3: 88370224 (small blind) folded before Flop
Seat 4: c86f76e6 (big blind) folded before Flop
Seat 5: a6bde6ad folded before Flop (didn't bet)
Seat 6: Hero folded before Flop (didn't bet)


Poker Hand #HD1199224049: Hold'em No Limit  ($0.02/$0.05) - 2023/04/11 21:25:34
Table 'NLHBlue32' 6-max Seat #1 is the button
Seat 1: 786d72 ($5.23 in chips)
Seat 2: 2bf0da0a ($5 in chips)
Seat 3: 88370224 ($6.79 in chips)
Seat 4: c86f76e6 ($3.66 in chips)
Seat 5: a6bde6ad ($6.7 in chips)
Seat 6: Hero ($9.55 in chips)
2bf0da0a: posts small blind $0.02
88370224: posts big blind $0.05
*** HOLE CARDS ***
Dealt to 786d72 
Dealt to 2bf0da0a 
Dealt to 88370224 
Dealt to c86f76e6 
Dealt to a6bde6ad 
Dealt to Hero [9s 2s]
c86f76e6: raises $0.09 to $0.14
a6bde6ad: folds
Hero: folds
786d72: folds
2bf0da0a: folds
88370224: folds
Uncalled bet ($0.09) returned to c86f76e6
*** SHOWDOWN ***
c86f76e6 collected $0.12 from pot
*** SUMMARY ***
Total pot $0.12 | Rake $0 | Jackpot $0 | Bingo $0 | Fortune $0
Seat 1: 786d72 (button) folded before Flop (didn't bet)
Seat 2: 2bf0da0a (small blind) folded before Flop
Seat 3: 88370224 (big blind) folded before Flop
Seat 4: c86f76e6 collected ($0.12)
Seat 5: a6bde6ad folded before Flop (didn't bet)
Seat 6: Hero folded before Flop (didn't bet)


Poker Hand #HD1199224019: Hold'em No Limit  ($0.02/$0.05) - 2023/04/11 21:25:16
Table 'NLHBlue32' 6-max Seat #6 is the button
Seat 1: 786d72 ($5.25 in chips)
Seat 2: 2bf0da0a ($5 in chips)
Seat 3: 88370224 ($6.79 in chips)
Seat 4: c86f76e6 ($3.66 in chips)
Seat 5: a6bde6ad ($6.63 in chips)
Seat 6: Hero ($9.55 in chips)
786d72: posts small blind $0.02
2bf0da0a: posts big blind $0.05
*** HOLE CARDS ***
Dealt to 786d72 
Dealt to 2bf0da0a 
Dealt to 88370224 
Dealt to c86f76e6 
Dealt to a6bde6ad 
Dealt to Hero [Qd 6s]
88370224: folds
c86f76e6: folds
a6bde6ad: raises $0.08 to $0.13
Hero: folds
786d72: folds
2bf0da0a: folds
Uncalled bet ($0.08) returned to a6bde6ad
*** SHOWDOWN ***
a6bde6ad collected $0.12 from pot
*** SUMMARY ***
Total pot $0.12 | Rake $0 | Jackpot $0 | Bingo $0 | Fortune $0
Seat 1: 786d72 (small blind) folded before Flop
Seat 2: 2bf0da0a (big blind) folded before Flop
Seat 3: 88370224 folded before Flop (didn't bet)
Seat 4: c86f76e6 folded before Flop (didn't bet)
Seat 5: a6bde6ad collected ($0.12)
Seat 6: Hero (button) folded before Flop (didn't bet)


Poker Hand #HD1199224001: Hold'em No Limit  ($0.02/$0.05) - 2023/04/11 21:25:06
Table 'NLHBlue32' 6-max Seat #5 is the button
Seat 1: 786d72 ($5.23 in chips)
Seat 2: 2bf0da0a ($5 in chips)
Seat 3: 88370224 ($6.79 in chips)
Seat 4: c86f76e6 ($3.66 in chips)
Seat 5: a6bde6ad ($6.63 in chips)
Seat 6: Hero ($9.57 in chips)
Hero: posts small blind $0.02
786d72: posts big blind $0.05
*** HOLE CARDS ***
Dealt to 786d72 
Dealt to 2bf0da0a 
Dealt to 88370224 
Dealt to c86f76e6 
Dealt to a6bde6ad 
Dealt to Hero [3h Tc]
2bf0da0a: folds
88370224: folds
c86f76e6: folds
a6bde6ad: folds
Hero: folds
Uncalled bet ($0.03) returned to 786d72
*** SHOWDOWN ***
786d72 collected $0.04 from pot
*** SUMMARY ***
Total pot $0.04 | Rake $0 | Jackpot $0 | Bingo $0 | Fortune $0
Seat 1: 786d72 (big blind) collected ($0.04)
Seat 2: 2bf0da0a folded before Flop (didn't bet)
Seat 3: 88370224 folded before Flop (didn't bet)
Seat 4: c86f76e6 folded before Flop (didn't bet)
Seat 5: a6bde6ad (button) folded before Flop (didn't bet)
Seat 6: Hero (small blind) folded before Flop


Poker Hand #HD1199223910: Hold'em No Limit  ($0.02/$0.05) - 2023/04/11 21:24:24
Table 'NLHBlue32' 6-max Seat #4 is the button
Seat 1: 786d72 ($5.23 in chips)
Seat 2: 2bf0da0a ($5 in chips)
Seat 3: 88370224 ($6.68 in chips)
Seat 4: c86f76e6 ($3.66 in chips)
Seat 5: a6bde6ad ($6.65 in chips)
Seat 6: Hero ($9.67 in chips)
a6bde6ad: posts small blind $0.02
Hero: posts big blind $0.05
*** HOLE CARDS ***
Dealt to 786d72 
Dealt to 2bf0da0a 
Dealt to 88370224 
Dealt to c86f76e6 
Dealt to a6bde6ad 
Dealt to Hero [3s Ks]
786d72: folds
2bf0da0a: folds
88370224: raises $0.05 to $0.1
c86f76e6: folds
a6bde6ad: folds
Hero: calls $0.05
*** FLOP *** [3c 6d 7h]
Hero: checks
88370224: bets $0.17
Hero: folds
Uncalled bet ($0.17) returned to 88370224
*** SHOWDOWN ***
88370224 collected $0.21 from pot
*** SUMMARY ***
Total pot $0.22 | Rake $0.01 | Jackpot $0 | Bingo $0 | Fortune $0
Board [3c 6d 7h]
Seat 1: 786d72 folded before Flop (didn't bet)
Seat 2: 2bf0da0a folded before Flop (didn't bet)
Seat 3: 88370224 won ($0.21)
Seat 4: c86f76e6 (button) folded before Flop (didn't bet)
Seat 5: a6bde6ad (small blind) folded before Flop
Seat 6: Hero (big blind) folded on the Flop


Poker Hand #HD1199223886: Hold'em No Limit  ($0.02/$0.05) - 2023/04/11 21:24:15
Table 'NLHBlue32' 6-max Seat #3 is the button
Seat 1: 786d72 ($5.23 in chips)
Seat 2: 2bf0da0a ($5 in chips)
Seat 3: 88370224 ($6.68 in chips)
Seat 4: c86f76e6 ($3.68 in chips)
Seat 5: a6bde6ad ($6.63 in chips)
Seat 6: Hero ($9.67 in chips)
c86f76e6: posts small blind $0.02
a6bde6ad: posts big blind $0.05
*** HOLE CARDS ***
Dealt to 786d72 
Dealt to 2bf0da0a 
Dealt to 88370224 
Dealt to c86f76e6 
Dealt to a6bde6ad 
Dealt to Hero [6s Ac]
Hero: folds
786d72: folds
2bf0da0a: folds
88370224: folds
c86f76e6: folds
Uncalled bet ($0.03) returned to a6bde6ad
*** SHOWDOWN ***
a6bde6ad collected $0.04 from pot
*** SUMMARY ***
Total pot $0.04 | Rake $0 | Jackpot $0 | Bingo $0 | Fortune $0
Seat 1: 786d72 folded before Flop (didn't bet)
Seat 2: 2bf0da0a folded before Flop (didn't bet)
Seat 3: 88370224 (button) folded before Flop (didn't bet)
Seat 4: c86f76e6 (small blind) folded before Flop
Seat 5: a6bde6ad (big blind) collected ($0.04)
Seat 6: Hero folded before Flop (didn't bet)


Poker Hand #HD1199223805: Hold'em No Limit  ($0.02/$0.05) - 2023/04/11 21:23:33
Table 'NLHBlue32' 6-max Seat #2 is the button
Seat 1: 786d72 ($5.23 in chips)
Seat 2: 2bf0da0a ($5 in chips)
Seat 3: 88370224 ($6.78 in chips)
Seat 4: c86f76e6 ($3.59 in chips)
Seat 5: a6bde6ad ($6.63 in chips)
Seat 6: Hero ($9.67 in chips)
88370224: posts small blind $0.02
c86f76e6: posts big blind $0.05
*** HOLE CARDS ***
Dealt to 786d72 
Dealt to 2bf0da0a 
Dealt to 88370224 
Dealt to c86f76e6 
Dealt to a6bde6ad 
Dealt to Hero [2s Qh]
a6bde6ad: folds
Hero: folds
786d72: folds
2bf0da0a: folds
88370224: raises $0.05 to $0.1
c86f76e6: raises $0.16 to $0.26
88370224: folds
Uncalled bet ($0.16) returned to c86f76e6
*** SHOWDOWN ***
c86f76e6 collected $0.19 from pot
*** SUMMARY ***
Total pot $0.2 | Rake $0.01 | Jackpot $0 | Bingo $0 | Fortune $0
Seat 1: 786d72 folded before Flop (didn't bet)
Seat 2: 2bf0da0a (button) folded before Flop (didn't bet)
Seat 3: 88370224 (small blind) folded before Flop
Seat 4: c86f76e6 (big blind) collected ($0.19)
Seat 5: a6bde6ad folded before Flop (didn't bet)
Seat 6: Hero folded before Flop (didn't bet)


Poker Hand #HD1199223756: Hold'em No Limit  ($0.02/$0.05) - 2023/04/11 21:23:12
Table 'NLHBlue32' 6-max Seat #1 is the button
Seat 1: 786d72 ($5.16 in chips)
Seat 2: 2bf0da0a ($5.02 in chips)
Seat 3: 88370224 ($6.83 in chips)
Seat 4: c86f76e6 ($3.59 in chips)
Seat 5: a6bde6ad ($6.63 in chips)
Seat 6: Hero ($9.67 in chips)
2bf0da0a: posts small blind $0.02
88370224: posts big blind $0.05
*** HOLE CARDS ***
Dealt to 786d72 
Dealt to 2bf0da0a 
Dealt to 88370224 
Dealt to c86f76e6 
Dealt to a6bde6ad 
Dealt to Hero [5d Js]
c86f76e6: folds
a6bde6ad: folds
Hero: folds
786d72: raises $0.08 to $0.13
2bf0da0a: folds
88370224: folds
Uncalled bet ($0.08) returned to 786d72
*** SHOWDOWN ***
786d72 collected $0.12 from pot
*** SUMMARY ***
Total pot $0.12 | Rake $0 | Jackpot $0 | Bingo $0 | Fortune $0
Seat 1: 786d72 (button) collected ($0.12)
Seat 2: 2bf0da0a (small blind) folded before Flop
Seat 3: 88370224 (big blind) folded before Flop
Seat 4: c86f76e6 folded before Flop (didn't bet)
Seat 5: a6bde6ad folded before Flop (didn't bet)
Seat 6: Hero folded before Flop (didn't bet)


Poker Hand #HD1199223740: Hold'em No Limit  ($0.02/$0.05) - 2023/04/11 21:23:01
Table 'NLHBlue32' 6-max Seat #6 is the button
Seat 1: 786d72 ($5.18 in chips)
Seat 2: 2bf0da0a ($5 in chips)
Seat 3: 88370224 ($6.83 in chips)
Seat 4: c86f76e6 ($3.59 in chips)
Seat 5: a6bde6ad ($6.63 in chips)
Seat 6: Hero ($9.67 in chips)
786d72: posts small blind $0.02
2bf0da0a: posts big blind $0.05
*** HOLE CARDS ***
Dealt to 786d72 
Dealt to 2bf0da0a 
Dealt to 88370224 
Dealt to c86f76e6 
Dealt to a6bde6ad 
Dealt to Hero [5h 7d]
88370224: folds
c86f76e6: folds
a6bde6ad: folds
Hero: folds
786d72: folds
Uncalled bet ($0.03) returned to 2bf0da0a
*** SHOWDOWN ***
2bf0da0a collected $0.04 from pot
*** SUMMARY ***
Total pot $0.04 | Rake $0 | Jackpot $0 | Bingo $0 | Fortune $0
Seat 1: 786d72 (small blind) folded before Flop
Seat 2: 2bf0da0a (big blind) collected ($0.04)
Seat 3: 88370224 folded before Flop (didn't bet)
Seat 4: c86f76e6 folded before Flop (didn't bet)
Seat 5: a6bde6ad folded before Flop (didn't bet)
Seat 6: Hero (button) folded before Flop (didn't bet)


Poker Hand #HD1199223639: Hold'em No Limit  ($0.02/$0.05) - 2023/04/11 21:22:04
Table 'NLHBlue32' 6-max Seat #5 is the button
Seat 1: 786d72 ($5.07 in chips)
Seat 2: 2bf0da0a ($5 in chips)
Seat 3: 88370224 ($6.93 in chips)
Seat 4: c86f76e6 ($3.59 in chips)
Seat 5: a6bde6ad ($6.63 in chips)
Seat 6: Hero ($9.69 in chips)
Hero: posts small blind $0.02
786d72: posts big blind $0.05
*** HOLE CARDS ***
Dealt to 786d72 
Dealt to 2bf0da0a 
Dealt to 88370224 
Dealt to c86f76e6 
Dealt to a6bde6ad 
Dealt to Hero [Tc 4h]
2bf0da0a: folds
88370224: raises $0.05 to $0.1
c86f76e6: folds
a6bde6ad: folds
Hero: folds
786d72: calls $0.05
*** FLOP *** [7h 6c 4c]
786d72: checks
88370224: checks
*** TURN *** [7h 6c 4c] [9h]
786d72: bets $0.17
88370224: folds
Uncalled bet ($0.17) returned to 786d72
*** SHOWDOWN ***
786d72 collected $0.21 from pot
*** SUMMARY ***
Total pot $0.22 | Rake $0.01 | Jackpot $0 | Bingo $0 | Fortune $0
Board [7h 6c 4c 9h]
Seat 1: 786d72 (big blind) won ($0.21)
Seat 2: 2bf0da0a folded before Flop (didn't bet)
Seat 3: 88370224 folded on the Turn
Seat 4: c86f76e6 folded before Flop (didn't bet)
Seat 5: a6bde6ad (button) folded before Flop (didn't bet)
Seat 6: Hero (small blind) folded before Flop


Poker Hand #HD1199223615: Hold'em No Limit  ($0.02/$0.05) - 2023/04/11 21:21:55
Table 'NLHBlue32' 6-max Seat #4 is the button
Seat 1: 786d72 ($5.07 in chips)
Seat 2: 2bf0da0a ($5 in chips)
Seat 3: 88370224 ($6.93 in chips)
Seat 4: c86f76e6 ($3.59 in chips)
Seat 5: a6bde6ad ($6.65 in chips)
Seat 6: Hero ($9.67 in chips)
a6bde6ad: posts small blind $0.02
Hero: posts big blind $0.05
*** HOLE CARDS ***
Dealt to 786d72 
Dealt to 2bf0da0a 
Dealt to 88370224 
Dealt to c86f76e6 
Dealt to a6bde6ad 
Dealt to Hero [6s Kh]
786d72: folds
2bf0da0a: folds
88370224: folds
c86f76e6: folds
a6bde6ad: folds
Uncalled bet ($0.03) returned to Hero
*** SHOWDOWN ***
Hero collected $0.04 from pot
*** SUMMARY ***
Total pot $0.04 | Rake $0 | Jackpot $0 | Bingo $0 | Fortune $0
Seat 1: 786d72 folded before Flop (didn't bet)
Seat 2: 2bf0da0a folded before Flop (didn't bet)
Seat 3: 88370224 folded before Flop (didn't bet)
Seat 4: c86f76e6 (button) folded before Flop (didn't bet)
Seat 5: a6bde6ad (small blind) folded before Flop
Seat 6: Hero (big blind) collected ($0.04)


Poker Hand #HD1199223595: Hold'em No Limit  ($0.02/$0.05) - 2023/04/11 21:21:44
Table 'NLHBlue32' 6-max Seat #3 is the button
Seat 1: 786d72 ($5 in chips)
Seat 2: 2bf0da0a ($5 in chips)
Seat 3: 88370224 ($6.93 in chips)
Seat 4: c86f76e6 ($3.61 in chips)
Seat 5: a6bde6ad ($6.7 in chips)
Seat 6: Hero ($9.67 in chips)
c86f76e6: posts small blind $0.02
a6bde6ad: posts big blind $0.05
*** HOLE CARDS ***
Dealt to 786d72 
Dealt to 2bf0da0a 
Dealt to 88370224 
Dealt to c86f76e6 
Dealt to a6bde6ad 
Dealt to Hero [7d Js]
Hero: folds
786d72: raises $0.08 to $0.13
2bf0da0a: folds
88370224: folds
c86f76e6: folds
a6bde6ad: folds
Uncalled bet ($0.08) returned to 786d72
*** SHOWDOWN ***
786d72 collected $0.12 from pot
*** SUMMARY ***
Total pot $0.12 | Rake $0 | Jackpot $0 | Bingo $0 | Fortune $0
Seat 1: 786d72 collected ($0.12)
Seat 2: 2bf0da0a folded before Flop (didn't bet)
Seat 3: 88370224 (button) folded before Flop (didn't bet)
Seat 4: c86f76e6 (small blind) folded before Flop
Seat 5: a6bde6ad (big blind) folded before Flop
Seat 6: Hero folded before Flop (didn't bet)


Poker Hand #HD1199223537: Hold'em No Limit  ($0.02/$0.05) - 2023/04/11 21:21:17
Table 'NLHBlue32' 6-max Seat #2 is the button
Seat 1: 786d72 ($5 in chips)
Seat 2: 2bf0da0a ($5 in chips)
Seat 3: 88370224 ($6.95 in chips)
Seat 4: c86f76e6 ($3.47 in chips)
Seat 5: a6bde6ad ($6.7 in chips)
Seat 6: Hero ($9.67 in chips)
88370224: posts small blind $0.02
c86f76e6: posts big blind $0.05
*** HOLE CARDS ***
Dealt to 786d72 
Dealt to 2bf0da0a 
Dealt to 88370224 
Dealt to c86f76e6 
Dealt to a6bde6ad 
Dealt to Hero [Td 2s]
a6bde6ad: folds
Hero: folds
786d72: raises $0.08 to $0.13
2bf0da0a: folds
88370224: folds
c86f76e6: raises $0.33 to $0.46
786d72: folds
Uncalled bet ($0.33) returned to c86f76e6
*** SHOWDOWN ***
c86f76e6 collected $0.27 from pot
*** SUMMARY ***
Total pot $0.28 | Rake $0.01 | Jackpot $0 | Bingo $0 | Fortune $0
Seat 1: 786d72 folded before Flop
Seat 2: 2bf0da0a (button) folded before Flop (didn't bet)
Seat 3: 88370224 (small blind) folded before Flop
Seat 4: c86f76e6 (big blind) collected ($0.27)
Seat 5: a6bde6ad folded before Flop (didn't bet)
Seat 6: Hero folded before Flop (didn't bet)


Poker Hand #HD1199223504: Hold'em No Limit  ($0.02/$0.05) - 2023/04/11 21:20:58
Table 'NLHBlue32' 6-max Seat #1 is the button
Seat 1: 786d72 ($5 in chips)
Seat 2: 2bf0da0a ($5.02 in chips)
Seat 3: 88370224 ($7 in chips)
Seat 4: c86f76e6 ($3.47 in chips)
Seat 5: a6bde6ad ($6.63 in chips)
Seat 6: Hero ($9.67 in chips)
2bf0da0a: posts small blind $0.02
88370224: posts big blind $0.05
*** HOLE CARDS ***
Dealt to 786d72 
Dealt to 2bf0da0a 
Dealt to 88370224 
Dealt to c86f76e6 
Dealt to a6bde6ad 
Dealt to Hero [6h 6s]
c86f76e6: folds
a6bde6ad: raises $0.08 to $0.13
Hero: folds
786d72: folds
2bf0da0a: folds
88370224: folds
Uncalled bet ($0.08) returned to a6bde6ad
*** SHOWDOWN ***
a6bde6ad collected $0.12 from pot
*** SUMMARY ***
Total pot $0.12 | Rake $0 | Jackpot $0 | Bingo $0 | Fortune $0
Seat 1: 786d72 (button) folded before Flop (didn't bet)
Seat 2: 2bf0da0a (small blind) folded before Flop
Seat 3: 88370224 (big blind) folded before Flop
Seat 4: c86f76e6 folded before Flop (didn't bet)
Seat 5: a6bde6ad collected ($0.12)
Seat 6: Hero folded before Flop (didn't bet)


Poker Hand #HD1199223459: Hold'em No Limit  ($0.02/$0.05) - 2023/04/11 21:20:37
Table 'NLHBlue32' 6-max Seat #6 is the button
Seat 1: 786d72 ($5 in chips)
Seat 2: 2bf0da0a ($5.07 in chips)
Seat 3: 88370224 ($7 in chips)
Seat 4: c86f76e6 ($3.47 in chips)
Seat 5: a6bde6ad ($6.63 in chips)
Seat 6: Hero ($9.6 in chips)
786d72: posts small blind $0.02
2bf0da0a: posts big blind $0.05
*** HOLE CARDS ***
Dealt to 786d72 
Dealt to 2bf0da0a 
Dealt to 88370224 
Dealt to c86f76e6 
Dealt to a6bde6ad 
Dealt to Hero [9s Ah]
88370224: folds
c86f76e6: folds
a6bde6ad: folds
Hero: raises $0.07 to $0.12
786d72: folds
2bf0da0a: folds
Uncalled bet ($0.07) returned to Hero
*** SHOWDOWN ***
Hero collected $0.12 from pot
*** SUMMARY ***
Total pot $0.12 | Rake $0 | Jackpot $0 | Bingo $0 | Fortune $0
Seat 1: 786d72 (small blind) folded before Flop
Seat 2: 2bf0da0a (big blind) folded before Flop
Seat 3: 88370224 folded before Flop (didn't bet)
Seat 4: c86f76e6 folded before Flop (didn't bet)
Seat 5: a6bde6ad folded before Flop (didn't bet)
Seat 6: Hero (button) collected ($0.12)


Poker Hand #HD1199223388: Hold'em No Limit  ($0.02/$0.05) - 2023/04/11 21:20:02
Table 'NLHBlue32' 6-max Seat #5 is the button
Seat 1: 786d72 ($5 in chips)
Seat 2: 2bf0da0a ($5.07 in chips)
Seat 3: 88370224 ($7 in chips)
Seat 4: c86f76e6 ($3.4 in chips)
Seat 5: a6bde6ad ($6.63 in chips)
Seat 6: Hero ($9.62 in chips)
Hero: posts small blind $0.02
786d72: posts big blind $0.05
*** HOLE CARDS ***
Dealt to 786d72 
Dealt to 2bf0da0a 
Dealt to 88370224 
Dealt to c86f76e6 
Dealt to a6bde6ad 
Dealt to Hero [Th Ad]
2bf0da0a: folds
88370224: folds
c86f76e6: raises $0.09 to $0.14
a6bde6ad: folds
Hero: folds
786d72: folds
Uncalled bet ($0.09) returned to c86f76e6
*** SHOWDOWN ***
c86f76e6 collected $0.12 from pot
*** SUMMARY ***
Total pot $0.12 | Rake $0 | Jackpot $0 | Bingo $0 | Fortune $0
Seat 1: 786d72 (big blind) folded before Flop
Seat 2: 2bf0da0a folded before Flop (didn't bet)
Seat 3: 88370224 folded before Flop (didn't bet)
Seat 4: c86f76e6 collected ($0.12)
Seat 5: a6bde6ad (button) folded before Flop (didn't bet)
Seat 6: Hero (small blind) folded before Flop


Poker Hand #HD1199223356: Hold'em No Limit  ($0.02/$0.05) - 2023/04/11 21:19:43
Table 'NLHBlue32' 6-max Seat #4 is the button
Seat 1: 786d72 ($5 in chips)
Seat 2: 2bf0da0a ($5.07 in chips)
Seat 3: 88370224 ($7 in chips)
Seat 4: c86f76e6 ($3.33 in chips)
Seat 5: a6bde6ad ($6.65 in chips)
Seat 6: Hero ($9.67 in chips)
a6bde6ad: posts small blind $0.02
Hero: posts big blind $0.05
*** HOLE CARDS ***
Dealt to 786d72 
Dealt to 2bf0da0a 
Dealt to 88370224 
Dealt to c86f76e6 
Dealt to a6bde6ad 
Dealt to Hero [6h 8d]
786d72: folds
2bf0da0a: folds
88370224: folds
c86f76e6: raises $0.08 to $0.13
a6bde6ad: folds
Hero: folds
Uncalled bet ($0.08) returned to c86f76e6
*** SHOWDOWN ***
c86f76e6 collected $0.12 from pot
*** SUMMARY ***
Total pot $0.12 | Rake $0 | Jackpot $0 | Bingo $0 | Fortune $0
Seat 1: 786d72 folded before Flop (didn't bet)
Seat 2: 2bf0da0a folded before Flop (didn't bet)
Seat 3: 88370224 folded before Flop (didn't bet)
Seat 4: c86f76e6 (button) collected ($0.12)
Seat 5: a6bde6ad (small blind) folded before Flop
Seat 6: Hero (big blind) folded before Flop


Poker Hand #HD1199223321: Hold'em No Limit  ($0.02/$0.05) - 2023/04/11 21:19:32
Table 'NLHBlue32' 6-max Seat #3 is the button
Seat 1: 786d72 ($5 in chips)
Seat 2: 2bf0da0a ($5 in chips)
Seat 3: 88370224 ($7 in chips)
Seat 4: c86f76e6 ($3.35 in chips)
Seat 5: a6bde6ad ($6.7 in chips)
Seat 6: Hero ($9.67 in chips)
c86f76e6: posts small blind $0.02
a6bde6ad: posts big blind $0.05
*** HOLE CARDS ***
Dealt to 786d72 
Dealt to 2bf0da0a 
Dealt to 88370224 
Dealt to c86f76e6 
Dealt to a6bde6ad 
Dealt to Hero [Tc 4d]
Hero: folds
786d72: folds
2bf0da0a: raises $0.08 to $0.13
88370224: folds
c86f76e6: folds
a6bde6ad: folds
Uncalled bet ($0.08) returned to 2bf0da0a
*** SHOWDOWN ***
2bf0da0a collected $0.12 from pot
*** SUMMARY ***
Total pot $0.12 | Rake $0 | Jackpot $0 | Bingo $0 | Fortune $0
Seat 1: 786d72 folded before Flop (didn't bet)
Seat 2: 2bf0da0a collected ($0.12)
Seat 3: 88370224 (button) folded before Flop (didn't bet)
Seat 4: c86f76e6 (small blind) folded before Flop
Seat 5: a6bde6ad (big blind) folded before Flop
Seat 6: Hero folded before Flop (didn't bet)


Poker Hand #HD1199223291: Hold'em No Limit  ($0.02/$0.05) - 2023/04/11 21:19:17
Table 'NLHBlue32' 6-max Seat #2 is the button
Seat 1: 786d72 ($5 in chips)
Seat 2: 2bf0da0a ($5 in chips)
Seat 3: 88370224 ($6.95 in chips)
Seat 4: c86f76e6 ($3.4 in chips)
Seat 5: a6bde6ad ($6.7 in chips)
Seat 6: Hero ($9.67 in chips)
88370224: posts small blind $0.02
c86f76e6: posts big blind $0.05
*** HOLE CARDS ***
Dealt to 786d72 
Dealt to 2bf0da0a 
Dealt to 88370224 
Dealt to c86f76e6 
Dealt to a6bde6ad 
Dealt to Hero [Jh 4c]
a6bde6ad: folds
Hero: folds
786d72: folds
2bf0da0a: folds
88370224: raises $0.05 to $0.1
c86f76e6: folds
Uncalled bet ($0.05) returned to 88370224
*** SHOWDOWN ***
88370224 collected $0.1 from pot
*** SUMMARY ***
Total pot $0.1 | Rake $0 | Jackpot $0 | Bingo $0 | Fortune $0
Seat 1: 786d72 folded before Flop (didn't bet)
Seat 2: 2bf0da0a (button) folded before Flop (didn't bet)
Seat 3: 88370224 (small blind) collected ($0.1)
Seat 4: c86f76e6 (big blind) folded before Flop
Seat 5: a6bde6ad folded before Flop (didn't bet)
Seat 6: Hero folded before Flop (didn't bet)


Poker Hand #HD1199223267: Hold'em No Limit  ($0.02/$0.05) - 2023/04/11 21:19:04
Table 'NLHBlue32' 6-max Seat #1 is the button
Seat 1: 786d72 ($5 in chips)
Seat 2: 2bf0da0a ($5.02 in chips)
Seat 3: 88370224 ($7 in chips)
Seat 4: c86f76e6 ($3.33 in chips)
Seat 5: a6bde6ad ($6.7 in chips)
Seat 6: Hero ($9.67 in chips)
2bf0da0a: posts small blind $0.02
88370224: posts big blind $0.05
*** HOLE CARDS ***
Dealt to 786d72 
Dealt to 2bf0da0a 
Dealt to 88370224 
Dealt to c86f76e6 
Dealt to a6bde6ad 
Dealt to Hero [5s 8h]
c86f76e6: raises $0.09 to $0.14
a6bde6ad: folds
Hero: folds
786d72: folds
2bf0da0a: folds
88370224: folds
Uncalled bet ($0.09) returned to c86f76e6
*** SHOWDOWN ***
c86f76e6 collected $0.12 from pot
*** SUMMARY ***
Total pot $0.12 | Rake $0 | Jackpot $0 | Bingo $0 | Fortune $0
Seat 1: 786d72 (button) folded before Flop (didn't bet)
Seat 2: 2bf0da0a (small blind) folded before Flop
Seat 3: 88370224 (big blind) folded before Flop
Seat 4: c86f76e6 collected ($0.12)
Seat 5: a6bde6ad folded before Flop (didn't bet)
Seat 6: Hero folded before Flop (didn't bet)


Poker Hand #HD1199223248: Hold'em No Limit  ($0.02/$0.05) - 2023/04/11 21:18:53
Table 'NLHBlue32' 6-max Seat #6 is the button
Seat 1: 786d72 ($5 in chips)
Seat 2: 2bf0da0a ($5.07 in chips)
Seat 3: 88370224 ($7 in chips)
Seat 4: c86f76e6 ($3.33 in chips)
Seat 5: a6bde6ad ($6.7 in chips)
Seat 6: Hero ($9.6 in chips)
786d72: posts small blind $0.02
2bf0da0a: posts big blind $0.05
*** HOLE CARDS ***
Dealt to 786d72 
Dealt to 2bf0da0a 
Dealt to 88370224 
Dealt to c86f76e6 
Dealt to a6bde6ad 
Dealt to Hero [Tc Jh]
88370224: folds
c86f76e6: folds
a6bde6ad: folds
Hero: raises $0.07 to $0.12
786d72: folds
2bf0da0a: folds
Uncalled bet ($0.07) returned to Hero
*** SHOWDOWN ***
Hero collected $0.12 from pot
*** SUMMARY ***
Total pot $0.12 | Rake $0 | Jackpot $0 | Bingo $0 | Fortune $0
Seat 1: 786d72 (small blind) folded before Flop
Seat 2: 2bf0da0a (big blind) folded before Flop
Seat 3: 88370224 folded before Flop (didn't bet)
Seat 4: c86f76e6 folded before Flop (didn't bet)
Seat 5: a6bde6ad folded before Flop (didn't bet)
Seat 6: Hero (button) collected ($0.12)


Poker Hand #HD1199223207: Hold'em No Limit  ($0.02/$0.05) - 2023/04/11 21:18:32
Table 'NLHBlue32' 6-max Seat #5 is the button
Seat 1: 786d72 ($5 in chips)
Seat 2: 2bf0da0a ($5.07 in chips)
Seat 3: 88370224 ($7 in chips)
Seat 4: c86f76e6 ($3.33 in chips)
Seat 5: a6bde6ad ($6.7 in chips)
Seat 6: Hero ($9.47 in chips)
Hero: posts small blind $0.02
786d72: posts big blind $0.05
*** HOLE CARDS ***
Dealt to 786d72 
Dealt to 2bf0da0a 
Dealt to 88370224 
Dealt to c86f76e6 
Dealt to a6bde6ad 
Dealt to Hero [5s Ah]
2bf0da0a: folds
88370224: folds
c86f76e6: folds
a6bde6ad: folds
Hero: raises $0.09 to $0.14
786d72: calls $0.09
*** FLOP *** [Js Kd Kc]
Hero: bets $0.14
786d72: folds
Uncalled bet ($0.14) returned to Hero
*** SHOWDOWN ***
Hero collected $0.27 from pot
*** SUMMARY ***
Total pot $0.28 | Rake $0.01 | Jackpot $0 | Bingo $0 | Fortune $0
Board [Js Kd Kc]
Seat 1: 786d72 (big blind) folded on the Flop
Seat 2: 2bf0da0a folded before Flop (didn't bet)
Seat 3: 88370224 folded before Flop (didn't bet)
Seat 4: c86f76e6 folded before Flop (didn't bet)
Seat 5: a6bde6ad (button) folded before Flop (didn't bet)
Seat 6: Hero (small blind) won ($0.27)


Poker Hand #HD1199223172: Hold'em No Limit  ($0.02/$0.05) - 2023/04/11 21:18:21
Table 'NLHBlue32' 6-max Seat #4 is the button
Seat 1: 786d72 ($5 in chips)
Seat 2: 2bf0da0a ($5.07 in chips)
Seat 3: 88370224 ($7 in chips)
Seat 4: c86f76e6 ($3.26 in chips)
Seat 5: a6bde6ad ($6.72 in chips)
Seat 6: Hero ($9.52 in chips)
a6bde6ad: posts small blind $0.02
Hero: posts big blind $0.05
*** HOLE CARDS ***
Dealt to 786d72 
Dealt to 2bf0da0a 
Dealt to 88370224 
Dealt to c86f76e6 
Dealt to a6bde6ad 
Dealt to Hero [3h 4d]
786d72: folds
2bf0da0a: folds
88370224: folds
c86f76e6: raises $0.08 to $0.13
a6bde6ad: folds
Hero: folds
Uncalled bet ($0.08) returned to c86f76e6
*** SHOWDOWN ***
c86f76e6 collected $0.12 from pot
*** SUMMARY ***
Total pot $0.12 | Rake $0 | Jackpot $0 | Bingo $0 | Fortune $0
Seat 1: 786d72 folded before Flop (didn't bet)
Seat 2: 2bf0da0a folded before Flop (didn't bet)
Seat 3: 88370224 folded before Flop (didn't bet)
Seat 4: c86f76e6 (button) collected ($0.12)
Seat 5: a6bde6ad (small blind) folded before Flop
Seat 6: Hero (big blind) folded before Flop


Poker Hand #HD1199223154: Hold'em No Limit  ($0.02/$0.05) - 2023/04/11 21:18:10
Table 'NLHBlue32' 6-max Seat #3 is the button
Seat 1: 786d72 ($5 in chips)
Seat 2: 2bf0da0a ($5.07 in chips)
Seat 3: 88370224 ($7 in chips)
Seat 4: c86f76e6 ($3.28 in chips)
Seat 5: a6bde6ad ($6.7 in chips)
Seat 6: Hero ($9.52 in chips)
c86f76e6: posts small blind $0.02
a6bde6ad: posts big blind $0.05
*** HOLE CARDS ***
Dealt to 786d72 
Dealt to 2bf0da0a 
Dealt to 88370224 
Dealt to c86f76e6 
Dealt to a6bde6ad 
Dealt to Hero [Ts 6h]
Hero: folds
786d72: folds
2bf0da0a: folds
88370224: folds
c86f76e6: folds
Uncalled bet ($0.03) returned to a6bde6ad
*** SHOWDOWN ***
a6bde6ad collected $0.04 from pot
*** SUMMARY ***
Total pot $0.04 | Rake $0 | Jackpot $0 | Bingo $0 | Fortune $0
Seat 1: 786d72 folded before Flop (didn't bet)
Seat 2: 2bf0da0a folded before Flop (didn't bet)
Seat 3: 88370224 (button) folded before Flop (didn't bet)
Seat 4: c86f76e6 (small blind) folded before Flop
Seat 5: a6bde6ad (big blind) collected ($0.04)
Seat 6: Hero folded before Flop (didn't bet)


Poker Hand #HD1199223131: Hold'em No Limit  ($0.02/$0.05) - 2023/04/11 21:17:57
Table 'NLHBlue32' 6-max Seat #2 is the button
Seat 1: 786d72 ($5 in chips)
Seat 2: 2bf0da0a ($5.07 in chips)
Seat 3: 88370224 ($6.95 in chips)
Seat 4: c86f76e6 ($3.33 in chips)
Seat 5: a6bde6ad ($6.7 in chips)
Seat 6: Hero ($9.52 in chips)
88370224: posts small blind $0.02
c86f76e6: posts big blind $0.05
*** HOLE CARDS ***
Dealt to 786d72 
Dealt to 2bf0da0a 
Dealt to 88370224 
Dealt to c86f76e6 
Dealt to a6bde6ad 
Dealt to Hero [6d Jh]
a6bde6ad: folds
Hero: folds
786d72: folds
2bf0da0a: folds
88370224: raises $0.05 to $0.1
c86f76e6: folds
Uncalled bet ($0.05) returned to 88370224
*** SHOWDOWN ***
88370224 collected $0.1 from pot
*** SUMMARY ***
Total pot $0.1 | Rake $0 | Jackpot $0 | Bingo $0 | Fortune $0
Seat 1: 786d72 folded before Flop (didn't bet)
Seat 2: 2bf0da0a (button) folded before Flop (didn't bet)
Seat 3: 88370224 (small blind) collected ($0.1)
Seat 4: c86f76e6 (big blind) folded before Flop
Seat 5: a6bde6ad folded before Flop (didn't bet)
Seat 6: Hero folded before Flop (didn't bet)


Poker Hand #HD1199223102: Hold'em No Limit  ($0.02/$0.05) - 2023/04/11 21:17:44
Table 'NLHBlue32' 6-max Seat #1 is the button
Seat 1: 786d72 ($5 in chips)
Seat 2: 2bf0da0a ($5.02 in chips)
Seat 3: 88370224 ($7 in chips)
Seat 4: c86f76e6 ($3.33 in chips)
Seat 5: a6bde6ad ($6.7 in chips)
Seat 6: Hero ($9.52 in chips)
2bf0da0a: posts small blind $0.02
88370224: posts big blind $0.05
*** HOLE CARDS ***
Dealt to 786d72 
Dealt to 2bf0da0a 
Dealt to 88370224 
Dealt to c86f76e6 
Dealt to a6bde6ad 
Dealt to Hero [As 2h]
c86f76e6: folds
a6bde6ad: folds
Hero: folds
786d72: folds
2bf0da0a: raises $0.1 to $0.15
88370224: folds
Uncalled bet ($0.1) returned to 2bf0da0a
*** SHOWDOWN ***
2bf0da0a collected $0.1 from pot
*** SUMMARY ***
Total pot $0.1 | Rake $0 | Jackpot $0 | Bingo $0 | Fortune $0
Seat 1: 786d72 (button) folded before Flop (didn't bet)
Seat 2: 2bf0da0a (small blind) collected ($0.1)
Seat 3: 88370224 (big blind) folded before Flop
Seat 4: c86f76e6 folded before Flop (didn't bet)
Seat 5: a6bde6ad folded before Flop (didn't bet)
Seat 6: Hero folded before Flop (didn't bet)


Poker Hand #HD1199223084: Hold'em No Limit  ($0.02/$0.05) - 2023/04/11 21:17:32
Table 'NLHBlue32' 6-max Seat #6 is the button
Seat 1: 786d72 ($5.02 in chips)
Seat 2: 2bf0da0a ($5 in chips)
Seat 3: 88370224 ($7 in chips)
Seat 4: c86f76e6 ($3.33 in chips)
Seat 5: a6bde6ad ($6.7 in chips)
Seat 6: Hero ($9.52 in chips)
786d72: posts small blind $0.02
2bf0da0a: posts big blind $0.05
*** HOLE CARDS ***
Dealt to 786d72 
Dealt to 2bf0da0a 
Dealt to 88370224 
Dealt to c86f76e6 
Dealt to a6bde6ad 
Dealt to Hero [8d 5h]
88370224: folds
c86f76e6: folds
a6bde6ad: folds
Hero: folds
786d72: folds
Uncalled bet ($0.03) returned to 2bf0da0a
*** SHOWDOWN ***
2bf0da0a collected $0.04 from pot
*** SUMMARY ***
Total pot $0.04 | Rake $0 | Jackpot $0 | Bingo $0 | Fortune $0
Seat 1: 786d72 (small blind) folded before Flop
Seat 2: 2bf0da0a (big blind) collected ($0.04)
Seat 3: 88370224 folded before Flop (didn't bet)
Seat 4: c86f76e6 folded before Flop (didn't bet)
Seat 5: a6bde6ad folded before Flop (didn't bet)
Seat 6: Hero (button) folded before Flop (didn't bet)


Poker Hand #HD1199223072: Hold'em No Limit  ($0.02/$0.05) - 2023/04/11 21:17:25
Table 'NLHBlue32' 6-max Seat #5 is the button
Seat 1: 786d72 ($5 in chips)
Seat 3: 88370224 ($7 in chips)
Seat 4: c86f76e6 ($3.33 in chips)
Seat 5: a6bde6ad ($6.7 in chips)
Seat 6: Hero ($9.54 in chips)
Hero: posts small blind $0.02
786d72: posts big blind $0.05
*** HOLE CARDS ***
Dealt to 786d72 
Dealt to 88370224 
Dealt to c86f76e6 
Dealt to a6bde6ad 
Dealt to Hero [7d 4h]
88370224: folds
c86f76e6: folds
a6bde6ad: folds
Hero: folds
Uncalled bet ($0.03) returned to 786d72
*** SHOWDOWN ***
786d72 collected $0.04 from pot
*** SUMMARY ***
Total pot $0.04 | Rake $0 | Jackpot $0 | Bingo $0 | Fortune $0
Seat 1: 786d72 (big blind) collected ($0.04)
Seat 3: 88370224 folded before Flop (didn't bet)
Seat 4: c86f76e6 folded before Flop (didn't bet)
Seat 5: a6bde6ad (button) folded before Flop (didn't bet)
Seat 6: Hero (small blind) folded before Flop


Poker Hand #HD1199222985: Hold'em No Limit  ($0.02/$0.05) - 2023/04/11 21:16:40
Table 'NLHBlue32' 6-max Seat #4 is the button
Seat 1: 786d72 ($5 in chips)
Seat 3: 88370224 ($7 in chips)
Seat 4: c86f76e6 ($3.92 in chips)
Seat 5: a6bde6ad ($6.72 in chips)
Seat 6: Hero ($8.99 in chips)
a6bde6ad: posts small blind $0.02
Hero: posts big blind $0.05
*** HOLE CARDS ***
Dealt to 786d72 
Dealt to 88370224 
Dealt to c86f76e6 
Dealt to a6bde6ad 
Dealt to Hero [5d 8d]
786d72: folds
88370224: folds
c86f76e6: raises $0.08 to $0.13
a6bde6ad: folds
Hero: calls $0.08
*** FLOP *** [5h 6c 2s]
Hero: checks
c86f76e6: bets $0.1
Hero: calls $0.1
*** TURN *** [5h 6c 2s] [8s]
Hero: bets $0.36
c86f76e6: calls $0.36
*** RIVER *** [5h 6c 2s 8s] [Ac]
Hero: bets $0.9
c86f76e6: folds
Uncalled bet ($0.9) returned to Hero
*** SHOWDOWN ***
Hero collected $1.14 from pot
*** SUMMARY ***
Total pot $1.2 | Rake $0.06 | Jackpot $0 | Bingo $0 | Fortune $0
Board [5h 6c 2s 8s Ac]
Seat 1: 786d72 folded before Flop (didn't bet)
Seat 3: 88370224 folded before Flop (didn't bet)
Seat 4: c86f76e6 (button) folded on the River
Seat 5: a6bde6ad (small blind) folded before Flop
Seat 6: Hero (big blind) won ($1.14)


Poker Hand #HD1199222964: Hold'em No Limit  ($0.02/$0.05) - 2023/04/11 21:16:33
Table 'NLHBlue32' 6-max Seat #3 is the button
Seat 1: 786d72 ($5 in chips)
Seat 3: 88370224 ($7 in chips)
Seat 4: c86f76e6 ($3.94 in chips)
Seat 5: a6bde6ad ($6.7 in chips)
Seat 6: Hero ($8.99 in chips)
c86f76e6: posts small blind $0.02
a6bde6ad: posts big blind $0.05
*** HOLE CARDS ***
Dealt to 786d72 
Dealt to 88370224 
Dealt to c86f76e6 
Dealt to a6bde6ad 
Dealt to Hero [9s Ah]
Hero: folds
786d72: folds
88370224: folds
c86f76e6: folds
Uncalled bet ($0.03) returned to a6bde6ad
*** SHOWDOWN ***
a6bde6ad collected $0.04 from pot
*** SUMMARY ***
Total pot $0.04 | Rake $0 | Jackpot $0 | Bingo $0 | Fortune $0
Seat 1: 786d72 folded before Flop (didn't bet)
Seat 3: 88370224 (button) folded before Flop (didn't bet)
Seat 4: c86f76e6 (small blind) folded before Flop
Seat 5: a6bde6ad (big blind) collected ($0.04)
Seat 6: Hero folded before Flop (didn't bet)


Poker Hand #HD1199222873: Hold'em No Limit  ($0.02/$0.05) - 2023/04/11 21:15:48
Table 'NLHBlue32' 6-max Seat #2 is the button
Seat 1: 786d72 ($5 in chips)
Seat 2: 42c34352 ($5.21 in chips)
Seat 3: 88370224 ($8.88 in chips)
Seat 4: c86f76e6 ($3.99 in chips)
Seat 5: a6bde6ad ($5 in chips)
Seat 6: Hero ($8.99 in chips)
88370224: posts small blind $0.02
c86f76e6: posts big blind $0.05
*** HOLE CARDS ***
Dealt to 786d72 
Dealt to 42c34352 
Dealt to 88370224 
Dealt to c86f76e6 
Dealt to a6bde6ad 
Dealt to Hero [2h 4d]
a6bde6ad: raises $0.08 to $0.13
Hero: folds
786d72: folds
42c34352: folds
88370224: calls $0.11
c86f76e6: folds
*** FLOP *** [3h 5s Js]
88370224: bets $0.16
a6bde6ad: calls $0.16
*** TURN *** [3h 5s Js] [2d]
88370224: bets $0.32
a6bde6ad: calls $0.32
*** RIVER *** [3h 5s Js 2d] [5c]
88370224: checks
a6bde6ad: bets $1.27
88370224: calls $1.27
a6bde6ad: shows [Ad 5d] (Three Fives)
88370224: shows [Td Jd] (Pair of Jacks and Pair of Fives)
*** SHOWDOWN ***
a6bde6ad collected $3.58 from pot
*** SUMMARY ***
Total pot $3.81 | Rake $0.18 | Jackpot $0.05 | Bingo $0 | Fortune $0
Board [3h 5s Js 2d 5c]
Seat 1: 786d72 folded before Flop (didn't bet)
Seat 2: 42c34352 (button) folded before Flop (didn't bet)
Seat 3: 88370224 (small blind) showed [Td Jd] and lost with Pair of Jacks and Pair of Fives
Seat 4: c86f76e6 (big blind) folded before Flop
Seat 5: a6bde6ad showed [Ad 5d] and won ($3.58) with Three Fives
Seat 6: Hero folded before Flop (didn't bet)


Poker Hand #HD1199222804: Hold'em No Limit  ($0.02/$0.05) - 2023/04/11 21:15:16
Table 'NLHBlue32' 6-max Seat #1 is the button
Seat 1: 786d72 ($5 in chips)
Seat 2: 42c34352 ($5.09 in chips)
Seat 3: 88370224 ($9.01 in chips)
Seat 4: c86f76e6 ($3.99 in chips)
Seat 5: a6bde6ad ($5 in chips)
Seat 6: Hero ($8.99 in chips)
42c34352: posts small blind $0.02
88370224: posts big blind $0.05
*** HOLE CARDS ***
Dealt to 786d72 
Dealt to 42c34352 
Dealt to 88370224 
Dealt to c86f76e6 
Dealt to a6bde6ad 
Dealt to Hero [2s Qc]
c86f76e6: folds
a6bde6ad: folds
Hero: folds
786d72: folds
42c34352: raises $0.08 to $0.13
88370224: calls $0.08
*** FLOP *** [Ks 6h Ad]
42c34352: bets $0.09
88370224: folds
Uncalled bet ($0.09) returned to 42c34352
*** SHOWDOWN ***
42c34352 collected $0.25 from pot
*** SUMMARY ***
Total pot $0.26 | Rake $0.01 | Jackpot $0 | Bingo $0 | Fortune $0
Board [Ks 6h Ad]
Seat 1: 786d72 (button) folded before Flop (didn't bet)
Seat 2: 42c34352 (small blind) won ($0.25)
Seat 3: 88370224 (big blind) folded on the Flop
Seat 4: c86f76e6 folded before Flop (didn't bet)
Seat 5: a6bde6ad folded before Flop (didn't bet)
Seat 6: Hero folded before Flop (didn't bet)


Poker Hand #HD1199222773: Hold'em No Limit  ($0.02/$0.05) - 2023/04/11 21:14:59
Table 'NLHBlue32' 6-max Seat #6 is the button
Seat 1: 786d72 ($5 in chips)
Seat 2: 42c34352 ($5.14 in chips)
Seat 3: 88370224 ($9.01 in chips)
Seat 4: c86f76e6 ($3.99 in chips)
Seat 5: a6bde6ad ($5 in chips)
Seat 6: Hero ($8.92 in chips)
786d72: posts small blind $0.02
42c34352: posts big blind $0.05
*** HOLE CARDS ***
Dealt to 786d72 
Dealt to 42c34352 
Dealt to 88370224 
Dealt to c86f76e6 
Dealt to a6bde6ad 
Dealt to Hero [Ad 8h]
88370224: folds
c86f76e6: folds
a6bde6ad: folds
Hero: raises $0.07 to $0.12
786d72: folds
42c34352: folds
Uncalled bet ($0.07) returned to Hero
*** SHOWDOWN ***
Hero collected $0.12 from pot
*** SUMMARY ***
Total pot $0.12 | Rake $0 | Jackpot $0 | Bingo $0 | Fortune $0
Seat 1: 786d72 (small blind) folded before Flop
Seat 2: 42c34352 (big blind) folded before Flop
Seat 3: 88370224 folded before Flop (didn't bet)
Seat 4: c86f76e6 folded before Flop (didn't bet)
Seat 5: a6bde6ad folded before Flop (didn't bet)
Seat 6: Hero (button) collected ($0.12)


Poker Hand #HD1199222735: Hold'em No Limit  ($0.02/$0.05) - 2023/04/11 21:14:42
Table 'NLHBlue32' 6-max Seat #5 is the button
Seat 1: 786d72 ($5 in chips)
Seat 2: 42c34352 ($5.07 in chips)
Seat 3: 88370224 ($9.01 in chips)
Seat 4: c86f76e6 ($3.99 in chips)
Seat 5: a6bde6ad ($5 in chips)
Seat 6: Hero ($8.94 in chips)
Hero: posts small blind $0.02
786d72: posts big blind $0.05
*** HOLE CARDS ***
Dealt to 786d72 
Dealt to 42c34352 
Dealt to 88370224 
Dealt to c86f76e6 
Dealt to a6bde6ad 
Dealt to Hero [5d Ac]
42c34352: raises $0.08 to $0.13
88370224: folds
c86f76e6: folds
a6bde6ad: folds
Hero: folds
786d72: folds
Uncalled bet ($0.08) returned to 42c34352
*** SHOWDOWN ***
42c34352 collected $0.12 from pot
*** SUMMARY ***
Total pot $0.12 | Rake $0 | Jackpot $0 | Bingo $0 | Fortune $0
Seat 1: 786d72 (big blind) folded before Flop
Seat 2: 42c34352 collected ($0.12)
Seat 3: 88370224 folded before Flop (didn't bet)
Seat 4: c86f76e6 folded before Flop (didn't bet)
Seat 5: a6bde6ad (button) folded before Flop (didn't bet)
Seat 6: Hero (small blind) folded before Flop


Poker Hand #HD1199222710: Hold'em No Limit  ($0.02/$0.05) - 2023/04/11 21:14:33
Table 'NLHBlue32' 6-max Seat #4 is the button
Seat 1: 786d72 ($5 in chips)
Seat 2: 42c34352 ($5.07 in chips)
Seat 3: 88370224 ($8.94 in chips)
Seat 4: c86f76e6 ($3.99 in chips)
Seat 5: a6bde6ad ($5 in chips)
Seat 6: Hero ($8.99 in chips)
a6bde6ad: posts small blind $0.02
Hero: posts big blind $0.05
*** HOLE CARDS ***
Dealt to 786d72 
Dealt to 42c34352 
Dealt to 88370224 
Dealt to c86f76e6 
Dealt to a6bde6ad 
Dealt to Hero [4s Jd]
786d72: folds
42c34352: folds
88370224: raises $0.05 to $0.1
c86f76e6: folds
a6bde6ad: folds
Hero: folds
Uncalled bet ($0.05) returned to 88370224
*** SHOWDOWN ***
88370224 collected $0.12 from pot
*** SUMMARY ***
Total pot $0.12 | Rake $0 | Jackpot $0 | Bingo $0 | Fortune $0
Seat 1: 786d72 folded before Flop (didn't bet)
Seat 2: 42c34352 folded before Flop (didn't bet)
Seat 3: 88370224 collected ($0.12)
Seat 4: c86f76e6 (button) folded before Flop (didn't bet)
Seat 5: a6bde6ad (small blind) folded before Flop
Seat 6: Hero (big blind) folded before Flop


Poker Hand #HD1199222680: Hold'em No Limit  ($0.02/$0.05) - 2023/04/11 21:14:21
Table 'NLHBlue32' 6-max Seat #3 is the button
Seat 1: 786d72 ($5 in chips)
Seat 2: 42c34352 ($5.07 in chips)
Seat 3: 88370224 ($8.94 in chips)
Seat 4: c86f76e6 ($3.94 in chips)
Seat 5: a6bde6ad ($5 in chips)
Seat 6: Hero ($8.99 in chips)
c86f76e6: posts small blind $0.02
a6bde6ad: posts big blind $0.05
*** HOLE CARDS ***
Dealt to 786d72 
Dealt to 42c34352 
Dealt to 88370224 
Dealt to c86f76e6 
Dealt to a6bde6ad 
Dealt to Hero [7c Kc]
Hero: folds
786d72: folds
42c34352: folds
88370224: folds
c86f76e6: raises $0.08 to $0.13
a6bde6ad: folds
Uncalled bet ($0.08) returned to c86f76e6
*** SHOWDOWN ***
c86f76e6 collected $0.1 from pot
*** SUMMARY ***
Total pot $0.1 | Rake $0 | Jackpot $0 | Bingo $0 | Fortune $0
Seat 1: 786d72 folded before Flop (didn't bet)
Seat 2: 42c34352 folded before Flop (didn't bet)
Seat 3: 88370224 (button) folded before Flop (didn't bet)
Seat 4: c86f76e6 (small blind) collected ($0.1)
Seat 5: a6bde6ad (big blind) folded before Flop
Seat 6: Hero folded before Flop (didn't bet)


Poker Hand #HD1199222657: Hold'em No Limit  ($0.02/$0.05) - 2023/04/11 21:14:11
Table 'NLHBlue32' 6-max Seat #2 is the button
Seat 1: 786d72 ($5 in chips)
Seat 2: 42c34352 ($5 in chips)
Seat 3: 88370224 ($8.96 in chips)
Seat 4: c86f76e6 ($3.99 in chips)
Seat 5: a6bde6ad ($5 in chips)
Seat 6: Hero ($8.99 in chips)
88370224: posts small blind $0.02
c86f76e6: posts big blind $0.05
*** HOLE CARDS ***
Dealt to 786d72 
Dealt to 42c34352 
Dealt to 88370224 
Dealt to c86f76e6 
Dealt to a6bde6ad 
Dealt to Hero [9d Qh]
a6bde6ad: folds
Hero: folds
786d72: folds
42c34352: raises $0.08 to $0.13
88370224: folds
c86f76e6: folds
Uncalled bet ($0.08) returned to 42c34352
*** SHOWDOWN ***
42c34352 collected $0.12 from pot
*** SUMMARY ***
Total pot $0.12 | Rake $0 | Jackpot $0 | Bingo $0 | Fortune $0
Seat 1: 786d72 folded before Flop (didn't bet)
Seat 2: 42c34352 (button) collected ($0.12)
Seat 3: 88370224 (small blind) folded before Flop
Seat 4: c86f76e6 (big blind) folded before Flop
Seat 5: a6bde6ad folded before Flop (didn't bet)
Seat 6: Hero folded before Flop (didn't bet)


Poker Hand #HD1199222496: Hold'em No Limit  ($0.02/$0.05) - 2023/04/11 21:13:00
Table 'NLHBlue32' 6-max Seat #1 is the button
Seat 1: 786d72 ($5 in chips)
Seat 2: 42c34352 ($5 in chips)
Seat 3: 88370224 ($6.81 in chips)
Seat 4: c86f76e6 ($3.99 in chips)
Seat 5: a6bde6ad ($5.17 in chips)
Seat 6: Hero ($8.99 in chips)
42c34352: posts small blind $0.02
88370224: posts big blind $0.05
*** HOLE CARDS ***
Dealt to 786d72 
Dealt to 42c34352 
Dealt to 88370224 
Dealt to c86f76e6 
Dealt to a6bde6ad 
Dealt to Hero [5d As]
c86f76e6: folds
a6bde6ad: raises $0.08 to $0.13
Hero: folds
786d72: folds
42c34352: calls $0.11
88370224: raises $0.45 to $0.58
a6bde6ad: calls $0.45
42c34352: calls $0.45
*** FLOP *** [Tc Ks 8c]
42c34352: checks
88370224: checks
a6bde6ad: checks
*** TURN *** [Tc Ks 8c] [Kh]
42c34352: bets $0.5
88370224: calls $0.5
a6bde6ad: folds
*** RIVER *** [Tc Ks 8c Kh] [8d]
42c34352: bets $0.75
88370224: calls $0.75
42c34352: shows [Jc Js] (Pair of Kings and Pair of Jacks)
88370224: shows [Qh Qc] (Pair of Kings and Pair of Queens)
*** SHOWDOWN ***
88370224 collected $3.98 from pot
*** SUMMARY ***
Total pot $4.24 | Rake $0.21 | Jackpot $0.05 | Bingo $0 | Fortune $0
Board [Tc Ks 8c Kh 8d]
Seat 1: 786d72 (button) folded before Flop (didn't bet)
Seat 2: 42c34352 (small blind) showed [Jc Js] and lost with Pair of Kings and Pair of Jacks
Seat 3: 88370224 (big blind) showed [Qh Qc] and won ($3.98) with Pair of Kings and Pair of Queens
Seat 4: c86f76e6 folded before Flop (didn't bet)
Seat 5: a6bde6ad folded on the Turn
Seat 6: Hero folded before Flop (didn't bet)


Poker Hand #HD1199222413: Hold'em No Limit  ($0.02/$0.05) - 2023/04/11 21:12:21
Table 'NLHBlue32' 6-max Seat #6 is the button
Seat 1: 786d72 ($5 in chips)
Seat 2: 42c34352 ($5 in chips)
Seat 3: 88370224 ($6.81 in chips)
Seat 4: c86f76e6 ($3.99 in chips)
Seat 5: a6bde6ad ($5.17 in chips)
Seat 6: Hero ($8.73 in chips)
786d72: posts small blind $0.02
42c34352: posts big blind $0.05
*** HOLE CARDS ***
Dealt to 786d72 
Dealt to 42c34352 
Dealt to 88370224 
Dealt to c86f76e6 
Dealt to a6bde6ad 
Dealt to Hero [Qd Qh]
88370224: folds
c86f76e6: folds
a6bde6ad: folds
Hero: raises $0.07 to $0.12
786d72: calls $0.1
42c34352: folds
*** FLOP *** [3d Th Ts]
786d72: checks
Hero: bets $0.11
786d72: calls $0.11
*** TURN *** [3d Th Ts] [Ac]
786d72: checks
Hero: bets $0.26
786d72: folds
Uncalled bet ($0.26) returned to Hero
*** SHOWDOWN ***
Hero collected $0.49 from pot
*** SUMMARY ***
Total pot $0.51 | Rake $0.02 | Jackpot $0 | Bingo $0 | Fortune $0
Board [3d Th Ts Ac]
Seat 1: 786d72 (small blind) folded on the Turn
Seat 2: 42c34352 (big blind) folded before Flop
Seat 3: 88370224 folded before Flop (didn't bet)
Seat 4: c86f76e6 folded before Flop (didn't bet)
Seat 5: a6bde6ad folded before Flop (didn't bet)
Seat 6: Hero (button) won ($0.49)


Poker Hand #HD1199222358: Hold'em No Limit  ($0.02/$0.05) - 2023/04/11 21:11:57
Table 'NLHBlue32' 6-max Seat #5 is the button
Seat 1: 786d72 ($5 in chips)
Seat 2: 42c34352 ($5 in chips)
Seat 3: 88370224 ($6.81 in chips)
Seat 4: c86f76e6 ($3.99 in chips)
Seat 5: a6bde6ad ($5.17 in chips)
Seat 6: Hero ($8.68 in chips)
Hero: posts small blind $0.02
786d72: posts big blind $0.05
*** HOLE CARDS ***
Dealt to 786d72 
Dealt to 42c34352 
Dealt to 88370224 
Dealt to c86f76e6 
Dealt to a6bde6ad 
Dealt to Hero [9c Qh]
42c34352: folds
88370224: folds
c86f76e6: folds
a6bde6ad: folds
Hero: raises $0.09 to $0.14
786d72: folds
Uncalled bet ($0.09) returned to Hero
*** SHOWDOWN ***
Hero collected $0.1 from pot
*** SUMMARY ***
Total pot $0.1 | Rake $0 | Jackpot $0 | Bingo $0 | Fortune $0
Seat 1: 786d72 (big blind) folded before Flop
Seat 2: 42c34352 folded before Flop (didn't bet)
Seat 3: 88370224 folded before Flop (didn't bet)
Seat 4: c86f76e6 folded before Flop (didn't bet)
Seat 5: a6bde6ad (button) folded before Flop (didn't bet)
Seat 6: Hero (small blind) collected ($0.1)


Poker Hand #HD1199222336: Hold'em No Limit  ($0.02/$0.05) - 2023/04/11 21:11:48
Table 'NLHBlue32' 6-max Seat #4 is the button
Seat 2: 42c34352 ($5 in chips)
Seat 3: 88370224 ($6.81 in chips)
Seat 4: c86f76e6 ($3.99 in chips)
Seat 5: a6bde6ad ($5.19 in chips)
Seat 6: Hero ($8.66 in chips)
a6bde6ad: posts small blind $0.02
Hero: posts big blind $0.05
*** HOLE CARDS ***
Dealt to 42c34352 
Dealt to 88370224 
Dealt to c86f76e6 
Dealt to a6bde6ad 
Dealt to Hero [7h 8s]
42c34352: folds
88370224: folds
c86f76e6: folds
a6bde6ad: folds
Uncalled bet ($0.03) returned to Hero
*** SHOWDOWN ***
Hero collected $0.04 from pot
*** SUMMARY ***
Total pot $0.04 | Rake $0 | Jackpot $0 | Bingo $0 | Fortune $0
Seat 2: 42c34352 folded before Flop (didn't bet)
Seat 3: 88370224 folded before Flop (didn't bet)
Seat 4: c86f76e6 (button) folded before Flop (didn't bet)
Seat 5: a6bde6ad (small blind) folded before Flop
Seat 6: Hero (big blind) collected ($0.04)


Poker Hand #HD1199222277: Hold'em No Limit  ($0.02/$0.05) - 2023/04/11 21:11:21
Table 'NLHBlue32' 6-max Seat #3 is the button
Seat 2: 42c34352 ($5 in chips)
Seat 3: 88370224 ($6.81 in chips)
Seat 4: c86f76e6 ($4.11 in chips)
Seat 5: a6bde6ad ($5.24 in chips)
Seat 6: Hero ($8.5 in chips)
c86f76e6: posts small blind $0.02
a6bde6ad: posts big blind $0.05
*** HOLE CARDS ***
Dealt to 42c34352 
Dealt to 88370224 
Dealt to c86f76e6 
Dealt to a6bde6ad 
Dealt to Hero [Qs Qd]
Hero: raises $0.07 to $0.12
42c34352: folds
88370224: folds
c86f76e6: calls $0.1
a6bde6ad: folds
*** FLOP *** [9s 7h Kd]
c86f76e6: checks
Hero: bets $0.11
c86f76e6: folds
Uncalled bet ($0.11) returned to Hero
*** SHOWDOWN ***
Hero collected $0.28 from pot
*** SUMMARY ***
Total pot $0.29 | Rake $0.01 | Jackpot $0 | Bingo $0 | Fortune $0
Board [9s 7h Kd]
Seat 2: 42c34352 folded before Flop (didn't bet)
Seat 3: 88370224 (button) folded before Flop (didn't bet)
Seat 4: c86f76e6 (small blind) folded on the Flop
Seat 5: a6bde6ad (big blind) folded before Flop
Seat 6: Hero won ($0.28)


Poker Hand #HD1199222191: Hold'em No Limit  ($0.02/$0.05) - 2023/04/11 21:10:37
Table 'NLHBlue32' 6-max Seat #2 is the button
Seat 2: 42c34352 ($5 in chips)
Seat 3: 88370224 ($6.83 in chips)
Seat 4: c86f76e6 ($4.35 in chips)
Seat 5: a6bde6ad ($5.24 in chips)
Seat 6: Hero ($8.26 in chips)
88370224: posts small blind $0.02
c86f76e6: posts big blind $0.05
*** HOLE CARDS ***
Dealt to 42c34352 
Dealt to 88370224 
Dealt to c86f76e6 
Dealt to a6bde6ad 
Dealt to Hero [7c 7h]
a6bde6ad: folds
Hero: raises $0.07 to $0.12
42c34352: folds
88370224: folds
c86f76e6: calls $0.07
*** FLOP *** [Kh 2d Qd]
c86f76e6: checks
Hero: checks
*** TURN *** [Kh 2d Qd] [9c]
c86f76e6: bets $0.12
Hero: calls $0.12
*** RIVER *** [Kh 2d Qd 9c] [9s]
c86f76e6: checks
Hero: checks
c86f76e6: shows [Tc As] (Pair of Nines)
Hero: shows [7c 7h] (Pair of Nines and Pair of Sevens)
*** SHOWDOWN ***
Hero collected $0.48 from pot
*** SUMMARY ***
Total pot $0.5 | Rake $0.02 | Jackpot $0 | Bingo $0 | Fortune $0
Board [Kh 2d Qd 9c 9s]
Seat 2: 42c34352 (button) folded before Flop (didn't bet)
Seat 3: 88370224 (small blind) folded before Flop
Seat 4: c86f76e6 (big blind) showed [Tc As] and lost with Pair of Nines
Seat 5: a6bde6ad folded before Flop (didn't bet)
Seat 6: Hero showed [7c 7h] and won ($0.48) with Pair of Nines and Pair of Sevens


Poker Hand #HD1199222167: Hold'em No Limit  ($0.02/$0.05) - 2023/04/11 21:10:24
Table 'NLHBlue32' 6-max Seat #6 is the button
Seat 2: 42c34352 ($5 in chips)
Seat 3: 88370224 ($6.88 in chips)
Seat 4: c86f76e6 ($4.35 in chips)
Seat 5: a6bde6ad ($5.17 in chips)
Seat 6: Hero ($8.26 in chips)
42c34352: posts small blind $0.02
88370224: posts big blind $0.05
*** HOLE CARDS ***
Dealt to 42c34352 
Dealt to 88370224 
Dealt to c86f76e6 
Dealt to a6bde6ad 
Dealt to Hero [Ah 9d]
c86f76e6: folds
a6bde6ad: raises $0.08 to $0.13
Hero: folds
42c34352: folds
88370224: folds
Uncalled bet ($0.08) returned to a6bde6ad
*** SHOWDOWN ***
a6bde6ad collected $0.12 from pot
*** SUMMARY ***
Total pot $0.12 | Rake $0 | Jackpot $0 | Bingo $0 | Fortune $0
Seat 2: 42c34352 (small blind) folded before Flop
Seat 3: 88370224 (big blind) folded before Flop
Seat 4: c86f76e6 folded before Flop (didn't bet)
Seat 5: a6bde6ad collected ($0.12)
Seat 6: Hero (button) folded before Flop (didn't bet)


Poker Hand #HD1199222099: Hold'em No Limit  ($0.02/$0.05) - 2023/04/11 21:09:54
Table 'NLHBlue32' 6-max Seat #5 is the button
Seat 2: 42c34352 ($5 in chips)
Seat 3: 88370224 ($6.88 in chips)
Seat 4: c86f76e6 ($4.35 in chips)
Seat 5: a6bde6ad ($5.17 in chips)
Seat 6: Hero ($8 in chips)
Hero: posts small blind $0.02
42c34352: posts big blind $0.05
*** HOLE CARDS ***
Dealt to 42c34352 
Dealt to 88370224 
Dealt to c86f76e6 
Dealt to a6bde6ad 
Dealt to Hero [8s 8d]
88370224: folds
c86f76e6: folds
a6bde6ad: folds
Hero: raises $0.09 to $0.14
42c34352: calls $0.09
*** FLOP *** [Ts 2s 6c]
Hero: bets $0.14
42c34352: calls $0.14
*** TURN *** [Ts 2s 6c] [7c]
Hero: bets $0.42
42c34352: folds
Uncalled bet ($0.42) returned to Hero
*** SHOWDOWN ***
Hero collected $0.54 from pot
*** SUMMARY ***
Total pot $0.56 | Rake $0.02 | Jackpot $0 | Bingo $0 | Fortune $0
Board [Ts 2s 6c 7c]
Seat 2: 42c34352 (big blind) folded on the Turn
Seat 3: 88370224 folded before Flop (didn't bet)
Seat 4: c86f76e6 folded before Flop (didn't bet)
Seat 5: a6bde6ad (button) folded before Flop (didn't bet)
Seat 6: Hero (small blind) won ($0.54)


Poker Hand #HD1199222041: Hold'em No Limit  ($0.02/$0.05) - 2023/04/11 21:09:25
Table 'NLHBlue32' 6-max Seat #4 is the button
Seat 1: 35c473c4 ($5.28 in chips)
Seat 2: 42c34352 ($5 in chips)
Seat 3: 88370224 ($6.88 in chips)
Seat 4: c86f76e6 ($4.48 in chips)
Seat 5: a6bde6ad ($5 in chips)
Seat 6: Hero ($8.05 in chips)
a6bde6ad: posts small blind $0.02
Hero: posts big blind $0.05
*** HOLE CARDS ***
Dealt to 35c473c4 
Dealt to 42c34352 
Dealt to 88370224 
Dealt to c86f76e6 
Dealt to a6bde6ad 
Dealt to Hero [Ac 7c]
35c473c4: folds
42c34352: folds
88370224: folds
c86f76e6: raises $0.08 to $0.13
a6bde6ad: raises $0.31 to $0.44
Hero: folds
c86f76e6: folds
Uncalled bet ($0.31) returned to a6bde6ad
*** SHOWDOWN ***
a6bde6ad collected $0.3 from pot
*** SUMMARY ***
Total pot $0.31 | Rake $0.01 | Jackpot $0 | Bingo $0 | Fortune $0
Seat 1: 35c473c4 folded before Flop (didn't bet)
Seat 2: 42c34352 folded before Flop (didn't bet)
Seat 3: 88370224 folded before Flop (didn't bet)
Seat 4: c86f76e6 (button) folded before Flop
Seat 5: a6bde6ad (small blind) collected ($0.3)
Seat 6: Hero (big blind) folded before Flop


Poker Hand #HD1199221965: Hold'em No Limit  ($0.02/$0.05) - 2023/04/11 21:08:51
Table 'NLHBlue32' 6-max Seat #3 is the button
Seat 1: 35c473c4 ($5.28 in chips)
Seat 2: 42c34352 ($5 in chips)
Seat 3: 88370224 ($6.98 in chips)
Seat 4: c86f76e6 ($4.34 in chips)
Seat 5: a6bde6ad ($5 in chips)
Seat 6: Hero ($8.05 in chips)
c86f76e6: posts small blind $0.02
a6bde6ad: posts big blind $0.05
*** HOLE CARDS ***
Dealt to 35c473c4 
Dealt to 42c34352 
Dealt to 88370224 
Dealt to c86f76e6 
Dealt to a6bde6ad 
Dealt to Hero [Qd 8h]
Hero: folds
35c473c4: folds
42c34352: folds
88370224: raises $0.05 to $0.1
c86f76e6: raises $0.2 to $0.3
a6bde6ad: folds
88370224: folds
Uncalled bet ($0.2) returned to c86f76e6
*** SHOWDOWN ***
c86f76e6 collected $0.24 from pot
*** SUMMARY ***
Total pot $0.25 | Rake $0.01 | Jackpot $0 | Bingo $0 | Fortune $0
Seat 1: 35c473c4 folded before Flop (didn't bet)
Seat 2: 42c34352 folded before Flop (didn't bet)
Seat 3: 88370224 (button) folded before Flop
Seat 4: c86f76e6 (small blind) collected ($0.24)
Seat 5: a6bde6ad (big blind) folded before Flop
Seat 6: Hero folded before Flop (didn't bet)


Poker Hand #HD1199221891: Hold'em No Limit  ($0.02/$0.05) - 2023/04/11 21:08:17
Table 'NLHBlue32' 6-max Seat #2 is the button
Seat 1: 35c473c4 ($5.28 in chips)
Seat 2: 42c34352 ($5 in chips)
Seat 3: 88370224 ($7 in chips)
Seat 4: c86f76e6 ($3.8 in chips)
Seat 5: a6bde6ad ($5 in chips)
Seat 6: Hero ($8.62 in chips)
88370224: posts small blind $0.02
c86f76e6: posts big blind $0.05
*** HOLE CARDS ***
Dealt to 35c473c4 
Dealt to 42c34352 
Dealt to 88370224 
Dealt to c86f76e6 
Dealt to a6bde6ad 
Dealt to Hero [7d Ad]
a6bde6ad: folds
Hero: raises $0.07 to $0.12
35c473c4: folds
42c34352: folds
88370224: folds
c86f76e6: calls $0.07
*** FLOP *** [3h 9c Ac]
c86f76e6: checks
Hero: bets $0.1
c86f76e6: calls $0.1
*** TURN *** [3h 9c Ac] [Jd]
c86f76e6: checks
Hero: bets $0.35
c86f76e6: raises $0.65 to $1
Hero: folds
Uncalled bet ($0.65) returned to c86f76e6
*** SHOWDOWN ***
c86f76e6 collected $1.11 from pot
*** SUMMARY ***
Total pot $1.16 | Rake $0.05 | Jackpot $0 | Bingo $0 | Fortune $0
Board [3h 9c Ac Jd]
Seat 1: 35c473c4 folded before Flop (didn't bet)
Seat 2: 42c34352 (button) folded before Flop (didn't bet)
Seat 3: 88370224 (small blind) folded before Flop
Seat 4: c86f76e6 (big blind) won ($1.11)
Seat 5: a6bde6ad folded before Flop (didn't bet)
Seat 6: Hero folded on the Turn


Poker Hand #HD1199221870: Hold'em No Limit  ($0.02/$0.05) - 2023/04/11 21:08:06
Table 'NLHBlue32' 6-max Seat #1 is the button
Seat 1: 35c473c4 ($5.28 in chips)
Seat 2: 42c34352 ($5 in chips)
Seat 3: 88370224 ($7.05 in chips)
Seat 4: c86f76e6 ($3.8 in chips)
Seat 5: a6bde6ad ($5 in chips)
Seat 6: Hero ($8.55 in chips)
42c34352: posts small blind $0.02
88370224: posts big blind $0.05
*** HOLE CARDS ***
Dealt to 35c473c4 
Dealt to 42c34352 
Dealt to 88370224 
Dealt to c86f76e6 
Dealt to a6bde6ad 
Dealt to Hero [Qd 9d]
c86f76e6: folds
a6bde6ad: folds
Hero: raises $0.07 to $0.12
35c473c4: folds
42c34352: folds
88370224: folds
Uncalled bet ($0.07) returned to Hero
*** SHOWDOWN ***
Hero collected $0.12 from pot
*** SUMMARY ***
Total pot $0.12 | Rake $0 | Jackpot $0 | Bingo $0 | Fortune $0
Seat 1: 35c473c4 (button) folded before Flop (didn't bet)
Seat 2: 42c34352 (small blind) folded before Flop
Seat 3: 88370224 (big blind) folded before Flop
Seat 4: c86f76e6 folded before Flop (didn't bet)
Seat 5: a6bde6ad folded before Flop (didn't bet)
Seat 6: Hero collected ($0.12)


Poker Hand #HD1199221798: Hold'em No Limit  ($0.02/$0.05) - 2023/04/11 21:07:32
Table 'NLHBlue32' 6-max Seat #6 is the button
Seat 1: 35c473c4 ($5 in chips)
Seat 2: 42c34352 ($5.07 in chips)
Seat 3: 88370224 ($7.05 in chips)
Seat 4: c86f76e6 ($3.8 in chips)
Seat 5: a6bde6ad ($5 in chips)
Seat 6: Hero ($8.55 in chips)
35c473c4: posts small blind $0.02
42c34352: posts big blind $0.05
*** HOLE CARDS ***
Dealt to 35c473c4 
Dealt to 42c34352 
Dealt to 88370224 
Dealt to c86f76e6 
Dealt to a6bde6ad 
Dealt to Hero [4h Td]
88370224: folds
c86f76e6: folds
a6bde6ad: folds
Hero: folds
35c473c4: raises $0.08 to $0.13
42c34352: calls $0.08
*** FLOP *** [7s 6d 2d]
35c473c4: bets $0.18
42c34352: calls $0.18
*** TURN *** [7s 6d 2d] [3h]
35c473c4: bets $0.42
42c34352: folds
Uncalled bet ($0.42) returned to 35c473c4
*** SHOWDOWN ***
35c473c4 collected $0.59 from pot
*** SUMMARY ***
Total pot $0.62 | Rake $0.03 | Jackpot $0 | Bingo $0 | Fortune $0
Board [7s 6d 2d 3h]
Seat 1: 35c473c4 (small blind) won ($0.59)
Seat 2: 42c34352 (big blind) folded on the Turn
Seat 3: 88370224 folded before Flop (didn't bet)
Seat 4: c86f76e6 folded before Flop (didn't bet)
Seat 5: a6bde6ad folded before Flop (didn't bet)
Seat 6: Hero (button) folded before Flop (didn't bet)


Poker Hand #HD1199221770: Hold'em No Limit  ($0.02/$0.05) - 2023/04/11 21:07:17
Table 'NLHBlue32' 6-max Seat #5 is the button
Seat 1: 35c473c4 ($5 in chips)
Seat 3: 88370224 ($7.05 in chips)
Seat 4: c86f76e6 ($3.73 in chips)
Seat 5: a6bde6ad ($5 in chips)
Seat 6: Hero ($8.57 in chips)
Hero: posts small blind $0.02
35c473c4: posts big blind $0.05
*** HOLE CARDS ***
Dealt to 35c473c4 
Dealt to 88370224 
Dealt to c86f76e6 
Dealt to a6bde6ad 
Dealt to Hero [8s Ac]
88370224: folds
c86f76e6: raises $0.09 to $0.14
a6bde6ad: folds
Hero: folds
35c473c4: folds
Uncalled bet ($0.09) returned to c86f76e6
*** SHOWDOWN ***
c86f76e6 collected $0.12 from pot
*** SUMMARY ***
Total pot $0.12 | Rake $0 | Jackpot $0 | Bingo $0 | Fortune $0
Seat 1: 35c473c4 (big blind) folded before Flop
Seat 3: 88370224 folded before Flop (didn't bet)
Seat 4: c86f76e6 collected ($0.12)
Seat 5: a6bde6ad (button) folded before Flop (didn't bet)
Seat 6: Hero (small blind) folded before Flop


Poker Hand #HD1199221754: Hold'em No Limit  ($0.02/$0.05) - 2023/04/11 21:07:09
Table 'NLHBlue32' 6-max Seat #4 is the button
Seat 3: 88370224 ($7.05 in chips)
Seat 4: c86f76e6 ($3.73 in chips)
Seat 5: a6bde6ad ($5 in chips)
Seat 6: Hero ($8.55 in chips)
a6bde6ad: posts small blind $0.02
Hero: posts big blind $0.05
*** HOLE CARDS ***
Dealt to 88370224 
Dealt to c86f76e6 
Dealt to a6bde6ad 
Dealt to Hero [5s Ac]
88370224: folds
c86f76e6: folds
a6bde6ad: folds
Uncalled bet ($0.03) returned to Hero
*** SHOWDOWN ***
Hero collected $0.04 from pot
*** SUMMARY ***
Total pot $0.04 | Rake $0 | Jackpot $0 | Bingo $0 | Fortune $0
Seat 3: 88370224 folded before Flop (didn't bet)
Seat 4: c86f76e6 (button) folded before Flop (didn't bet)
Seat 5: a6bde6ad (small blind) folded before Flop
Seat 6: Hero (big blind) collected ($0.04)


Poker Hand #HD1199221728: Hold'em No Limit  ($0.02/$0.05) - 2023/04/11 21:06:58
Table 'NLHBlue32' 6-max Seat #3 is the button
Seat 3: 88370224 ($7.05 in chips)
Seat 4: c86f76e6 ($3.68 in chips)
Seat 5: a6bde6ad ($5 in chips)
Seat 6: Hero ($8.55 in chips)
c86f76e6: posts small blind $0.02
a6bde6ad: posts big blind $0.05
*** HOLE CARDS ***
Dealt to 88370224 
Dealt to c86f76e6 
Dealt to a6bde6ad 
Dealt to Hero [5s 3s]
Hero: folds
88370224: folds
c86f76e6: raises $0.09 to $0.14
a6bde6ad: folds
Uncalled bet ($0.09) returned to c86f76e6
*** SHOWDOWN ***
c86f76e6 collected $0.1 from pot
*** SUMMARY ***
Total pot $0.1 | Rake $0 | Jackpot $0 | Bingo $0 | Fortune $0
Seat 3: 88370224 (button) folded before Flop (didn't bet)
Seat 4: c86f76e6 (small blind) collected ($0.1)
Seat 5: a6bde6ad (big blind) folded before Flop
Seat 6: Hero folded before Flop (didn't bet)


Poker Hand #HD1199221635: Hold'em No Limit  ($0.02/$0.05) - 2023/04/11 21:06:13
Table 'NLHBlue32' 6-max Seat #6 is the button
Seat 3: 88370224 ($7.67 in chips)
Seat 4: c86f76e6 ($3.12 in chips)
Seat 5: a6bde6ad ($5 in chips)
Seat 6: Hero ($8.55 in chips)
88370224: posts small blind $0.02
c86f76e6: posts big blind $0.05
*** HOLE CARDS ***
Dealt to 88370224 
Dealt to c86f76e6 
Dealt to a6bde6ad 
Dealt to Hero [7c 9s]
a6bde6ad: folds
Hero: folds
88370224: raises $0.05 to $0.1
c86f76e6: raises $0.2 to $0.3
88370224: calls $0.2
*** FLOP *** [3s 2c Kc]
88370224: checks
c86f76e6: bets $0.32
88370224: calls $0.32
*** TURN *** [3s 2c Kc] [4d]
88370224: checks
c86f76e6: checks
*** RIVER *** [3s 2c Kc 4d] [2h]
88370224: checks
c86f76e6: checks
88370224: shows [Ac 3c] (Pair of Treys and Pair of Twos)
c86f76e6: shows [8d 8h] (Pair of Eights and Pair of Twos)
*** SHOWDOWN ***
c86f76e6 collected $1.18 from pot
*** SUMMARY ***
Total pot $1.24 | Rake $0.06 | Jackpot $0 | Bingo $0 | Fortune $0
Board [3s 2c Kc 4d 2h]
Seat 3: 88370224 (small blind) showed [Ac 3c] and lost with Pair of Treys and Pair of Twos
Seat 4: c86f76e6 (big blind) showed [8d 8h] and won ($1.18) with Pair of Eights and Pair of Twos
Seat 5: a6bde6ad folded before Flop (didn't bet)
Seat 6: Hero (button) folded before Flop (didn't bet)


Poker Hand #HD1199221569: Hold'em No Limit  ($0.02/$0.05) - 2023/04/11 21:05:44
Table 'NLHBlue32' 6-max Seat #5 is the button
Seat 3: 88370224 ($7.41 in chips)
Seat 4: c86f76e6 ($3.12 in chips)
Seat 5: a6bde6ad ($5 in chips)
Seat 6: Hero ($8.83 in chips)
Hero: posts small blind $0.02
88370224: posts big blind $0.05
*** HOLE CARDS ***
Dealt to 88370224 
Dealt to c86f76e6 
Dealt to a6bde6ad 
Dealt to Hero [Ah Th]
c86f76e6: folds
a6bde6ad: folds
Hero: raises $0.09 to $0.14
88370224: calls $0.09
*** FLOP *** [9s 2d 3d]
Hero: bets $0.14
88370224: calls $0.14
*** TURN *** [9s 2d 3d] [Kh]
Hero: checks
88370224: bets $0.3
Hero: folds
Uncalled bet ($0.3) returned to 88370224
*** SHOWDOWN ***
88370224 collected $0.54 from pot
*** SUMMARY ***
Total pot $0.56 | Rake $0.02 | Jackpot $0 | Bingo $0 | Fortune $0
Board [9s 2d 3d Kh]
Seat 3: 88370224 (big blind) won ($0.54)
Seat 4: c86f76e6 folded before Flop (didn't bet)
Seat 5: a6bde6ad (button) folded before Flop (didn't bet)
Seat 6: Hero (small blind) folded on the Turn


Poker Hand #HD1199221546: Hold'em No Limit  ($0.02/$0.05) - 2023/04/11 21:05:34
Table 'NLHBlue32' 6-max Seat #4 is the button
Seat 3: 88370224 ($7.41 in chips)
Seat 4: c86f76e6 ($3.05 in chips)
Seat 5: a6bde6ad ($5 in chips)
Seat 6: Hero ($8.88 in chips)
a6bde6ad: posts small blind $0.02
Hero: posts big blind $0.05
*** HOLE CARDS ***
Dealt to 88370224 
Dealt to c86f76e6 
Dealt to a6bde6ad 
Dealt to Hero [7h Ts]
88370224: folds
c86f76e6: raises $0.08 to $0.13
a6bde6ad: folds
Hero: folds
Uncalled bet ($0.08) returned to c86f76e6
*** SHOWDOWN ***
c86f76e6 collected $0.12 from pot
*** SUMMARY ***
Total pot $0.12 | Rake $0 | Jackpot $0 | Bingo $0 | Fortune $0
Seat 3: 88370224 folded before Flop (didn't bet)
Seat 4: c86f76e6 (button) collected ($0.12)
Seat 5: a6bde6ad (small blind) folded before Flop
Seat 6: Hero (big blind) folded before Flop


Poker Hand #HD1199221533: Hold'em No Limit  ($0.02/$0.05) - 2023/04/11 21:05:27
Table 'NLHBlue32' 6-max Seat #3 is the button
Seat 3: 88370224 ($7.41 in chips)
Seat 4: c86f76e6 ($3.07 in chips)
Seat 5: a6bde6ad ($5 in chips)
Seat 6: Hero ($8.81 in chips)
c86f76e6: posts small blind $0.02
a6bde6ad: posts big blind $0.05
*** HOLE CARDS ***
Dealt to 88370224 
Dealt to c86f76e6 
Dealt to a6bde6ad 
Dealt to Hero [Qh Th]
Hero: raises $0.07 to $0.12
88370224: folds
c86f76e6: folds
a6bde6ad: folds
Uncalled bet ($0.07) returned to Hero
*** SHOWDOWN ***
Hero collected $0.12 from pot
*** SUMMARY ***
Total pot $0.12 | Rake $0 | Jackpot $0 | Bingo $0 | Fortune $0
Seat 3: 88370224 (button) folded before Flop (didn't bet)
Seat 4: c86f76e6 (small blind) folded before Flop
Seat 5: a6bde6ad (big blind) folded before Flop
Seat 6: Hero collected ($0.12)


Poker Hand #HD1199221519: Hold'em No Limit  ($0.02/$0.05) - 2023/04/11 21:05:21
Table 'NLHBlue32' 6-max Seat #6 is the button
Seat 3: 88370224 ($7.43 in chips)
Seat 4: c86f76e6 ($3.05 in chips)
Seat 5: a6bde6ad ($5 in chips)
Seat 6: Hero ($8.81 in chips)
88370224: posts small blind $0.02
c86f76e6: posts big blind $0.05
*** HOLE CARDS ***
Dealt to 88370224 
Dealt to c86f76e6 
Dealt to a6bde6ad 
Dealt to Hero [9c Qd]
a6bde6ad: folds
Hero: folds
88370224: folds
Uncalled bet ($0.03) returned to c86f76e6
*** SHOWDOWN ***
c86f76e6 collected $0.04 from pot
*** SUMMARY ***
Total pot $0.04 | Rake $0 | Jackpot $0 | Bingo $0 | Fortune $0
Seat 3: 88370224 (small blind) folded before Flop
Seat 4: c86f76e6 (big blind) collected ($0.04)
Seat 5: a6bde6ad folded before Flop (didn't bet)
Seat 6: Hero (button) folded before Flop (didn't bet)


Poker Hand #HD1199221509: Hold'em No Limit  ($0.02/$0.05) - 2023/04/11 21:05:15
Table 'NLHBlue32' 6-max Seat #5 is the button
Seat 3: 88370224 ($7.41 in chips)
Seat 4: c86f76e6 ($3.05 in chips)
Seat 5: a6bde6ad ($5 in chips)
Seat 6: Hero ($8.83 in chips)
Hero: posts small blind $0.02
88370224: posts big blind $0.05
*** HOLE CARDS ***
Dealt to 88370224 
Dealt to c86f76e6 
Dealt to a6bde6ad 
Dealt to Hero [5c 4s]
c86f76e6: folds
a6bde6ad: folds
Hero: folds
Uncalled bet ($0.03) returned to 88370224
*** SHOWDOWN ***
88370224 collected $0.04 from pot
*** SUMMARY ***
Total pot $0.04 | Rake $0 | Jackpot $0 | Bingo $0 | Fortune $0
Seat 3: 88370224 (big blind) collected ($0.04)
Seat 4: c86f76e6 folded before Flop (didn't bet)
Seat 5: a6bde6ad (button) folded before Flop (didn't bet)
Seat 6: Hero (small blind) folded before Flop


Poker Hand #HD1199221461: Hold'em No Limit  ($0.02/$0.05) - 2023/04/11 21:04:57
Table 'NLHBlue32' 6-max Seat #4 is the button
Seat 2: 30ad5512 ($5.32 in chips)
Seat 3: 88370224 ($7.41 in chips)
Seat 4: c86f76e6 ($2.98 in chips)
Seat 5: a6bde6ad ($5 in chips)
Seat 6: Hero ($8.88 in chips)
a6bde6ad: posts small blind $0.02
Hero: posts big blind $0.05
*** HOLE CARDS ***
Dealt to 30ad5512 
Dealt to 88370224 
Dealt to c86f76e6 
Dealt to a6bde6ad 
Dealt to Hero [Ks 7c]
30ad5512: folds
88370224: folds
c86f76e6: raises $0.08 to $0.13
a6bde6ad: folds
Hero: folds
Uncalled bet ($0.08) returned to c86f76e6
*** SHOWDOWN ***
c86f76e6 collected $0.12 from pot
*** SUMMARY ***
Total pot $0.12 | Rake $0 | Jackpot $0 | Bingo $0 | Fortune $0
Seat 2: 30ad5512 folded before Flop (didn't bet)
Seat 3: 88370224 folded before Flop (didn't bet)
Seat 4: c86f76e6 (button) collected ($0.12)
Seat 5: a6bde6ad (small blind) folded before Flop
Seat 6: Hero (big blind) folded before Flop


Poker Hand #HD1199221437: Hold'em No Limit  ($0.02/$0.05) - 2023/04/11 21:04:44
Table 'NLHBlue32' 6-max Seat #3 is the button
Seat 2: 30ad5512 ($5.25 in chips)
Seat 3: 88370224 ($7.41 in chips)
Seat 4: c86f76e6 ($3 in chips)
Seat 5: a6bde6ad ($5 in chips)
Seat 6: Hero ($8.88 in chips)
c86f76e6: posts small blind $0.02
a6bde6ad: posts big blind $0.05
*** HOLE CARDS ***
Dealt to 30ad5512 
Dealt to 88370224 
Dealt to c86f76e6 
Dealt to a6bde6ad 
Dealt to Hero [8s 3c]
Hero: folds
30ad5512: raises $0.08 to $0.13
88370224: folds
c86f76e6: folds
a6bde6ad: folds
Uncalled bet ($0.08) returned to 30ad5512
*** SHOWDOWN ***
30ad5512 collected $0.12 from pot
*** SUMMARY ***
Total pot $0.12 | Rake $0 | Jackpot $0 | Bingo $0 | Fortune $0
Seat 2: 30ad5512 collected ($0.12)
Seat 3: 88370224 (button) folded before Flop (didn't bet)
Seat 4: c86f76e6 (small blind) folded before Flop
Seat 5: a6bde6ad (big blind) folded before Flop
Seat 6: Hero folded before Flop (didn't bet)


Poker Hand #HD1199221405: Hold'em No Limit  ($0.02/$0.05) - 2023/04/11 21:04:30
Table 'NLHBlue32' 6-max Seat #2 is the button
Seat 2: 30ad5512 ($5.25 in chips)
Seat 3: 88370224 ($7.43 in chips)
Seat 4: c86f76e6 ($2.98 in chips)
Seat 6: Hero ($8.88 in chips)
88370224: posts small blind $0.02
c86f76e6: posts big blind $0.05
*** HOLE CARDS ***
Dealt to 30ad5512 
Dealt to 88370224 
Dealt to c86f76e6 
Dealt to Hero [7h 9c]
Hero: folds
30ad5512: folds
88370224: folds
Uncalled bet ($0.03) returned to c86f76e6
*** SHOWDOWN ***
c86f76e6 collected $0.04 from pot
*** SUMMARY ***
Total pot $0.04 | Rake $0 | Jackpot $0 | Bingo $0 | Fortune $0
Seat 2: 30ad5512 (button) folded before Flop (didn't bet)
Seat 3: 88370224 (small blind) folded before Flop
Seat 4: c86f76e6 (big blind) collected ($0.04)
Seat 6: Hero folded before Flop (didn't bet)


Poker Hand #HD1199221384: Hold'em No Limit  ($0.02/$0.05) - 2023/04/11 21:04:20
Table 'NLHBlue32' 6-max Seat #6 is the button
Seat 2: 30ad5512 ($5.27 in chips)
Seat 3: 88370224 ($7.48 in chips)
Seat 4: c86f76e6 ($2.98 in chips)
Seat 6: Hero ($8.81 in chips)
30ad5512: posts small blind $0.02
88370224: posts big blind $0.05
*** HOLE CARDS ***
Dealt to 30ad5512 
Dealt to 88370224 
Dealt to c86f76e6 
Dealt to Hero [Kc Ac]
c86f76e6: folds
Hero: raises $0.07 to $0.12
30ad5512: folds
88370224: folds
Uncalled bet ($0.07) returned to Hero
*** SHOWDOWN ***
Hero collected $0.12 from pot
*** SUMMARY ***
Total pot $0.12 | Rake $0 | Jackpot $0 | Bingo $0 | Fortune $0
Seat 2: 30ad5512 (small blind) folded before Flop
Seat 3: 88370224 (big blind) folded before Flop
Seat 4: c86f76e6 folded before Flop (didn't bet)
Seat 6: Hero (button) collected ($0.12)


Poker Hand #HD1199221369: Hold'em No Limit  ($0.02/$0.05) - 2023/04/11 21:04:12
Table 'NLHBlue32' 6-max Seat #4 is the button
Seat 2: 30ad5512 ($5.25 in chips)
Seat 3: 88370224 ($7.48 in chips)
Seat 4: c86f76e6 ($2.98 in chips)
Seat 6: Hero ($8.83 in chips)
Hero: posts small blind $0.02
30ad5512: posts big blind $0.05
*** HOLE CARDS ***
Dealt to 30ad5512 
Dealt to 88370224 
Dealt to c86f76e6 
Dealt to Hero [Qc 4h]
88370224: folds
c86f76e6: folds
Hero: folds
Uncalled bet ($0.03) returned to 30ad5512
*** SHOWDOWN ***
30ad5512 collected $0.04 from pot
*** SUMMARY ***
Total pot $0.04 | Rake $0 | Jackpot $0 | Bingo $0 | Fortune $0
Seat 2: 30ad5512 (big blind) collected ($0.04)
Seat 3: 88370224 folded before Flop (didn't bet)
Seat 4: c86f76e6 (button) folded before Flop (didn't bet)
Seat 6: Hero (small blind) folded before Flop


Poker Hand #HD1199221347: Hold'em No Limit  ($0.02/$0.05) - 2023/04/11 21:04:01
Table 'NLHBlue32' 6-max Seat #3 is the button
Seat 2: 30ad5512 ($5.25 in chips)
Seat 3: 88370224 ($7.48 in chips)
Seat 4: c86f76e6 ($3 in chips)
Seat 6: Hero ($8.81 in chips)
c86f76e6: posts small blind $0.02
Hero: posts big blind $0.05
*** HOLE CARDS ***
Dealt to 30ad5512 
Dealt to 88370224 
Dealt to c86f76e6 
Dealt to Hero [7s 4h]
30ad5512: folds
88370224: folds
c86f76e6: folds
Uncalled bet ($0.03) returned to Hero
*** SHOWDOWN ***
Hero collected $0.04 from pot
*** SUMMARY ***
Total pot $0.04 | Rake $0 | Jackpot $0 | Bingo $0 | Fortune $0
Seat 2: 30ad5512 folded before Flop (didn't bet)
Seat 3: 88370224 (button) folded before Flop (didn't bet)
Seat 4: c86f76e6 (small blind) folded before Flop
Seat 6: Hero (big blind) collected ($0.04)


Poker Hand #HD1199221307: Hold'em No Limit  ($0.02/$0.05) - 2023/04/11 21:03:39
Table 'NLHBlue32' 6-max Seat #2 is the button
Seat 2: 30ad5512 ($5.25 in chips)
Seat 3: 88370224 ($7.5 in chips)
Seat 4: c86f76e6 ($2.98 in chips)
Seat 6: Hero ($8.81 in chips)
88370224: posts small blind $0.02
c86f76e6: posts big blind $0.05
*** HOLE CARDS ***
Dealt to 30ad5512 
Dealt to 88370224 
Dealt to c86f76e6 
Dealt to Hero [5d Ah]
Hero: folds
30ad5512: folds
88370224: folds
Uncalled bet ($0.03) returned to c86f76e6
*** SHOWDOWN ***
c86f76e6 collected $0.04 from pot
*** SUMMARY ***
Total pot $0.04 | Rake $0 | Jackpot $0 | Bingo $0 | Fortune $0
Seat 2: 30ad5512 (button) folded before Flop (didn't bet)
Seat 3: 88370224 (small blind) folded before Flop
Seat 4: c86f76e6 (big blind) collected ($0.04)
Seat 6: Hero folded before Flop (didn't bet)


Poker Hand #HD1199221276: Hold'em No Limit  ($0.02/$0.05) - 2023/04/11 21:03:26
Table 'NLHBlue32' 6-max Seat #6 is the button
Seat 2: 30ad5512 ($5.27 in chips)
Seat 3: 88370224 ($7.55 in chips)
Seat 4: c86f76e6 ($2.91 in chips)
Seat 6: Hero ($8.81 in chips)
30ad5512: posts small blind $0.02
88370224: posts big blind $0.05
*** HOLE CARDS ***
Dealt to 30ad5512 
Dealt to 88370224 
Dealt to c86f76e6 
Dealt to Hero [5d 7h]
c86f76e6: raises $0.07 to $0.12
Hero: folds
30ad5512: folds
88370224: folds
Uncalled bet ($0.07) returned to c86f76e6
*** SHOWDOWN ***
c86f76e6 collected $0.12 from pot
*** SUMMARY ***
Total pot $0.12 | Rake $0 | Jackpot $0 | Bingo $0 | Fortune $0
Seat 2: 30ad5512 (small blind) folded before Flop
Seat 3: 88370224 (big blind) folded before Flop
Seat 4: c86f76e6 collected ($0.12)
Seat 6: Hero (button) folded before Flop (didn't bet)


Poker Hand #HD1199221218: Hold'em No Limit  ($0.02/$0.05) - 2023/04/11 21:02:55
Table 'NLHBlue32' 6-max Seat #4 is the button
Seat 2: 30ad5512 ($5.14 in chips)
Seat 3: 88370224 ($7.55 in chips)
Seat 4: c86f76e6 ($3.03 in chips)
Seat 6: Hero ($8.83 in chips)
Hero: posts small blind $0.02
30ad5512: posts big blind $0.05
*** HOLE CARDS ***
Dealt to 30ad5512 
Dealt to 88370224 
Dealt to c86f76e6 
Dealt to Hero [Ah 7c]
88370224: folds
c86f76e6: raises $0.07 to $0.12
Hero: folds
30ad5512: calls $0.07
*** FLOP *** [Jc 3d 7s]
30ad5512: bets $0.13
c86f76e6: folds
Uncalled bet ($0.13) returned to 30ad5512
*** SHOWDOWN ***
30ad5512 collected $0.25 from pot
*** SUMMARY ***
Total pot $0.26 | Rake $0.01 | Jackpot $0 | Bingo $0 | Fortune $0
Board [Jc 3d 7s]
Seat 2: 30ad5512 (big blind) won ($0.25)
Seat 3: 88370224 folded before Flop (didn't bet)
Seat 4: c86f76e6 (button) folded on the Flop
Seat 6: Hero (small blind) folded before Flop


Poker Hand #HD1199221134: Hold'em No Limit  ($0.02/$0.05) - 2023/04/11 21:02:15
Table 'NLHBlue32' 6-max Seat #3 is the button
Seat 2: 30ad5512 ($5.14 in chips)
Seat 3: 88370224 ($7.55 in chips)
Seat 4: c86f76e6 ($3.61 in chips)
Seat 6: Hero ($8.3 in chips)
c86f76e6: posts small blind $0.02
Hero: posts big blind $0.05
*** HOLE CARDS ***
Dealt to 30ad5512 
Dealt to 88370224 
Dealt to c86f76e6 
Dealt to Hero [Kh 5h]
30ad5512: folds
88370224: folds
c86f76e6: raises $0.07 to $0.12
Hero: calls $0.07
*** FLOP *** [Td Ah Jh]
c86f76e6: bets $0.14
Hero: raises $0.32 to $0.46
c86f76e6: calls $0.32
*** TURN *** [Td Ah Jh] [9s]
c86f76e6: checks
Hero: bets $0.87
c86f76e6: folds
Uncalled bet ($0.87) returned to Hero
*** SHOWDOWN ***
Hero collected $1.11 from pot
*** SUMMARY ***
Total pot $1.16 | Rake $0.05 | Jackpot $0 | Bingo $0 | Fortune $0
Board [Td Ah Jh 9s]
Seat 2: 30ad5512 folded before Flop (didn't bet)
Seat 3: 88370224 (button) folded before Flop (didn't bet)
Seat 4: c86f76e6 (small blind) folded on the Turn
Seat 6: Hero (big blind) won ($1.11)


Poker Hand #HD1199221090: Hold'em No Limit  ($0.02/$0.05) - 2023/04/11 21:01:57
Table 'NLHBlue32' 6-max Seat #2 is the button
Seat 2: 30ad5512 ($5 in chips)
Seat 3: 88370224 ($7.57 in chips)
Seat 4: c86f76e6 ($3.74 in chips)
Seat 6: Hero ($8.3 in chips)
88370224: posts small blind $0.02
c86f76e6: posts big blind $0.05
*** HOLE CARDS ***
Dealt to 30ad5512 
Dealt to 88370224 
Dealt to c86f76e6 
Dealt to Hero [Td 3h]
Hero: folds
30ad5512: raises $0.08 to $0.13
88370224: folds
c86f76e6: calls $0.08
*** FLOP *** [8c 2d Jh]
c86f76e6: checks
30ad5512: bets $0.14
c86f76e6: folds
Uncalled bet ($0.14) returned to 30ad5512
*** SHOWDOWN ***
30ad5512 collected $0.27 from pot
*** SUMMARY ***
Total pot $0.28 | Rake $0.01 | Jackpot $0 | Bingo $0 | Fortune $0
Board [8c 2d Jh]
Seat 2: 30ad5512 (button) won ($0.27)
Seat 3: 88370224 (small blind) folded before Flop
Seat 4: c86f76e6 (big blind) folded on the Flop
Seat 6: Hero folded before Flop (didn't bet)


Poker Hand #HD1199220999: Hold'em No Limit  ($0.02/$0.05) - 2023/04/11 21:01:12
Table 'NLHBlue32' 6-max Seat #1 is the button
Seat 1: 2a59c51a ($0.67 in chips)
Seat 2: 30ad5512 ($5 in chips)
Seat 3: 88370224 ($7.27 in chips)
Seat 4: c86f76e6 ($3.74 in chips)
Seat 6: Hero ($8.61 in chips)
30ad5512: posts small blind $0.02
88370224: posts big blind $0.05
*** HOLE CARDS ***
Dealt to 2a59c51a 
Dealt to 30ad5512 
Dealt to 88370224 
Dealt to c86f76e6 
Dealt to Hero [Js As]
c86f76e6: folds
Hero: raises $0.07 to $0.12
2a59c51a: folds
30ad5512: folds
88370224: raises $0.19 to $0.31
Hero: calls $0.19
*** FLOP *** [8d 5h 7c]
88370224: checks
Hero: checks
*** TURN *** [8d 5h 7c] [Th]
88370224: checks
Hero: checks
*** RIVER *** [8d 5h 7c Th] [7h]
88370224: checks
Hero: checks
88370224: shows [Qd Ac] (Pair of Sevens)
Hero: shows [Js As] (Pair of Sevens)
*** SHOWDOWN ***
88370224 collected $0.61 from pot
*** SUMMARY ***
Total pot $0.64 | Rake $0.03 | Jackpot $0 | Bingo $0 | Fortune $0
Board [8d 5h 7c Th 7h]
Seat 1: 2a59c51a (button) folded before Flop (didn't bet)
Seat 2: 30ad5512 (small blind) folded before Flop
Seat 3: 88370224 (big blind) showed [Qd Ac] and won ($0.61) with Pair of Sevens
Seat 4: c86f76e6 folded before Flop (didn't bet)
Seat 6: Hero showed [Js As] and lost with Pair of Sevens


Poker Hand #HD1199220845: Hold'em No Limit  ($0.02/$0.05) - 2023/04/11 21:00:01
Table 'NLHBlue32' 6-max Seat #6 is the button
Seat 1: 2a59c51a ($4.68 in chips)
Seat 2: 30ad5512 ($5 in chips)
Seat 3: 88370224 ($7.27 in chips)
Seat 4: c86f76e6 ($3.74 in chips)
Seat 6: Hero ($5 in chips)
2a59c51a: posts small blind $0.02
30ad5512: posts big blind $0.05
*** HOLE CARDS ***
Dealt to 2a59c51a 
Dealt to 30ad5512 
Dealt to 88370224 
Dealt to c86f76e6 
Dealt to Hero [Kc Ks]
88370224: folds
c86f76e6: folds
Hero: raises $0.07 to $0.12
2a59c51a: calls $0.1
30ad5512: folds
*** FLOP *** [Kh Jd 4d]
2a59c51a: checks
Hero: bets $0.22
2a59c51a: calls $0.22
*** TURN *** [Kh Jd 4d] [2c]
2a59c51a: checks
Hero: bets $0.64
2a59c51a: calls $0.64
*** RIVER *** [Kh Jd 4d 2c] [Ad]
2a59c51a: checks
Hero: bets $1.01
2a59c51a: raises $2.02 to $3.03
Hero: calls $2.02
2a59c51a: shows [Js 2d] (Pair of Jacks and Pair of Twos)
Hero: shows [Kc Ks] (Three Kings)
*** SHOWDOWN ***
Hero collected $7.62 from pot
*** SUMMARY ***
Total pot $8.07 | Rake $0.4 | Jackpot $0.05 | Bingo $0 | Fortune $0
Board [Kh Jd 4d 2c Ad]
Seat 1: 2a59c51a (small blind) showed [Js 2d] and lost with Pair of Jacks and Pair of Twos
Seat 2: 30ad5512 (big blind) folded before Flop
Seat 3: 88370224 folded before Flop (didn't bet)
Seat 4: c86f76e6 folded before Flop (didn't bet)
Seat 6: Hero (button) showed [Kc Ks] and won ($7.62) with Three Kings


Poker Hand #HD1199220774: Hold'em No Limit  ($0.02/$0.05) - 2023/04/11 20:59:29
Table 'NLHBlue32' 6-max Seat #4 is the button
Seat 1: 2a59c51a ($4.42 in chips)
Seat 2: 58d93a83 ($1.01 in chips)
Seat 3: 88370224 ($7.27 in chips)
Seat 4: c86f76e6 ($3.74 in chips)
Seat 6: Hero ($5.07 in chips)
Hero: posts small blind $0.02
2a59c51a: posts big blind $0.05
*** HOLE CARDS ***
Dealt to 2a59c51a 
Dealt to 58d93a83 
Dealt to 88370224 
Dealt to c86f76e6 
Dealt to Hero [Ad 2d]
58d93a83: folds
88370224: folds
c86f76e6: folds
Hero: raises $0.09 to $0.14
2a59c51a: calls $0.09
*** FLOP *** [7d Qs Ks]
Hero: bets $0.14
2a59c51a: calls $0.14
*** TURN *** [7d Qs Ks] [5s]
Hero: checks
2a59c51a: bets $0.19
Hero: folds
Uncalled bet ($0.19) returned to 2a59c51a
*** SHOWDOWN ***
2a59c51a collected $0.54 from pot
*** SUMMARY ***
Total pot $0.56 | Rake $0.02 | Jackpot $0 | Bingo $0 | Fortune $0
Board [7d Qs Ks 5s]
Seat 1: 2a59c51a (big blind) won ($0.54)
Seat 2: 58d93a83 folded before Flop (didn't bet)
Seat 3: 88370224 folded before Flop (didn't bet)
Seat 4: c86f76e6 (button) folded before Flop (didn't bet)
Seat 6: Hero (small blind) folded on the Turn


Poker Hand #HD1199220703: Hold'em No Limit  ($0.02/$0.05) - 2023/04/11 20:58:55
Table 'NLHBlue32' 6-max Seat #3 is the button
Seat 1: 2a59c51a ($4.28 in chips)
Seat 2: 58d93a83 ($1.06 in chips)
Seat 3: 88370224 ($7.27 in chips)
Seat 4: c86f76e6 ($3.79 in chips)
Seat 6: Hero ($5.12 in chips)
c86f76e6: posts small blind $0.02
Hero: posts big blind $0.05
58d93a83: posts big blind $0.05
*** HOLE CARDS ***
Dealt to 2a59c51a 
Dealt to 58d93a83 
Dealt to 88370224 
Dealt to c86f76e6 
Dealt to Hero [9s 3s]
2a59c51a: calls $0.05
58d93a83: checks
88370224: folds
c86f76e6: calls $0.03
Hero: checks
*** FLOP *** [Ad Ts 6c]
c86f76e6: checks
Hero: checks
2a59c51a: bets $0.07
58d93a83: folds
c86f76e6: folds
Hero: folds
Uncalled bet ($0.07) returned to 2a59c51a
*** SHOWDOWN ***
2a59c51a collected $0.19 from pot
*** SUMMARY ***
Total pot $0.2 | Rake $0.01 | Jackpot $0 | Bingo $0 | Fortune $0
Board [Ad Ts 6c]
Seat 1: 2a59c51a won ($0.19)
Seat 2: 58d93a83 folded on the Flop
Seat 3: 88370224 (button) folded before Flop (didn't bet)
Seat 4: c86f76e6 (small blind) folded on the Flop
Seat 6: Hero (big blind) folded on the Flop


Poker Hand #HD1199220653: Hold'em No Limit  ($0.02/$0.05) - 2023/04/11 20:58:34
Table 'NLHBlue32' 6-max Seat #1 is the button
Seat 1: 2a59c51a ($4.21 in chips)
Seat 3: 88370224 ($7.29 in chips)
Seat 4: c86f76e6 ($3.84 in chips)
Seat 6: Hero ($5.12 in chips)
88370224: posts small blind $0.02
c86f76e6: posts big blind $0.05
*** HOLE CARDS ***
Dealt to 2a59c51a 
Dealt to 88370224 
Dealt to c86f76e6 
Dealt to Hero [6s 5c]
Hero: folds
2a59c51a: calls $0.05
88370224: folds
c86f76e6: checks
*** FLOP *** [6d Jh Th]
c86f76e6: checks
2a59c51a: checks
*** TURN *** [6d Jh Th] [Qs]
c86f76e6: checks
2a59c51a: checks
*** RIVER *** [6d Jh Th Qs] [8c]
c86f76e6: checks
2a59c51a: bets $0.06
c86f76e6: folds
Uncalled bet ($0.06) returned to 2a59c51a
*** SHOWDOWN ***
2a59c51a collected $0.12 from pot
*** SUMMARY ***
Total pot $0.12 | Rake $0 | Jackpot $0 | Bingo $0 | Fortune $0
Board [6d Jh Th Qs 8c]
Seat 1: 2a59c51a (button) won ($0.12)
Seat 3: 88370224 (small blind) folded before Flop
Seat 4: c86f76e6 (big blind) folded on the River
Seat 6: Hero folded before Flop (didn't bet)


Poker Hand #HD1199220585: Hold'em No Limit  ($0.02/$0.05) - 2023/04/11 20:57:58
Table 'NLHBlue32' 6-max Seat #6 is the button
Seat 1: 2a59c51a ($4.46 in chips)
Seat 3: 88370224 ($7.34 in chips)
Seat 4: c86f76e6 ($3.56 in chips)
Seat 6: Hero ($5.12 in chips)
2a59c51a: posts small blind $0.02
88370224: posts big blind $0.05
*** HOLE CARDS ***
Dealt to 2a59c51a 
Dealt to 88370224 
Dealt to c86f76e6 
Dealt to Hero [Ks 5d]
c86f76e6: raises $0.09 to $0.14
Hero: folds
2a59c51a: calls $0.12
88370224: folds
*** FLOP *** [9s 5c Ts]
2a59c51a: checks
c86f76e6: checks
*** TURN *** [9s 5c Ts] [2c]
2a59c51a: checks
c86f76e6: checks
*** RIVER *** [9s 5c Ts 2c] [9c]
2a59c51a: bets $0.11
c86f76e6: calls $0.11
2a59c51a: shows [6s Kh] (Pair of Nines)
c86f76e6: shows [Ah Kd] (Pair of Nines)
*** SHOWDOWN ***
c86f76e6 collected $0.53 from pot
*** SUMMARY ***
Total pot $0.55 | Rake $0.02 | Jackpot $0 | Bingo $0 | Fortune $0
Board [9s 5c Ts 2c 9c]
Seat 1: 2a59c51a (small blind) showed [6s Kh] and lost with Pair of Nines
Seat 3: 88370224 (big blind) folded before Flop
Seat 4: c86f76e6 showed [Ah Kd] and won ($0.53) with Pair of Nines
Seat 6: Hero (button) folded before Flop (didn't bet)


Poker Hand #HD1199220502: Hold'em No Limit  ($0.02/$0.05) - 2023/04/11 20:57:24
Table 'NLHBlue32' 6-max Seat #4 is the button
Seat 1: 2a59c51a ($4.32 in chips)
Seat 3: 88370224 ($7.34 in chips)
Seat 4: c86f76e6 ($3.69 in chips)
Seat 6: Hero ($5.14 in chips)
Hero: posts small blind $0.02
2a59c51a: posts big blind $0.05
*** HOLE CARDS ***
Dealt to 2a59c51a 
Dealt to 88370224 
Dealt to c86f76e6 
Dealt to Hero [5s 4c]
88370224: folds
c86f76e6: raises $0.08 to $0.13
Hero: folds
2a59c51a: calls $0.08
*** FLOP *** [Jc 8s Js]
2a59c51a: bets $0.1
c86f76e6: folds
Uncalled bet ($0.1) returned to 2a59c51a
*** SHOWDOWN ***
2a59c51a collected $0.27 from pot
*** SUMMARY ***
Total pot $0.28 | Rake $0.01 | Jackpot $0 | Bingo $0 | Fortune $0
Board [Jc 8s Js]
Seat 1: 2a59c51a (big blind) won ($0.27)
Seat 3: 88370224 folded before Flop (didn't bet)
Seat 4: c86f76e6 (button) folded on the Flop
Seat 6: Hero (small blind) folded before Flop


Poker Hand #HD1199220492: Hold'em No Limit  ($0.02/$0.05) - 2023/04/11 20:57:17
Table 'NLHBlue32' 6-max Seat #3 is the button
Seat 1: 2a59c51a ($4.32 in chips)
Seat 3: 88370224 ($7.34 in chips)
Seat 4: c86f76e6 ($3.71 in chips)
Seat 6: Hero ($5.12 in chips)
c86f76e6: posts small blind $0.02
Hero: posts big blind $0.05
*** HOLE CARDS ***
Dealt to 2a59c51a 
Dealt to 88370224 
Dealt to c86f76e6 
Dealt to Hero [As 5h]
2a59c51a: folds
88370224: folds
c86f76e6: folds
Uncalled bet ($0.03) returned to Hero
*** SHOWDOWN ***
Hero collected $0.04 from pot
*** SUMMARY ***
Total pot $0.04 | Rake $0 | Jackpot $0 | Bingo $0 | Fortune $0
Seat 1: 2a59c51a folded before Flop (didn't bet)
Seat 3: 88370224 (button) folded before Flop (didn't bet)
Seat 4: c86f76e6 (small blind) folded before Flop
Seat 6: Hero (big blind) collected ($0.04)


Poker Hand #HD1199220476: Hold'em No Limit  ($0.02/$0.05) - 2023/04/11 20:57:07
Table 'NLHBlue32' 6-max Seat #2 is the button
Seat 1: 2a59c51a ($4.32 in chips)
Seat 2: 40093001 ($3.72 in chips)
Seat 3: 88370224 ($7.36 in chips)
Seat 4: c86f76e6 ($3.76 in chips)
Seat 6: Hero ($5.05 in chips)
88370224: posts small blind $0.02
c86f76e6: posts big blind $0.05
*** HOLE CARDS ***
Dealt to 2a59c51a 
Dealt to 40093001 
Dealt to 88370224 
Dealt to c86f76e6 
Dealt to Hero [9d 9s]
Hero: raises $0.07 to $0.12
2a59c51a: folds
40093001: folds
88370224: folds
c86f76e6: folds
Uncalled bet ($0.07) returned to Hero
*** SHOWDOWN ***
Hero collected $0.12 from pot
*** SUMMARY ***
Total pot $0.12 | Rake $0 | Jackpot $0 | Bingo $0 | Fortune $0
Seat 1: 2a59c51a folded before Flop (didn't bet)
Seat 2: 40093001 (button) folded before Flop (didn't bet)
Seat 3: 88370224 (small blind) folded before Flop
Seat 4: c86f76e6 (big blind) folded before Flop
Seat 6: Hero collected ($0.12)


Poker Hand #HD1199220352: Hold'em No Limit  ($0.02/$0.05) - 2023/04/11 20:56:11
Table 'NLHBlue32' 6-max Seat #1 is the button
Seat 1: 2a59c51a ($4.32 in chips)
Seat 2: 40093001 ($3.96 in chips)
Seat 3: 88370224 ($7.3 in chips)
Seat 4: c86f76e6 ($3.76 in chips)
Seat 6: Hero ($5 in chips)
40093001: posts small blind $0.02
88370224: posts big blind $0.05
*** HOLE CARDS ***
Dealt to 2a59c51a 
Dealt to 40093001 
Dealt to 88370224 
Dealt to c86f76e6 
Dealt to Hero [Ks Jc]
c86f76e6: folds
Hero: raises $0.07 to $0.12
2a59c51a: folds
40093001: calls $0.1
88370224: calls $0.07
*** FLOP *** [5c 9d Qc]
40093001: bets $0.12
88370224: calls $0.12
Hero: calls $0.12
*** TURN *** [5c 9d Qc] [2c]
40093001: checks
88370224: bets $0.53
Hero: calls $0.53
40093001: folds
*** RIVER *** [5c 9d Qc 2c] [6d]
88370224: checks
Hero: checks
88370224: shows [Jd Kc] (King-High)
Hero: shows [Ks Jc] (King-High)
40093001: shows [4d 3d] (Sixes-High Straight)
*** SHOWDOWN ***
88370224 collected $0.83 from pot
Hero collected $0.82 from pot
*** SUMMARY ***
Total pot $1.78 | Rake $0.08 | Jackpot $0.05 | Bingo $0 | Fortune $0
Board [5c 9d Qc 2c 6d]
Seat 1: 2a59c51a (button) folded before Flop (didn't bet)
Seat 2: 40093001 (small blind) folded on the Turn
Seat 3: 88370224 (big blind) showed [Jd Kc] and won ($0.83) with King-High
Seat 4: c86f76e6 folded before Flop (didn't bet)
Seat 6: Hero showed [Ks Jc] and won ($0.82) with King-High


Poker Hand #HD1199220249: Hold'em No Limit  ($0.02/$0.05) - 2023/04/11 20:55:26
Table 'NLHBlue32' 6-max Seat #6 is the button
Seat 1: 2a59c51a ($3.51 in chips)
Seat 2: 40093001 ($4.61 in chips)
Seat 3: 88370224 ($7.3 in chips)
Seat 4: c86f76e6 ($3.9 in chips)
Seat 6: Hero ($5 in chips)
2a59c51a: posts small blind $0.02
40093001: posts big blind $0.05
*** HOLE CARDS ***
Dealt to 2a59c51a 
Dealt to 40093001 
Dealt to 88370224 
Dealt to c86f76e6 
Dealt to Hero [9s As]
88370224: folds
c86f76e6: raises $0.09 to $0.14
Hero: calls $0.14
2a59c51a: calls $0.12
40093001: calls $0.09
*** FLOP *** [Jh 8d 9d]
2a59c51a: bets $0.19
40093001: calls $0.19
c86f76e6: folds
Hero: folds
*** TURN *** [Jh 8d 9d] [2c]
2a59c51a: bets $0.32
40093001: calls $0.32
*** RIVER *** [Jh 8d 9d 2c] [4s]
2a59c51a: bets $0.53
40093001: folds
Uncalled bet ($0.53) returned to 2a59c51a
*** SHOWDOWN ***
2a59c51a collected $1.46 from pot
*** SUMMARY ***
Total pot $1.58 | Rake $0.07 | Jackpot $0.05 | Bingo $0 | Fortune $0
Board [Jh 8d 9d 2c 4s]
Seat 1: 2a59c51a (small blind) won ($1.46)
Seat 2: 40093001 (big blind) folded on the River
Seat 3: 88370224 folded before Flop (didn't bet)
Seat 4: c86f76e6 folded on the Flop
Seat 6: Hero (button) folded on the Flop


Poker Hand #HD1199220173: Hold'em No Limit  ($0.02/$0.05) - 2023/04/11 20:54:49
Table 'NLHBlue32' 6-max Seat #5 is the button
Seat 1: 2a59c51a ($3.56 in chips)
Seat 2: 40093001 ($4.61 in chips)
Seat 3: 88370224 ($7.3 in chips)
Seat 4: c86f76e6 ($3.9 in chips)
Seat 5: e2804f12 ($7.38 in chips)
Seat 6: Hero ($5.02 in chips)
Hero: posts small blind $0.02
2a59c51a: posts big blind $0.05
*** HOLE CARDS ***
Dealt to 2a59c51a 
Dealt to 40093001 
Dealt to 88370224 
Dealt to c86f76e6 
Dealt to e2804f12 
Dealt to Hero [Qh As]
40093001: folds
88370224: folds
c86f76e6: folds
e2804f12: raises $0.1 to $0.15
Hero: raises $0.43 to $0.58
2a59c51a: folds
e2804f12: raises $6.8 to $7.38 and is all-in
Hero: folds
Uncalled bet ($6.8) returned to e2804f12
*** SHOWDOWN ***
e2804f12 collected $1.15 from pot
*** SUMMARY ***
Total pot $1.21 | Rake $0.06 | Jackpot $0 | Bingo $0 | Fortune $0
Seat 1: 2a59c51a (big blind) folded before Flop
Seat 2: 40093001 folded before Flop (didn't bet)
Seat 3: 88370224 folded before Flop (didn't bet)
Seat 4: c86f76e6 folded before Flop (didn't bet)
Seat 5: e2804f12 (button) collected ($1.15)
Seat 6: Hero (small blind) folded before Flop


Poker Hand #HD1199220124: Hold'em No Limit  ($0.02/$0.05) - 2023/04/11 20:54:29
Table 'NLHBlue32' 6-max Seat #4 is the button
Seat 1: 2a59c51a ($3.56 in chips)
Seat 2: 40093001 ($4.61 in chips)
Seat 3: 88370224 ($7.3 in chips)
Seat 4: c86f76e6 ($3.9 in chips)
Seat 5: e2804f12 ($7.4 in chips)
Seat 6: Hero ($5 in chips)
e2804f12: posts small blind $0.02
Hero: posts big blind $0.05
*** HOLE CARDS ***
Dealt to 2a59c51a 
Dealt to 40093001 
Dealt to 88370224 
Dealt to c86f76e6 
Dealt to e2804f12 
Dealt to Hero [Kd Tc]
2a59c51a: folds
40093001: folds
88370224: folds
c86f76e6: folds
e2804f12: folds
Uncalled bet ($0.03) returned to Hero
*** SHOWDOWN ***
Hero collected $0.04 from pot
*** SUMMARY ***
Total pot $0.04 | Rake $0 | Jackpot $0 | Bingo $0 | Fortune $0
Seat 1: 2a59c51a folded before Flop (didn't bet)
Seat 2: 40093001 folded before Flop (didn't bet)
Seat 3: 88370224 folded before Flop (didn't bet)
Seat 4: c86f76e6 (button) folded before Flop (didn't bet)
Seat 5: e2804f12 (small blind) folded before Flop
Seat 6: Hero (big blind) collected ($0.04)


Poker Hand #HD1199220078: Hold'em No Limit  ($0.02/$0.05) - 2023/04/11 20:54:08
Table 'NLHBlue32' 6-max Seat #3 is the button
Seat 1: 2a59c51a ($3.49 in chips)
Seat 2: 40093001 ($4.61 in chips)
Seat 3: 88370224 ($7.3 in chips)
Seat 4: c86f76e6 ($3.92 in chips)
Seat 5: e2804f12 ($7.45 in chips)
Seat 6: Hero ($5 in chips)
c86f76e6: posts small blind $0.02
e2804f12: posts big blind $0.05
*** HOLE CARDS ***
Dealt to 2a59c51a 
Dealt to 40093001 
Dealt to 88370224 
Dealt to c86f76e6 
Dealt to e2804f12 
Dealt to Hero [3h 2c]
Hero: folds
2a59c51a: calls $0.05
40093001: folds
88370224: folds
c86f76e6: folds
e2804f12: checks
*** FLOP *** [9c Jc 8d]
e2804f12: checks
2a59c51a: bets $0.12
e2804f12: folds
Uncalled bet ($0.12) returned to 2a59c51a
*** SHOWDOWN ***
2a59c51a collected $0.12 from pot
*** SUMMARY ***
Total pot $0.12 | Rake $0 | Jackpot $0 | Bingo $0 | Fortune $0
Board [9c Jc 8d]
Seat 1: 2a59c51a won ($0.12)
Seat 2: 40093001 folded before Flop (didn't bet)
Seat 3: 88370224 (button) folded before Flop (didn't bet)
Seat 4: c86f76e6 (small blind) folded before Flop
Seat 5: e2804f12 (big blind) folded on the Flop
Seat 6: Hero folded before Flop (didn't bet)


Poker Hand #HD1199220052: Hold'em No Limit  ($0.02/$0.05) - 2023/04/11 20:53:54
Table 'NLHBlue32' 6-max Seat #2 is the button
Seat 1: 2a59c51a ($3.49 in chips)
Seat 2: 40093001 ($4.61 in chips)
Seat 3: 88370224 ($7.32 in chips)
Seat 4: c86f76e6 ($3.97 in chips)
Seat 5: e2804f12 ($7.38 in chips)
Seat 6: Hero ($5 in chips)
88370224: posts small blind $0.02
c86f76e6: posts big blind $0.05
*** HOLE CARDS ***
Dealt to 2a59c51a 
Dealt to 40093001 
Dealt to 88370224 
Dealt to c86f76e6 
Dealt to e2804f12 
Dealt to Hero [Kc 7s]
e2804f12: raises $0.08 to $0.13
Hero: folds
2a59c51a: folds
40093001: folds
88370224: folds
c86f76e6: folds
Uncalled bet ($0.08) returned to e2804f12
*** SHOWDOWN ***
e2804f12 collected $0.12 from pot
*** SUMMARY ***
Total pot $0.12 | Rake $0 | Jackpot $0 | Bingo $0 | Fortune $0
Seat 1: 2a59c51a folded before Flop (didn't bet)
Seat 2: 40093001 (button) folded before Flop (didn't bet)
Seat 3: 88370224 (small blind) folded before Flop
Seat 4: c86f76e6 (big blind) folded before Flop
Seat 5: e2804f12 collected ($0.12)
Seat 6: Hero folded before Flop (didn't bet)


Poker Hand #HD1199219819: Hold'em No Limit  ($0.02/$0.05) - 2023/04/11 20:52:06
Table 'NLHBlue32' 6-max Seat #1 is the button
Seat 1: 2a59c51a ($3.88 in chips)
Seat 2: 40093001 ($4.63 in chips)
Seat 3: 88370224 ($5 in chips)
Seat 4: c86f76e6 ($6.16 in chips)
Seat 5: e2804f12 ($7.38 in chips)
Seat 6: Hero ($5 in chips)
40093001: posts small blind $0.02
88370224: posts big blind $0.05
*** HOLE CARDS ***
Dealt to 2a59c51a 
Dealt to 40093001 
Dealt to 88370224 
Dealt to c86f76e6 
Dealt to e2804f12 
Dealt to Hero [6d 5s]
c86f76e6: raises $0.09 to $0.14
e2804f12: folds
Hero: folds
2a59c51a: calls $0.14
40093001: folds
88370224: calls $0.09
*** FLOP *** [7d Ts 9c]
88370224: checks
c86f76e6: bets $0.25
2a59c51a: calls $0.25
88370224: raises $0.6 to $0.85
c86f76e6: calls $0.6
2a59c51a: folds
*** TURN *** [7d Ts 9c] [7c]
88370224: bets $1.2
c86f76e6: calls $1.2
*** RIVER *** [7d Ts 9c 7c] [3h]
88370224: bets $1.2
c86f76e6: folds
Uncalled bet ($1.2) returned to 88370224
*** SHOWDOWN ***
88370224 collected $4.51 from pot
*** SUMMARY ***
Total pot $4.79 | Rake $0.23 | Jackpot $0.05 | Bingo $0 | Fortune $0
Board [7d Ts 9c 7c 3h]
Seat 1: 2a59c51a (button) folded on the Flop
Seat 2: 40093001 (small blind) folded before Flop
Seat 3: 88370224 (big blind) won ($4.51)
Seat 4: c86f76e6 folded on the River
Seat 5: e2804f12 folded before Flop (didn't bet)
Seat 6: Hero folded before Flop (didn't bet)


Poker Hand #HD1199219707: Hold'em No Limit  ($0.02/$0.05) - 2023/04/11 20:51:20
Table 'NLHBlue32' 6-max Seat #6 is the button
Seat 1: 2a59c51a ($4.18 in chips)
Seat 2: 40093001 ($4.68 in chips)
Seat 3: 88370224 ($5 in chips)
Seat 4: c86f76e6 ($5.71 in chips)
Seat 5: e2804f12 ($7.52 in chips)
Seat 6: Hero ($5 in chips)
2a59c51a: posts small blind $0.02
40093001: posts big blind $0.05
*** HOLE CARDS ***
Dealt to 2a59c51a 
Dealt to 40093001 
Dealt to 88370224 
Dealt to c86f76e6 
Dealt to e2804f12 
Dealt to Hero [Kc 7d]
88370224: folds
c86f76e6: raises $0.09 to $0.14
e2804f12: calls $0.14
Hero: folds
2a59c51a: calls $0.12
40093001: folds
*** FLOP *** [As 5h 2d]
2a59c51a: bets $0.16
c86f76e6: calls $0.16
e2804f12: folds
*** TURN *** [As 5h 2d] [9d]
2a59c51a: checks
c86f76e6: bets $0.46
2a59c51a: folds
Uncalled bet ($0.46) returned to c86f76e6
*** SHOWDOWN ***
c86f76e6 collected $0.75 from pot
*** SUMMARY ***
Total pot $0.79 | Rake $0.04 | Jackpot $0 | Bingo $0 | Fortune $0
Board [As 5h 2d 9d]
Seat 1: 2a59c51a (small blind) folded on the Turn
Seat 2: 40093001 (big blind) folded before Flop
Seat 3: 88370224 folded before Flop (didn't bet)
Seat 4: c86f76e6 won ($0.75)
Seat 5: e2804f12 folded on the Flop
Seat 6: Hero (button) folded before Flop (didn't bet)


Poker Hand #HD1199219594: Hold'em No Limit  ($0.02/$0.05) - 2023/04/11 20:50:29
Table 'NLHBlue32' 6-max Seat #5 is the button
Seat 1: 2a59c51a ($4.04 in chips)
Seat 2: 40093001 ($4.68 in chips)
Seat 3: 88370224 ($5 in chips)
Seat 4: c86f76e6 ($5.71 in chips)
Seat 5: e2804f12 ($7.65 in chips)
Seat 6: Hero ($5 in chips)
Hero: posts small blind $0.02
2a59c51a: posts big blind $0.05
*** HOLE CARDS ***
Dealt to 2a59c51a 
Dealt to 40093001 
Dealt to 88370224 
Dealt to c86f76e6 
Dealt to e2804f12 
Dealt to Hero [5s 8c]
40093001: folds
88370224: folds
c86f76e6: folds
e2804f12: raises $0.08 to $0.13
Hero: folds
2a59c51a: calls $0.08
*** FLOP *** [Qc Js Ac]
2a59c51a: checks
e2804f12: checks
*** TURN *** [Qc Js Ac] [Jd]
2a59c51a: checks
e2804f12: checks
*** RIVER *** [Qc Js Ac Jd] [4s]
2a59c51a: bets $0.8
e2804f12: folds
Uncalled bet ($0.8) returned to 2a59c51a
*** SHOWDOWN ***
2a59c51a collected $0.27 from pot
*** SUMMARY ***
Total pot $0.28 | Rake $0.01 | Jackpot $0 | Bingo $0 | Fortune $0
Board [Qc Js Ac Jd 4s]
Seat 1: 2a59c51a (big blind) won ($0.27)
Seat 2: 40093001 folded before Flop (didn't bet)
Seat 3: 88370224 folded before Flop (didn't bet)
Seat 4: c86f76e6 folded before Flop (didn't bet)
Seat 5: e2804f12 (button) folded on the River
Seat 6: Hero (small blind) folded before Flop


Poker Hand #HD1199219493: Hold'em No Limit  ($0.02/$0.05) - 2023/04/11 20:49:43
Table 'NLHBlue32' 6-max Seat #4 is the button
Seat 1: 2a59c51a ($4.26 in chips)
Seat 2: 40093001 ($4.68 in chips)
Seat 3: 88370224 ($5 in chips)
Seat 4: c86f76e6 ($5.25 in chips)
Seat 5: e2804f12 ($7.87 in chips)
Seat 6: Hero ($5 in chips)
e2804f12: posts small blind $0.02
Hero: posts big blind $0.05
*** HOLE CARDS ***
Dealt to 2a59c51a 
Dealt to 40093001 
Dealt to 88370224 
Dealt to c86f76e6 
Dealt to e2804f12 
Dealt to Hero [8h Td]
2a59c51a: calls $0.05
40093001: folds
88370224: folds
c86f76e6: raises $0.17 to $0.22
e2804f12: calls $0.2
Hero: folds
2a59c51a: calls $0.17
*** FLOP *** [7h 5h 2d]
e2804f12: checks
2a59c51a: checks
c86f76e6: bets $0.4
e2804f12: folds
2a59c51a: folds
Uncalled bet ($0.4) returned to c86f76e6
*** SHOWDOWN ***
c86f76e6 collected $0.68 from pot
*** SUMMARY ***
Total pot $0.71 | Rake $0.03 | Jackpot $0 | Bingo $0 | Fortune $0
Board [7h 5h 2d]
Seat 1: 2a59c51a folded on the Flop
Seat 2: 40093001 folded before Flop (didn't bet)
Seat 3: 88370224 folded before Flop (didn't bet)
Seat 4: c86f76e6 (button) won ($0.68)
Seat 5: e2804f12 (small blind) folded on the Flop
Seat 6: Hero (big blind) folded before Flop


Poker Hand #HD1199219411: Hold'em No Limit  ($0.02/$0.05) - 2023/04/11 20:49:06
Table 'NLHBlue32' 6-max Seat #3 is the button
Seat 1: 2a59c51a ($4.31 in chips)
Seat 2: 40093001 ($4.68 in chips)
Seat 3: 88370224 ($5 in chips)
Seat 4: c86f76e6 ($4.95 in chips)
Seat 5: e2804f12 ($7.92 in chips)
Seat 6: Hero ($5 in chips)
c86f76e6: posts small blind $0.02
e2804f12: posts big blind $0.05
*** HOLE CARDS ***
Dealt to 2a59c51a 
Dealt to 40093001 
Dealt to 88370224 
Dealt to c86f76e6 
Dealt to e2804f12 
Dealt to Hero [9h 4h]
Hero: folds
2a59c51a: calls $0.05
40093001: folds
88370224: raises $0.17 to $0.22
c86f76e6: raises $0.58 to $0.8
e2804f12: folds
2a59c51a: folds
88370224: folds
Uncalled bet ($0.58) returned to c86f76e6
*** SHOWDOWN ***
c86f76e6 collected $0.52 from pot
*** SUMMARY ***
Total pot $0.54 | Rake $0.02 | Jackpot $0 | Bingo $0 | Fortune $0
Seat 1: 2a59c51a folded before Flop
Seat 2: 40093001 folded before Flop (didn't bet)
Seat 3: 88370224 (button) folded before Flop
Seat 4: c86f76e6 (small blind) collected ($0.52)
Seat 5: e2804f12 (big blind) folded before Flop
Seat 6: Hero folded before Flop (didn't bet)


Poker Hand #HD1199219296: Hold'em No Limit  ($0.02/$0.05) - 2023/04/11 20:48:16
Table 'NLHBlue32' 6-max Seat #2 is the button
Seat 1: 2a59c51a ($5.63 in chips)
Seat 2: 40093001 ($4.68 in chips)
Seat 3: 88370224 ($5 in chips)
Seat 4: c86f76e6 ($5 in chips)
Seat 5: e2804f12 ($6.71 in chips)
Seat 6: Hero ($5 in chips)
88370224: posts small blind $0.02
c86f76e6: posts big blind $0.05
*** HOLE CARDS ***
Dealt to 2a59c51a 
Dealt to 40093001 
Dealt to 88370224 
Dealt to c86f76e6 
Dealt to e2804f12 
Dealt to Hero [2s Ad]
e2804f12: raises $0.08 to $0.13
Hero: folds
2a59c51a: calls $0.13
40093001: folds
88370224: folds
c86f76e6: folds
*** FLOP *** [Js 6d Qh]
e2804f12: bets $0.17
2a59c51a: calls $0.17
*** TURN *** [Js 6d Qh] [5h]
e2804f12: bets $0.34
2a59c51a: calls $0.34
*** RIVER *** [Js 6d Qh 5h] [Qc]
e2804f12: bets $0.68
2a59c51a: calls $0.68
e2804f12: shows [Qs Kc] (Three Queens)
2a59c51a: shows [Ac Ks] (Pair of Queens)
*** SHOWDOWN ***
e2804f12 collected $2.53 from pot
*** SUMMARY ***
Total pot $2.71 | Rake $0.13 | Jackpot $0.05 | Bingo $0 | Fortune $0
Board [Js 6d Qh 5h Qc]
Seat 1: 2a59c51a showed [Ac Ks] and lost with Pair of Queens
Seat 2: 40093001 (button) folded before Flop (didn't bet)
Seat 3: 88370224 (small blind) folded before Flop
Seat 4: c86f76e6 (big blind) folded before Flop
Seat 5: e2804f12 showed [Qs Kc] and won ($2.53) with Three Queens
Seat 6: Hero folded before Flop (didn't bet)


Poker Hand #HD1199219170: Hold'em No Limit  ($0.02/$0.05) - 2023/04/11 20:47:16
Table 'NLHBlue32' 6-max Seat #1 is the button
Seat 1: 2a59c51a ($5.56 in chips)
Seat 2: 40093001 ($4.7 in chips)
Seat 3: 88370224 ($5 in chips)
Seat 5: e2804f12 ($6.71 in chips)
Seat 6: Hero ($5 in chips)
40093001: posts small blind $0.02
88370224: posts big blind $0.05
*** HOLE CARDS ***
Dealt to 2a59c51a 
Dealt to 40093001 
Dealt to 88370224 
Dealt to e2804f12 
Dealt to Hero [8d Qc]
e2804f12: folds
Hero: folds
2a59c51a: calls $0.05
40093001: folds
88370224: checks
*** FLOP *** [As Qd 4s]
88370224: checks
2a59c51a: checks
*** TURN *** [As Qd 4s] [3c]
88370224: checks
2a59c51a: checks
*** RIVER *** [As Qd 4s 3c] [Tc]
88370224: checks
2a59c51a: bets $0.06
88370224: folds
Uncalled bet ($0.06) returned to 2a59c51a
*** SHOWDOWN ***
2a59c51a collected $0.12 from pot
*** SUMMARY ***
Total pot $0.12 | Rake $0 | Jackpot $0 | Bingo $0 | Fortune $0
Board [As Qd 4s 3c Tc]
Seat 1: 2a59c51a (button) won ($0.12)
Seat 2: 40093001 (small blind) folded before Flop
Seat 3: 88370224 (big blind) folded on the River
Seat 5: e2804f12 folded before Flop (didn't bet)
Seat 6: Hero folded before Flop (didn't bet)


Poker Hand #HD1199219061: Hold'em No Limit  ($0.02/$0.05) - 2023/04/11 20:46:25
Table 'NLHBlue32' 6-max Seat #6 is the button
Seat 1: 2a59c51a ($5.39 in chips)
Seat 2: 40093001 ($4.75 in chips)
Seat 3: 88370224 ($5 in chips)
Seat 5: e2804f12 ($6.84 in chips)
Seat 6: Hero ($5 in chips)
2a59c51a: posts small blind $0.02
40093001: posts big blind $0.05
*** HOLE CARDS ***
Dealt to 2a59c51a 
Dealt to 40093001 
Dealt to 88370224 
Dealt to e2804f12 
Dealt to Hero [9s Kh]
88370224: folds
e2804f12: raises $0.08 to $0.13
Hero: folds
2a59c51a: calls $0.11
40093001: folds
*** FLOP *** [Tc 5d Qs]
2a59c51a: checks
e2804f12: checks
*** TURN *** [Tc 5d Qs] [8c]
2a59c51a: checks
e2804f12: checks
*** RIVER *** [Tc 5d Qs 8c] [9h]
2a59c51a: bets $0.11
e2804f12: folds
Uncalled bet ($0.11) returned to 2a59c51a
*** SHOWDOWN ***
2a59c51a collected $0.3 from pot
*** SUMMARY ***
Total pot $0.31 | Rake $0.01 | Jackpot $0 | Bingo $0 | Fortune $0
Board [Tc 5d Qs 8c 9h]
Seat 1: 2a59c51a (small blind) won ($0.3)
Seat 2: 40093001 (big blind) folded before Flop
Seat 3: 88370224 folded before Flop (didn't bet)
Seat 5: e2804f12 folded on the River
Seat 6: Hero (button) folded before Flop (didn't bet)


Poker Hand #HD1199218941: Hold'em No Limit  ($0.02/$0.05) - 2023/04/11 20:45:33
Table 'NLHBlue32' 6-max Seat #5 is the button
Seat 1: 2a59c51a ($5 in chips)
Seat 2: 40093001 ($4.88 in chips)
Seat 3: 88370224 ($5 in chips)
Seat 4: 9b5cf7b6 ($1.7 in chips)
Seat 5: e2804f12 ($6.97 in chips)
Seat 6: Hero ($5.01 in chips)
Hero: posts small blind $0.02
2a59c51a: posts big blind $0.05
*** HOLE CARDS ***
Dealt to 2a59c51a 
Dealt to 40093001 
Dealt to 88370224 
Dealt to 9b5cf7b6 
Dealt to e2804f12 
Dealt to Hero [3d 2c]
40093001: calls $0.05
88370224: folds
9b5cf7b6: calls $0.05
e2804f12: calls $0.05
Hero: folds
2a59c51a: checks
*** FLOP *** [5h 4h 2s]
2a59c51a: bets $0.08
40093001: calls $0.08
9b5cf7b6: calls $0.08
e2804f12: calls $0.08
*** TURN *** [5h 4h 2s] [Qd]
2a59c51a: bets $0.18
40093001: folds
9b5cf7b6: folds
e2804f12: folds
Uncalled bet ($0.18) returned to 2a59c51a
*** SHOWDOWN ***
2a59c51a collected $0.52 from pot
*** SUMMARY ***
Total pot $0.54 | Rake $0.02 | Jackpot $0 | Bingo $0 | Fortune $0
Board [5h 4h 2s Qd]
Seat 1: 2a59c51a (big blind) won ($0.52)
Seat 2: 40093001 folded on the Turn
Seat 3: 88370224 folded before Flop (didn't bet)
Seat 4: 9b5cf7b6 folded on the Turn
Seat 5: e2804f12 (button) folded on the Turn
Seat 6: Hero (small blind) folded before Flop


Poker Hand #HD1199218850: Hold'em No Limit  ($0.02/$0.05) - 2023/04/11 20:44:51
Table 'NLHBlue32' 6-max Seat #4 is the button
Seat 2: 40093001 ($4.88 in chips)
Seat 3: 88370224 ($5 in chips)
Seat 4: 9b5cf7b6 ($1.69 in chips)
Seat 5: e2804f12 ($6.99 in chips)
Seat 6: Hero ($5 in chips)
e2804f12: posts small blind $0.02
Hero: posts big blind $0.05
*** HOLE CARDS ***
Dealt to 40093001 
Dealt to 88370224 
Dealt to 9b5cf7b6 
Dealt to e2804f12 
Dealt to Hero [2h Ac]
40093001: folds
88370224: folds
9b5cf7b6: calls $0.05
e2804f12: folds
Hero: checks
*** FLOP *** [8c Ts 8s]
Hero: checks
9b5cf7b6: checks
*** TURN *** [8c Ts 8s] [6h]
Hero: checks
9b5cf7b6: checks
*** RIVER *** [8c Ts 8s 6h] [Jc]
Hero: checks
9b5cf7b6: checks
Hero: shows [2h Ac] (Pair of Eights)
9b5cf7b6: shows [7c Ad] (Pair of Eights)
*** SHOWDOWN ***
Hero collected $0.06 from pot
9b5cf7b6 collected $0.06 from pot
*** SUMMARY ***
Total pot $0.12 | Rake $0 | Jackpot $0 | Bingo $0 | Fortune $0
Board [8c Ts 8s 6h Jc]
Seat 2: 40093001 folded before Flop (didn't bet)
Seat 3: 88370224 folded before Flop (didn't bet)
Seat 4: 9b5cf7b6 (button) showed [7c Ad] and won ($0.06) with Pair of Eights
Seat 5: e2804f12 (small blind) folded before Flop
Seat 6: Hero (big blind) showed [2h Ac] and won ($0.06) with Pair of Eights


Poker Hand #HD1199218755: Hold'em No Limit  ($0.02/$0.05) - 2023/04/11 20:44:10
Table 'NLHBlue32' 6-max Seat #3 is the button
Seat 2: 40093001 ($5 in chips)
Seat 3: 88370224 ($5 in chips)
Seat 4: 9b5cf7b6 ($1.71 in chips)
Seat 5: e2804f12 ($6.4 in chips)
Seat 6: Hero ($5.12 in chips)
9b5cf7b6: posts small blind $0.02
e2804f12: posts big blind $0.05
*** HOLE CARDS ***
Dealt to 40093001 
Dealt to 88370224 
Dealt to 9b5cf7b6 
Dealt to e2804f12 
Dealt to Hero [Ad Qh]
Hero: raises $0.07 to $0.12
40093001: calls $0.12
88370224: folds
9b5cf7b6: folds
e2804f12: raises $0.38 to $0.5
Hero: calls $0.38
40093001: folds
*** FLOP *** [9s 5c 9d]
e2804f12: checks
Hero: checks
*** TURN *** [9s 5c 9d] [3c]
e2804f12: bets $0.57
Hero: folds
Uncalled bet ($0.57) returned to e2804f12
*** SHOWDOWN ***
e2804f12 collected $1.09 from pot
*** SUMMARY ***
Total pot $1.14 | Rake $0.05 | Jackpot $0 | Bingo $0 | Fortune $0
Board [9s 5c 9d 3c]
Seat 2: 40093001 folded before Flop
Seat 3: 88370224 (button) folded before Flop (didn't bet)
Seat 4: 9b5cf7b6 (small blind) folded before Flop
Seat 5: e2804f12 (big blind) won ($1.09)
Seat 6: Hero folded on the Turn


Poker Hand #HD1199218720: Hold'em No Limit  ($0.02/$0.05) - 2023/04/11 20:43:52
Table 'NLHBlue32' 6-max Seat #2 is the button
Seat 2: 40093001 ($4.93 in chips)
Seat 3: 88370224 ($5 in chips)
Seat 4: 9b5cf7b6 ($1.76 in chips)
Seat 5: e2804f12 ($6.4 in chips)
Seat 6: Hero ($5.12 in chips)
88370224: posts small blind $0.02
9b5cf7b6: posts big blind $0.05
*** HOLE CARDS ***
Dealt to 40093001 
Dealt to 88370224 
Dealt to 9b5cf7b6 
Dealt to e2804f12 
Dealt to Hero [9h Kd]
e2804f12: folds
Hero: folds
40093001: raises $0.1 to $0.15
88370224: folds
9b5cf7b6: folds
Uncalled bet ($0.1) returned to 40093001
*** SHOWDOWN ***
40093001 collected $0.12 from pot
*** SUMMARY ***
Total pot $0.12 | Rake $0 | Jackpot $0 | Bingo $0 | Fortune $0
Seat 2: 40093001 (button) collected ($0.12)
Seat 3: 88370224 (small blind) folded before Flop
Seat 4: 9b5cf7b6 (big blind) folded before Flop
Seat 5: e2804f12 folded before Flop (didn't bet)
Seat 6: Hero folded before Flop (didn't bet)


Poker Hand #HD1199218685: Hold'em No Limit  ($0.02/$0.05) - 2023/04/11 20:43:38
Table 'NLHBlue32' 6-max Seat #6 is the button
Seat 2: 40093001 ($4.95 in chips)
Seat 3: 88370224 ($5 in chips)
Seat 4: 9b5cf7b6 ($1.76 in chips)
Seat 5: e2804f12 ($6.4 in chips)
Seat 6: Hero ($5.05 in chips)
40093001: posts small blind $0.02
88370224: posts big blind $0.05
*** HOLE CARDS ***
Dealt to 40093001 
Dealt to 88370224 
Dealt to 9b5cf7b6 
Dealt to e2804f12 
Dealt to Hero [Td Ks]
9b5cf7b6: folds
e2804f12: folds
Hero: raises $0.07 to $0.12
40093001: folds
88370224: folds
Uncalled bet ($0.07) returned to Hero
*** SHOWDOWN ***
Hero collected $0.12 from pot
*** SUMMARY ***
Total pot $0.12 | Rake $0 | Jackpot $0 | Bingo $0 | Fortune $0
Seat 2: 40093001 (small blind) folded before Flop
Seat 3: 88370224 (big blind) folded before Flop
Seat 4: 9b5cf7b6 folded before Flop (didn't bet)
Seat 5: e2804f12 folded before Flop (didn't bet)
Seat 6: Hero (button) collected ($0.12)


Poker Hand #HD1199218582: Hold'em No Limit  ($0.02/$0.05) - 2023/04/11 20:42:49
Table 'NLHBlue32' 6-max Seat #5 is the button
Seat 1: 7552969a ($1.61 in chips)
Seat 2: 40093001 ($5 in chips)
Seat 4: 9b5cf7b6 ($1.76 in chips)
Seat 5: e2804f12 ($4.93 in chips)
Seat 6: Hero ($5.07 in chips)
Hero: posts small blind $0.02
7552969a: posts big blind $0.05
40093001: posts big blind $0.05
*** HOLE CARDS ***
Dealt to 7552969a 
Dealt to 40093001 
Dealt to 9b5cf7b6 
Dealt to e2804f12 
Dealt to Hero [5h 8c]
40093001: checks
9b5cf7b6: folds
e2804f12: raises $0.17 to $0.22
Hero: folds
7552969a: raises $1.39 to $1.61 and is all-in
40093001: folds
e2804f12: calls $1.39
7552969a: shows [Kd Ks]
e2804f12: shows [Ad 8d]
*** FLOP *** [Qs Ac 2d]
*** TURN *** [Qs Ac 2d] [Ah]
*** RIVER *** [Qs Ac 2d Ah] [2h]
*** SHOWDOWN ***
e2804f12 collected $3.08 from pot
*** SUMMARY ***
Total pot $3.29 | Rake $0.16 | Jackpot $0.05 | Bingo $0 | Fortune $0
Board [Qs Ac 2d Ah 2h]
Seat 1: 7552969a (big blind) showed [Kd Ks] and lost with Pair of Aces and Pair of Kings
Seat 2: 40093001 folded before Flop
Seat 4: 9b5cf7b6 folded before Flop (didn't bet)
Seat 5: e2804f12 (button) showed [Ad 8d] and won ($3.08) with Aces Full over Twos
Seat 6: Hero (small blind) folded before Flop


Poker Hand #HD1199218543: Hold'em No Limit  ($0.02/$0.05) - 2023/04/11 20:42:31
Table 'NLHBlue32' 6-max Seat #4 is the button
Seat 1: 7552969a ($1.61 in chips)
Seat 4: 9b5cf7b6 ($1.81 in chips)
Seat 5: e2804f12 ($4.95 in chips)
Seat 6: Hero ($5 in chips)
e2804f12: posts small blind $0.02
Hero: posts big blind $0.05
*** HOLE CARDS ***
Dealt to 7552969a 
Dealt to 9b5cf7b6 
Dealt to e2804f12 
Dealt to Hero [Kh Ks]
7552969a: folds
9b5cf7b6: calls $0.05
e2804f12: folds
Hero: raises $0.18 to $0.23
9b5cf7b6: folds
Uncalled bet ($0.18) returned to Hero
*** SHOWDOWN ***
Hero collected $0.12 from pot
*** SUMMARY ***
Total pot $0.12 | Rake $0 | Jackpot $0 | Bingo $0 | Fortune $0
Seat 1: 7552969a folded before Flop (didn't bet)
Seat 4: 9b5cf7b6 (button) folded before Flop
Seat 5: e2804f12 (small blind) folded before Flop
Seat 6: Hero (big blind) collected ($0.12)


