Poker Hand #HD1177159310: Hold'em No Limit  ($0.02/$0.05) - 2023/03/26 20:42:34
Table 'NLHBlue29' 6-max Seat #5 is the button
Seat 2: 5affe9bf ($10.99 in chips)
Seat 3: Hero ($7.54 in chips)
Seat 5: ca373d8f ($5 in chips)
Seat 6: f4398ddd ($5.02 in chips)
f4398ddd: posts small blind $0.02
5affe9bf: posts big blind $0.05
*** HOLE CARDS ***
Dealt to 5affe9bf 
Dealt to Hero [9h 8s]
Dealt to ca373d8f 
Dealt to f4398ddd 
Hero: folds
ca373d8f: raises $0.08 to $0.13
f4398ddd: folds
5affe9bf: calls $0.08
*** FLOP *** [6h 4d 8h]
5affe9bf: checks
ca373d8f: checks
*** TURN *** [6h 4d 8h] [2c]
5affe9bf: bets $0.14
ca373d8f: raises $0.36 to $0.5
5affe9bf: calls $0.36
*** RIVER *** [6h 4d 8h 2c] [6c]
5affe9bf: checks
ca373d8f: bets $0.8
5affe9bf: calls $0.8
ca373d8f: shows [Ks 3s] (Pair of Sixes)
5affe9bf: shows [7h 6d] (Three Sixes)
*** SHOWDOWN ***
5affe9bf collected $2.69 from pot
*** SUMMARY ***
Total pot $2.88 | Rake $0.14 | Jackpot $0.05 | Bingo $0 | Fortune $0
Board [6h 4d 8h 2c 6c]
Seat 2: 5affe9bf (big blind) showed [7h 6d] and won ($2.69) with Three Sixes
Seat 3: Hero folded before Flop (didn't bet)
Seat 5: ca373d8f (button) showed [Ks 3s] and lost with Pair of Sixes
Seat 6: f4398ddd (small blind) folded before Flop


Poker Hand #HD1177159295: Hold'em No Limit  ($0.02/$0.05) - 2023/03/26 20:42:26
Table 'NLHBlue29' 6-max Seat #3 is the button
Seat 2: 5affe9bf ($10.99 in chips)
Seat 3: Hero ($7.54 in chips)
Seat 5: ca373d8f ($5 in chips)
Seat 6: f4398ddd ($5 in chips)
ca373d8f: posts small blind $0.02
f4398ddd: posts big blind $0.05
*** HOLE CARDS ***
Dealt to 5affe9bf 
Dealt to Hero [6s Th]
Dealt to ca373d8f 
Dealt to f4398ddd 
5affe9bf: folds
Hero: folds
ca373d8f: folds
Uncalled bet ($0.03) returned to f4398ddd
*** SHOWDOWN ***
f4398ddd collected $0.04 from pot
*** SUMMARY ***
Total pot $0.04 | Rake $0 | Jackpot $0 | Bingo $0 | Fortune $0
Seat 2: 5affe9bf folded before Flop (didn't bet)
Seat 3: Hero (button) folded before Flop (didn't bet)
Seat 5: ca373d8f (small blind) folded before Flop
Seat 6: f4398ddd (big blind) collected ($0.04)


Poker Hand #HD1177159271: Hold'em No Limit  ($0.02/$0.05) - 2023/03/26 20:42:14
Table 'NLHBlue29' 6-max Seat #2 is the button
Seat 2: 5affe9bf ($10.99 in chips)
Seat 3: Hero ($7.49 in chips)
Seat 5: ca373d8f ($5 in chips)
Seat 6: f4398ddd ($5 in chips)
Hero: posts small blind $0.02
ca373d8f: posts big blind $0.05
*** HOLE CARDS ***
Dealt to 5affe9bf 
Dealt to Hero [7s 8s]
Dealt to ca373d8f 
Dealt to f4398ddd 
f4398ddd: folds
5affe9bf: folds
Hero: raises $0.09 to $0.14
ca373d8f: folds
Uncalled bet ($0.09) returned to Hero
*** SHOWDOWN ***
Hero collected $0.1 from pot
*** SUMMARY ***
Total pot $0.1 | Rake $0 | Jackpot $0 | Bingo $0 | Fortune $0
Seat 2: 5affe9bf (button) folded before Flop (didn't bet)
Seat 3: Hero (small blind) collected ($0.1)
Seat 5: ca373d8f (big blind) folded before Flop
Seat 6: f4398ddd folded before Flop (didn't bet)


Poker Hand #HD1177159144: Hold'em No Limit  ($0.02/$0.05) - 2023/03/26 20:41:09
Table 'NLHBlue29' 6-max Seat #6 is the button
Seat 2: 5affe9bf ($11.03 in chips)
Seat 3: Hero ($7.54 in chips)
Seat 5: ca373d8f ($5.03 in chips)
Seat 6: f4398ddd ($5 in chips)
5affe9bf: posts small blind $0.02
Hero: posts big blind $0.05
*** HOLE CARDS ***
Dealt to 5affe9bf 
Dealt to Hero [8s Ks]
Dealt to ca373d8f 
Dealt to f4398ddd 
ca373d8f: raises $0.08 to $0.13
f4398ddd: folds
5affe9bf: calls $0.11
Hero: calls $0.08
*** FLOP *** [Td Jh 9d]
5affe9bf: checks
Hero: checks
ca373d8f: checks
*** TURN *** [Td Jh 9d] [7s]
5affe9bf: bets $0.2
Hero: calls $0.2
ca373d8f: calls $0.2
*** RIVER *** [Td Jh 9d 7s] [Jc]
5affe9bf: checks
Hero: checks
ca373d8f: bets $0.33
5affe9bf: calls $0.33
Hero: calls $0.33
ca373d8f: shows [9c 8c] (Jacks-High Straight)
5affe9bf: shows [As 8h] (Jacks-High Straight)
Hero: shows [8s Ks] (Jacks-High Straight)
*** SHOWDOWN ***
Hero collected $0.61 from pot
ca373d8f collected $0.61 from pot
5affe9bf collected $0.62 from pot
*** SUMMARY ***
Total pot $1.98 | Rake $0.09 | Jackpot $0.05 | Bingo $0 | Fortune $0
Board [Td Jh 9d 7s Jc]
Seat 2: 5affe9bf (small blind) showed [As 8h] and won ($0.62) with Jacks-High Straight
Seat 3: Hero (big blind) showed [8s Ks] and won ($0.61) with Jacks-High Straight
Seat 5: ca373d8f showed [9c 8c] and won ($0.61) with Jacks-High Straight
Seat 6: f4398ddd (button) folded before Flop (didn't bet)


Poker Hand #HD1177159123: Hold'em No Limit  ($0.02/$0.05) - 2023/03/26 20:40:58
Table 'NLHBlue29' 6-max Seat #5 is the button
Seat 2: 5affe9bf ($11.01 in chips)
Seat 3: Hero ($7.54 in chips)
Seat 5: ca373d8f ($5.03 in chips)
Seat 6: f4398ddd ($5 in chips)
f4398ddd: posts small blind $0.02
5affe9bf: posts big blind $0.05
*** HOLE CARDS ***
Dealt to 5affe9bf 
Dealt to Hero [Js 7c]
Dealt to ca373d8f 
Dealt to f4398ddd 
Hero: folds
ca373d8f: folds
f4398ddd: folds
Uncalled bet ($0.03) returned to 5affe9bf
*** SHOWDOWN ***
5affe9bf collected $0.04 from pot
*** SUMMARY ***
Total pot $0.04 | Rake $0 | Jackpot $0 | Bingo $0 | Fortune $0
Seat 2: 5affe9bf (big blind) collected ($0.04)
Seat 3: Hero folded before Flop (didn't bet)
Seat 5: ca373d8f (button) folded before Flop (didn't bet)
Seat 6: f4398ddd (small blind) folded before Flop


Poker Hand #HD1177159093: Hold'em No Limit  ($0.02/$0.05) - 2023/03/26 20:40:39
Table 'NLHBlue29' 6-max Seat #3 is the button
Seat 2: 5affe9bf ($11.01 in chips)
Seat 3: Hero ($7.47 in chips)
Seat 5: ca373d8f ($5.05 in chips)
Seat 6: f4398ddd ($5 in chips)
ca373d8f: posts small blind $0.02
f4398ddd: posts big blind $0.05
*** HOLE CARDS ***
Dealt to 5affe9bf 
Dealt to Hero [5s Ks]
Dealt to ca373d8f 
Dealt to f4398ddd 
5affe9bf: folds
Hero: raises $0.07 to $0.12
ca373d8f: folds
f4398ddd: folds
Uncalled bet ($0.07) returned to Hero
*** SHOWDOWN ***
Hero collected $0.12 from pot
*** SUMMARY ***
Total pot $0.12 | Rake $0 | Jackpot $0 | Bingo $0 | Fortune $0
Seat 2: 5affe9bf folded before Flop (didn't bet)
Seat 3: Hero (button) collected ($0.12)
Seat 5: ca373d8f (small blind) folded before Flop
Seat 6: f4398ddd (big blind) folded before Flop


Poker Hand #HD1177158940: Hold'em No Limit  ($0.02/$0.05) - 2023/03/26 20:39:33
Table 'NLHBlue29' 6-max Seat #2 is the button
Seat 2: 5affe9bf ($10.03 in chips)
Seat 3: Hero ($7.6 in chips)
Seat 4: 4374a972 ($1 in chips)
Seat 5: ca373d8f ($5.05 in chips)
Hero: posts small blind $0.02
4374a972: posts big blind $0.05
*** HOLE CARDS ***
Dealt to 5affe9bf 
Dealt to Hero [Ks Qd]
Dealt to 4374a972 
Dealt to ca373d8f 
ca373d8f: folds
5affe9bf: raises $0.08 to $0.13
Hero: calls $0.11
4374a972: calls $0.08
*** FLOP *** [Qh Tc Jc]
Hero: checks
4374a972: bets $0.3
5affe9bf: raises $1.8 to $2.1
Hero: folds
4374a972: calls $0.57 and is all-in
Uncalled bet ($1.23) returned to 5affe9bf
5affe9bf: shows [Ah Kh] (Aces-High Straight)
4374a972: shows [Kd 3h] (King-High)
*** TURN *** [Qh Tc Jc] [2d]
*** RIVER *** [Qh Tc Jc 2d] [4s]
*** SHOWDOWN ***
5affe9bf collected $1.98 from pot
*** SUMMARY ***
Total pot $2.13 | Rake $0.1 | Jackpot $0.05 | Bingo $0 | Fortune $0
Board [Qh Tc Jc 2d 4s]
Seat 2: 5affe9bf (button) showed [Ah Kh] and won ($1.98) with Aces-High Straight
Seat 3: Hero (small blind) folded on the Flop
Seat 4: 4374a972 (big blind) showed [Kd 3h] and lost with King-High
Seat 5: ca373d8f folded before Flop (didn't bet)


Poker Hand #HD1177158929: Hold'em No Limit  ($0.02/$0.05) - 2023/03/26 20:39:24
Table 'NLHBlue29' 6-max Seat #5 is the button
Seat 2: 5affe9bf ($10.05 in chips)
Seat 3: Hero ($7.58 in chips)
Seat 4: 4374a972 ($1 in chips)
Seat 5: ca373d8f ($5.05 in chips)
5affe9bf: posts small blind $0.02
Hero: posts big blind $0.05
*** HOLE CARDS ***
Dealt to 5affe9bf 
Dealt to Hero [Kh Qs]
Dealt to 4374a972 
Dealt to ca373d8f 
4374a972: folds
ca373d8f: folds
5affe9bf: folds
Uncalled bet ($0.03) returned to Hero
*** SHOWDOWN ***
Hero collected $0.04 from pot
*** SUMMARY ***
Total pot $0.04 | Rake $0 | Jackpot $0 | Bingo $0 | Fortune $0
Seat 2: 5affe9bf (small blind) folded before Flop
Seat 3: Hero (big blind) collected ($0.04)
Seat 4: 4374a972 folded before Flop (didn't bet)
Seat 5: ca373d8f (button) folded before Flop (didn't bet)


Poker Hand #HD1177158888: Hold'em No Limit  ($0.02/$0.05) - 2023/03/26 20:39:03
Table 'NLHBlue29' 6-max Seat #4 is the button
Seat 2: 5affe9bf ($10.1 in chips)
Seat 3: Hero ($7.58 in chips)
Seat 4: 4374a972 ($1 in chips)
Seat 5: ca373d8f ($5 in chips)
ca373d8f: posts small blind $0.02
5affe9bf: posts big blind $0.05
*** HOLE CARDS ***
Dealt to 5affe9bf 
Dealt to Hero [8s Kh]
Dealt to 4374a972 
Dealt to ca373d8f 
Hero: folds
4374a972: folds
ca373d8f: raises $0.1 to $0.15
5affe9bf: folds
Uncalled bet ($0.1) returned to ca373d8f
*** SHOWDOWN ***
ca373d8f collected $0.1 from pot
*** SUMMARY ***
Total pot $0.1 | Rake $0 | Jackpot $0 | Bingo $0 | Fortune $0
Seat 2: 5affe9bf (big blind) folded before Flop
Seat 3: Hero folded before Flop (didn't bet)
Seat 4: 4374a972 (button) folded before Flop (didn't bet)
Seat 5: ca373d8f (small blind) collected ($0.1)


Poker Hand #HD1177158840: Hold'em No Limit  ($0.02/$0.05) - 2023/03/26 20:38:45
Table 'NLHBlue29' 6-max Seat #3 is the button
Seat 2: 5affe9bf ($10.1 in chips)
Seat 3: Hero ($7.58 in chips)
Seat 4: 4374a972 ($0.95 in chips)
Seat 5: ca373d8f ($5 in chips)
4374a972: posts small blind $0.02
ca373d8f: posts big blind $0.05
*** HOLE CARDS ***
Dealt to 5affe9bf 
Dealt to Hero [3h 2h]
Dealt to 4374a972 
Dealt to ca373d8f 
5affe9bf: folds
Hero: folds
4374a972: calls $0.03
ca373d8f: checks
*** FLOP *** [3c 9h 3s]
4374a972: bets $0.05
ca373d8f: folds
Uncalled bet ($0.05) returned to 4374a972
*** SHOWDOWN ***
4374a972 collected $0.1 from pot
*** SUMMARY ***
Total pot $0.1 | Rake $0 | Jackpot $0 | Bingo $0 | Fortune $0
Board [3c 9h 3s]
Seat 2: 5affe9bf folded before Flop (didn't bet)
Seat 3: Hero (button) folded before Flop (didn't bet)
Seat 4: 4374a972 (small blind) won ($0.1)
Seat 5: ca373d8f (big blind) folded on the Flop


Poker Hand #HD1177158802: Hold'em No Limit  ($0.02/$0.05) - 2023/03/26 20:38:27
Table 'NLHBlue29' 6-max Seat #2 is the button
Seat 2: 5affe9bf ($10.03 in chips)
Seat 3: Hero ($7.6 in chips)
Seat 4: 4374a972 ($1 in chips)
Hero: posts small blind $0.02
4374a972: posts big blind $0.05
*** HOLE CARDS ***
Dealt to 5affe9bf 
Dealt to Hero [8h 9h]
Dealt to 4374a972 
5affe9bf: raises $0.08 to $0.13
Hero: folds
4374a972: folds
Uncalled bet ($0.08) returned to 5affe9bf
*** SHOWDOWN ***
5affe9bf collected $0.12 from pot
*** SUMMARY ***
Total pot $0.12 | Rake $0 | Jackpot $0 | Bingo $0 | Fortune $0
Seat 2: 5affe9bf (button) collected ($0.12)
Seat 3: Hero (small blind) folded before Flop
Seat 4: 4374a972 (big blind) folded before Flop


Poker Hand #HD1177158790: Hold'em No Limit  ($0.02/$0.05) - 2023/03/26 20:38:22
Table 'NLHBlue29' 6-max Seat #3 is the button
Seat 2: 5affe9bf ($10.01 in chips)
Seat 3: Hero ($7.62 in chips)
Hero: posts small blind $0.02
5affe9bf: posts big blind $0.05
*** HOLE CARDS ***
Dealt to 5affe9bf 
Dealt to Hero [6s 8h]
Hero: folds
Uncalled bet ($0.03) returned to 5affe9bf
*** SHOWDOWN ***
5affe9bf collected $0.04 from pot
*** SUMMARY ***
Total pot $0.04 | Rake $0 | Jackpot $0 | Bingo $0 | Fortune $0
Seat 2: 5affe9bf (big blind) collected ($0.04)
Seat 3: Hero (small blind) folded before Flop


Poker Hand #HD1177158707: Hold'em No Limit  ($0.02/$0.05) - 2023/03/26 20:37:45
Table 'NLHBlue29' 6-max Seat #2 is the button
Seat 2: 5affe9bf ($9.71 in chips)
Seat 3: Hero ($7.95 in chips)
5affe9bf: posts small blind $0.02
Hero: posts big blind $0.05
*** HOLE CARDS ***
Dealt to 5affe9bf 
Dealt to Hero [Ac 2s]
5affe9bf: raises $0.05 to $0.1
Hero: calls $0.05
*** FLOP *** [8d 2h 6h]
Hero: checks
5affe9bf: bets $0.05
Hero: calls $0.05
*** TURN *** [8d 2h 6h] [Qd]
Hero: checks
5affe9bf: checks
*** RIVER *** [8d 2h 6h Qd] [8h]
Hero: bets $0.18
5affe9bf: calls $0.18
Hero: shows [Ac 2s] (Pair of Eights and Pair of Twos)
5affe9bf: shows [6c Ah] (Pair of Eights and Pair of Sixes)
*** SHOWDOWN ***
5affe9bf collected $0.63 from pot
*** SUMMARY ***
Total pot $0.66 | Rake $0.03 | Jackpot $0 | Bingo $0 | Fortune $0
Board [8d 2h 6h Qd 8h]
Seat 2: 5affe9bf (small blind) showed [6c Ah] and won ($0.63) with Pair of Eights and Pair of Sixes
Seat 3: Hero (big blind) showed [Ac 2s] and lost with Pair of Eights and Pair of Twos


Poker Hand #HD1177158689: Hold'em No Limit  ($0.02/$0.05) - 2023/03/26 20:37:40
Table 'NLHBlue29' 6-max Seat #3 is the button
Seat 2: 5affe9bf ($9.69 in chips)
Seat 3: Hero ($7.97 in chips)
Hero: posts small blind $0.02
5affe9bf: posts big blind $0.05
*** HOLE CARDS ***
Dealt to 5affe9bf 
Dealt to Hero [Qd 2h]
Hero: folds
Uncalled bet ($0.03) returned to 5affe9bf
*** SHOWDOWN ***
5affe9bf collected $0.04 from pot
*** SUMMARY ***
Total pot $0.04 | Rake $0 | Jackpot $0 | Bingo $0 | Fortune $0
Seat 2: 5affe9bf (big blind) collected ($0.04)
Seat 3: Hero (small blind) folded before Flop


Poker Hand #HD1177158645: Hold'em No Limit  ($0.02/$0.05) - 2023/03/26 20:37:20
Table 'NLHBlue29' 6-max Seat #2 is the button
Seat 2: 5affe9bf ($9.6 in chips)
Seat 3: Hero ($8.07 in chips)
5affe9bf: posts small blind $0.02
Hero: posts big blind $0.05
*** HOLE CARDS ***
Dealt to 5affe9bf 
Dealt to Hero [3h 3s]
5affe9bf: raises $0.05 to $0.1
Hero: calls $0.05
*** FLOP *** [Ts Kd 2s]
Hero: checks
5affe9bf: bets $0.1
Hero: folds
Uncalled bet ($0.1) returned to 5affe9bf
5affe9bf: shows [Th Kc] (Pair of Kings and Pair of Tens)
*** SHOWDOWN ***
5affe9bf collected $0.19 from pot
*** SUMMARY ***
Total pot $0.2 | Rake $0.01 | Jackpot $0 | Bingo $0 | Fortune $0
Board [Ts Kd 2s]
Seat 2: 5affe9bf (small blind) showed [Th Kc] and won ($0.19) with Pair of Kings and Pair of Tens
Seat 3: Hero (big blind) folded on the Flop


Poker Hand #HD1177158628: Hold'em No Limit  ($0.02/$0.05) - 2023/03/26 20:37:15
Table 'NLHBlue29' 6-max Seat #3 is the button
Seat 2: 5affe9bf ($9.58 in chips)
Seat 3: Hero ($8.09 in chips)
Hero: posts small blind $0.02
5affe9bf: posts big blind $0.05
*** HOLE CARDS ***
Dealt to 5affe9bf 
Dealt to Hero [3s Qd]
Hero: folds
Uncalled bet ($0.03) returned to 5affe9bf
*** SHOWDOWN ***
5affe9bf collected $0.04 from pot
*** SUMMARY ***
Total pot $0.04 | Rake $0 | Jackpot $0 | Bingo $0 | Fortune $0
Seat 2: 5affe9bf (big blind) collected ($0.04)
Seat 3: Hero (small blind) folded before Flop


Poker Hand #HD1177158618: Hold'em No Limit  ($0.02/$0.05) - 2023/03/26 20:37:09
Table 'NLHBlue29' 6-max Seat #2 is the button
Seat 2: 5affe9bf ($9.53 in chips)
Seat 3: Hero ($8.14 in chips)
5affe9bf: posts small blind $0.02
Hero: posts big blind $0.05
*** HOLE CARDS ***
Dealt to 5affe9bf 
Dealt to Hero [9h 4h]
5affe9bf: raises $0.08 to $0.13
Hero: folds
Uncalled bet ($0.08) returned to 5affe9bf
*** SHOWDOWN ***
5affe9bf collected $0.1 from pot
*** SUMMARY ***
Total pot $0.1 | Rake $0 | Jackpot $0 | Bingo $0 | Fortune $0
Seat 2: 5affe9bf (small blind) collected ($0.1)
Seat 3: Hero (big blind) folded before Flop


Poker Hand #HD1177158560: Hold'em No Limit  ($0.02/$0.05) - 2023/03/26 20:36:46
Table 'NLHBlue29' 6-max Seat #3 is the button
Seat 2: 5affe9bf ($9.65 in chips)
Seat 3: Hero ($8.03 in chips)
Hero: posts small blind $0.02
5affe9bf: posts big blind $0.05
*** HOLE CARDS ***
Dealt to 5affe9bf 
Dealt to Hero [7d Ac]
Hero: raises $0.07 to $0.12
5affe9bf: calls $0.07
*** FLOP *** [9d Jc 9s]
5affe9bf: checks
Hero: checks
*** TURN *** [9d Jc 9s] [Js]
5affe9bf: checks
Hero: checks
*** RIVER *** [9d Jc 9s Js] [Th]
5affe9bf: checks
Hero: checks
Hero: shows [7d Ac] (Pair of Jacks and Pair of Nines)
5affe9bf: shows [7h Qd] (Pair of Jacks and Pair of Nines)
*** SHOWDOWN ***
Hero collected $0.23 from pot
*** SUMMARY ***
Total pot $0.24 | Rake $0.01 | Jackpot $0 | Bingo $0 | Fortune $0
Board [9d Jc 9s Js Th]
Seat 2: 5affe9bf (big blind) showed [7h Qd] and lost with Pair of Jacks and Pair of Nines
Seat 3: Hero (small blind) showed [7d Ac] and won ($0.23) with Pair of Jacks and Pair of Nines


Poker Hand #HD1177158545: Hold'em No Limit  ($0.02/$0.05) - 2023/03/26 20:36:40
Table 'NLHBlue29' 6-max Seat #2 is the button
Seat 2: 5affe9bf ($9.67 in chips)
Seat 3: Hero ($8.01 in chips)
5affe9bf: posts small blind $0.02
Hero: posts big blind $0.05
*** HOLE CARDS ***
Dealt to 5affe9bf 
Dealt to Hero [As Ts]
5affe9bf: folds
Uncalled bet ($0.03) returned to Hero
*** SHOWDOWN ***
Hero collected $0.04 from pot
*** SUMMARY ***
Total pot $0.04 | Rake $0 | Jackpot $0 | Bingo $0 | Fortune $0
Seat 2: 5affe9bf (small blind) folded before Flop
Seat 3: Hero (big blind) collected ($0.04)


Poker Hand #HD1177158504: Hold'em No Limit  ($0.02/$0.05) - 2023/03/26 20:36:21
Table 'NLHBlue29' 6-max Seat #3 is the button
Seat 2: 5affe9bf ($9.54 in chips)
Seat 3: Hero ($8.15 in chips)
Hero: posts small blind $0.02
5affe9bf: posts big blind $0.05
*** HOLE CARDS ***
Dealt to 5affe9bf 
Dealt to Hero [6s 8s]
Hero: raises $0.09 to $0.14
5affe9bf: raises $0.36 to $0.5
Hero: folds
Uncalled bet ($0.36) returned to 5affe9bf
5affe9bf: shows [Kh Ah]
*** SHOWDOWN ***
5affe9bf collected $0.27 from pot
*** SUMMARY ***
Total pot $0.28 | Rake $0.01 | Jackpot $0 | Bingo $0 | Fortune $0
Seat 2: 5affe9bf (big blind) showed [Kh Ah] and collected ($0.27)
Seat 3: Hero (small blind) folded before Flop


Poker Hand #HD1177158490: Hold'em No Limit  ($0.02/$0.05) - 2023/03/26 20:36:16
Table 'NLHBlue29' 6-max Seat #2 is the button
Seat 2: 5affe9bf ($9.56 in chips)
Seat 3: Hero ($8.13 in chips)
5affe9bf: posts small blind $0.02
Hero: posts big blind $0.05
*** HOLE CARDS ***
Dealt to 5affe9bf 
Dealt to Hero [Qc 7c]
5affe9bf: folds
Uncalled bet ($0.03) returned to Hero
*** SHOWDOWN ***
Hero collected $0.04 from pot
*** SUMMARY ***
Total pot $0.04 | Rake $0 | Jackpot $0 | Bingo $0 | Fortune $0
Seat 2: 5affe9bf (small blind) folded before Flop
Seat 3: Hero (big blind) collected ($0.04)


Poker Hand #HD1177158409: Hold'em No Limit  ($0.02/$0.05) - 2023/03/26 20:35:40
Table 'NLHBlue29' 6-max Seat #6 is the button
Seat 2: 5affe9bf ($9.44 in chips)
Seat 3: Hero ($8.26 in chips)
Seat 6: fbc8ce17 ($4.51 in chips)
5affe9bf: posts small blind $0.02
Hero: posts big blind $0.05
*** HOLE CARDS ***
Dealt to 5affe9bf 
Dealt to Hero [Kh 6h]
Dealt to fbc8ce17 
fbc8ce17: folds
5affe9bf: raises $0.08 to $0.13
Hero: calls $0.08
*** FLOP *** [3s 8h Ad]
5affe9bf: bets $0.13
Hero: folds
Uncalled bet ($0.13) returned to 5affe9bf
*** SHOWDOWN ***
5affe9bf collected $0.25 from pot
*** SUMMARY ***
Total pot $0.26 | Rake $0.01 | Jackpot $0 | Bingo $0 | Fortune $0
Board [3s 8h Ad]
Seat 2: 5affe9bf (small blind) won ($0.25)
Seat 3: Hero (big blind) folded on the Flop
Seat 6: fbc8ce17 (button) folded before Flop (didn't bet)


Poker Hand #HD1177158309: Hold'em No Limit  ($0.02/$0.05) - 2023/03/26 20:34:52
Table 'NLHBlue29' 6-max Seat #3 is the button
Seat 2: 5affe9bf ($10.19 in chips)
Seat 3: Hero ($8.26 in chips)
Seat 6: fbc8ce17 ($3.88 in chips)
fbc8ce17: posts small blind $0.02
5affe9bf: posts big blind $0.05
*** HOLE CARDS ***
Dealt to 5affe9bf 
Dealt to Hero [4d Jc]
Dealt to fbc8ce17 
Hero: folds
fbc8ce17: raises $0.05 to $0.1
5affe9bf: calls $0.05
*** FLOP *** [4c 5c 3s]
fbc8ce17: bets $0.15
5affe9bf: calls $0.15
*** TURN *** [4c 5c 3s] [Jd]
fbc8ce17: bets $0.5
5affe9bf: calls $0.5
*** RIVER *** [4c 5c 3s Jd] [8c]
fbc8ce17: checks
5affe9bf: checks
fbc8ce17: shows [3h 3c] (Three Treys)
5affe9bf: shows [5d 2c] (Pair of Fives)
*** SHOWDOWN ***
fbc8ce17 collected $1.38 from pot
*** SUMMARY ***
Total pot $1.5 | Rake $0.07 | Jackpot $0.05 | Bingo $0 | Fortune $0
Board [4c 5c 3s Jd 8c]
Seat 2: 5affe9bf (big blind) showed [5d 2c] and lost with Pair of Fives
Seat 3: Hero (button) folded before Flop (didn't bet)
Seat 6: fbc8ce17 (small blind) showed [3h 3c] and won ($1.38) with Three Treys


Poker Hand #HD1177158295: Hold'em No Limit  ($0.02/$0.05) - 2023/03/26 20:34:47
Table 'NLHBlue29' 6-max Seat #2 is the button
Seat 2: 5affe9bf ($10.19 in chips)
Seat 3: Hero ($8.28 in chips)
Seat 6: fbc8ce17 ($3.86 in chips)
Hero: posts small blind $0.02
fbc8ce17: posts big blind $0.05
*** HOLE CARDS ***
Dealt to 5affe9bf 
Dealt to Hero [8d 5h]
Dealt to fbc8ce17 
5affe9bf: folds
Hero: folds
Uncalled bet ($0.03) returned to fbc8ce17
*** SHOWDOWN ***
fbc8ce17 collected $0.04 from pot
*** SUMMARY ***
Total pot $0.04 | Rake $0 | Jackpot $0 | Bingo $0 | Fortune $0
Seat 2: 5affe9bf (button) folded before Flop (didn't bet)
Seat 3: Hero (small blind) folded before Flop
Seat 6: fbc8ce17 (big blind) collected ($0.04)


Poker Hand #HD1177158285: Hold'em No Limit  ($0.02/$0.05) - 2023/03/26 20:34:41
Table 'NLHBlue29' 6-max Seat #6 is the button
Seat 2: 5affe9bf ($10.21 in chips)
Seat 3: Hero ($8.26 in chips)
Seat 6: fbc8ce17 ($3.86 in chips)
5affe9bf: posts small blind $0.02
Hero: posts big blind $0.05
*** HOLE CARDS ***
Dealt to 5affe9bf 
Dealt to Hero [6s Ac]
Dealt to fbc8ce17 
fbc8ce17: folds
5affe9bf: folds
Uncalled bet ($0.03) returned to Hero
*** SHOWDOWN ***
Hero collected $0.04 from pot
*** SUMMARY ***
Total pot $0.04 | Rake $0 | Jackpot $0 | Bingo $0 | Fortune $0
Seat 2: 5affe9bf (small blind) folded before Flop
Seat 3: Hero (big blind) collected ($0.04)
Seat 6: fbc8ce17 (button) folded before Flop (didn't bet)


Poker Hand #HD1177158178: Hold'em No Limit  ($0.02/$0.05) - 2023/03/26 20:33:57
Table 'NLHBlue29' 6-max Seat #3 is the button
Seat 2: 5affe9bf ($10.78 in chips)
Seat 3: Hero ($7.72 in chips)
Seat 6: fbc8ce17 ($3.88 in chips)
fbc8ce17: posts small blind $0.02
5affe9bf: posts big blind $0.05
*** HOLE CARDS ***
Dealt to 5affe9bf 
Dealt to Hero [Ks Kh]
Dealt to fbc8ce17 
Hero: raises $0.07 to $0.12
fbc8ce17: folds
5affe9bf: calls $0.07
*** FLOP *** [Kd Kc 7c]
5affe9bf: checks
Hero: bets $0.09
5affe9bf: raises $0.11 to $0.2
Hero: calls $0.11
*** TURN *** [Kd Kc 7c] [3s]
5affe9bf: checks
Hero: checks
*** RIVER *** [Kd Kc 7c 3s] [2d]
5affe9bf: bets $0.25
Hero: raises $0.51 to $0.76
5affe9bf: folds
Uncalled bet ($0.51) returned to Hero
Hero: shows [Ks Kh] (Four Kings)
*** SHOWDOWN ***
Hero collected $1.11 from pot
*** SUMMARY ***
Total pot $1.16 | Rake $0.05 | Jackpot $0 | Bingo $0 | Fortune $0
Board [Kd Kc 7c 3s 2d]
Seat 2: 5affe9bf (big blind) folded on the River
Seat 3: Hero (button) showed [Ks Kh] and won ($1.11) with Four Kings
Seat 6: fbc8ce17 (small blind) folded before Flop


Poker Hand #HD1177158112: Hold'em No Limit  ($0.02/$0.05) - 2023/03/26 20:33:29
Table 'NLHBlue29' 6-max Seat #2 is the button
Seat 2: 5affe9bf ($10.91 in chips)
Seat 3: Hero ($7.74 in chips)
Seat 6: fbc8ce17 ($3.74 in chips)
Hero: posts small blind $0.02
fbc8ce17: posts big blind $0.05
*** HOLE CARDS ***
Dealt to 5affe9bf 
Dealt to Hero [Jh 6c]
Dealt to fbc8ce17 
5affe9bf: raises $0.08 to $0.13
Hero: folds
fbc8ce17: calls $0.08
*** FLOP *** [Kd Td 2h]
fbc8ce17: checks
5affe9bf: checks
*** TURN *** [Kd Td 2h] [Th]
fbc8ce17: bets $0.15
5affe9bf: folds
Uncalled bet ($0.15) returned to fbc8ce17
*** SHOWDOWN ***
fbc8ce17 collected $0.27 from pot
*** SUMMARY ***
Total pot $0.28 | Rake $0.01 | Jackpot $0 | Bingo $0 | Fortune $0
Board [Kd Td 2h Th]
Seat 2: 5affe9bf (button) folded on the Turn
Seat 3: Hero (small blind) folded before Flop
Seat 6: fbc8ce17 (big blind) won ($0.27)


Poker Hand #HD1177157976: Hold'em No Limit  ($0.02/$0.05) - 2023/03/26 20:32:23
Table 'NLHBlue29' 6-max Seat #6 is the button
Seat 2: 5affe9bf ($10.63 in chips)
Seat 3: Hero ($7.84 in chips)
Seat 6: fbc8ce17 ($3.94 in chips)
5affe9bf: posts small blind $0.02
Hero: posts big blind $0.05
*** HOLE CARDS ***
Dealt to 5affe9bf 
Dealt to Hero [Kd Qh]
Dealt to fbc8ce17 
fbc8ce17: raises $0.05 to $0.1
5affe9bf: calls $0.08
Hero: calls $0.05
*** FLOP *** [6s 8c 2h]
5affe9bf: bets $0.1
Hero: folds
fbc8ce17: calls $0.1
*** TURN *** [6s 8c 2h] [8s]
5affe9bf: bets $0.17
fbc8ce17: folds
Uncalled bet ($0.17) returned to 5affe9bf
*** SHOWDOWN ***
5affe9bf collected $0.48 from pot
*** SUMMARY ***
Total pot $0.5 | Rake $0.02 | Jackpot $0 | Bingo $0 | Fortune $0
Board [6s 8c 2h 8s]
Seat 2: 5affe9bf (small blind) won ($0.48)
Seat 3: Hero (big blind) folded on the Flop
Seat 6: fbc8ce17 (button) folded on the Turn


Poker Hand #HD1177157859: Hold'em No Limit  ($0.02/$0.05) - 2023/03/26 20:31:33
Table 'NLHBlue29' 6-max Seat #3 is the button
Seat 2: 5affe9bf ($10.5 in chips)
Seat 3: Hero ($7.96 in chips)
Seat 6: fbc8ce17 ($3.96 in chips)
fbc8ce17: posts small blind $0.02
5affe9bf: posts big blind $0.05
*** HOLE CARDS ***
Dealt to 5affe9bf 
Dealt to Hero [Qc Jc]
Dealt to fbc8ce17 
Hero: raises $0.07 to $0.12
fbc8ce17: folds
5affe9bf: calls $0.07
*** FLOP *** [8s 3d 6h]
5affe9bf: checks
Hero: checks
*** TURN *** [8s 3d 6h] [6c]
5affe9bf: checks
Hero: checks
*** RIVER *** [8s 3d 6h 6c] [9c]
5affe9bf: checks
Hero: checks
5affe9bf: shows [Ac 5h] (Pair of Sixes)
Hero: shows [Qc Jc] (Pair of Sixes)
*** SHOWDOWN ***
5affe9bf collected $0.25 from pot
*** SUMMARY ***
Total pot $0.26 | Rake $0.01 | Jackpot $0 | Bingo $0 | Fortune $0
Board [8s 3d 6h 6c 9c]
Seat 2: 5affe9bf (big blind) showed [Ac 5h] and won ($0.25) with Pair of Sixes
Seat 3: Hero (button) showed [Qc Jc] and lost with Pair of Sixes
Seat 6: fbc8ce17 (small blind) folded before Flop


Poker Hand #HD1177157839: Hold'em No Limit  ($0.02/$0.05) - 2023/03/26 20:31:25
Table 'NLHBlue29' 6-max Seat #2 is the button
Seat 2: 5affe9bf ($10.5 in chips)
Seat 3: Hero ($7.98 in chips)
Seat 6: fbc8ce17 ($3.94 in chips)
Hero: posts small blind $0.02
fbc8ce17: posts big blind $0.05
*** HOLE CARDS ***
Dealt to 5affe9bf 
Dealt to Hero [Th 3c]
Dealt to fbc8ce17 
5affe9bf: folds
Hero: folds
Uncalled bet ($0.03) returned to fbc8ce17
*** SHOWDOWN ***
fbc8ce17 collected $0.04 from pot
*** SUMMARY ***
Total pot $0.04 | Rake $0 | Jackpot $0 | Bingo $0 | Fortune $0
Seat 2: 5affe9bf (button) folded before Flop (didn't bet)
Seat 3: Hero (small blind) folded before Flop
Seat 6: fbc8ce17 (big blind) collected ($0.04)


Poker Hand #HD1177157817: Hold'em No Limit  ($0.02/$0.05) - 2023/03/26 20:31:15
Table 'NLHBlue29' 6-max Seat #6 is the button
Seat 2: 5affe9bf ($10.52 in chips)
Seat 3: Hero ($7.96 in chips)
Seat 6: fbc8ce17 ($3.94 in chips)
5affe9bf: posts small blind $0.02
Hero: posts big blind $0.05
*** HOLE CARDS ***
Dealt to 5affe9bf 
Dealt to Hero [9c 3h]
Dealt to fbc8ce17 
fbc8ce17: folds
5affe9bf: folds
Uncalled bet ($0.03) returned to Hero
*** SHOWDOWN ***
Hero collected $0.04 from pot
*** SUMMARY ***
Total pot $0.04 | Rake $0 | Jackpot $0 | Bingo $0 | Fortune $0
Seat 2: 5affe9bf (small blind) folded before Flop
Seat 3: Hero (big blind) collected ($0.04)
Seat 6: fbc8ce17 (button) folded before Flop (didn't bet)


Poker Hand #HD1177157759: Hold'em No Limit  ($0.02/$0.05) - 2023/03/26 20:30:47
Table 'NLHBlue29' 6-max Seat #3 is the button
Seat 2: 5affe9bf ($10.52 in chips)
Seat 3: Hero ($7.89 in chips)
Seat 5: d04f608d ($5 in chips)
Seat 6: fbc8ce17 ($3.99 in chips)
d04f608d: posts small blind $0.02
fbc8ce17: posts big blind $0.05
*** HOLE CARDS ***
Dealt to 5affe9bf 
Dealt to Hero [8c 9c]
Dealt to d04f608d 
Dealt to fbc8ce17 
5affe9bf: folds
Hero: raises $0.07 to $0.12
d04f608d: folds
fbc8ce17: folds
Uncalled bet ($0.07) returned to Hero
*** SHOWDOWN ***
Hero collected $0.12 from pot
*** SUMMARY ***
Total pot $0.12 | Rake $0 | Jackpot $0 | Bingo $0 | Fortune $0
Seat 2: 5affe9bf folded before Flop (didn't bet)
Seat 3: Hero (button) collected ($0.12)
Seat 5: d04f608d (small blind) folded before Flop
Seat 6: fbc8ce17 (big blind) folded before Flop


Poker Hand #HD1177157717: Hold'em No Limit  ($0.02/$0.05) - 2023/03/26 20:30:27
Table 'NLHBlue29' 6-max Seat #2 is the button
Seat 2: 5affe9bf ($10.45 in chips)
Seat 3: Hero ($7.91 in chips)
Seat 5: d04f608d ($5 in chips)
Seat 6: fbc8ce17 ($3.99 in chips)
Hero: posts small blind $0.02
d04f608d: posts big blind $0.05
*** HOLE CARDS ***
Dealt to 5affe9bf 
Dealt to Hero [Js 2h]
Dealt to d04f608d 
Dealt to fbc8ce17 
fbc8ce17: folds
5affe9bf: raises $0.08 to $0.13
Hero: folds
d04f608d: folds
Uncalled bet ($0.08) returned to 5affe9bf
*** SHOWDOWN ***
5affe9bf collected $0.12 from pot
*** SUMMARY ***
Total pot $0.12 | Rake $0 | Jackpot $0 | Bingo $0 | Fortune $0
Seat 2: 5affe9bf (button) collected ($0.12)
Seat 3: Hero (small blind) folded before Flop
Seat 5: d04f608d (big blind) folded before Flop
Seat 6: fbc8ce17 folded before Flop (didn't bet)


Poker Hand #HD1177157651: Hold'em No Limit  ($0.02/$0.05) - 2023/03/26 20:29:58
Table 'NLHBlue29' 6-max Seat #6 is the button
Seat 2: 5affe9bf ($10.4 in chips)
Seat 3: Hero ($7.96 in chips)
Seat 6: fbc8ce17 ($3.99 in chips)
5affe9bf: posts small blind $0.02
Hero: posts big blind $0.05
*** HOLE CARDS ***
Dealt to 5affe9bf 
Dealt to Hero [5d 3s]
Dealt to fbc8ce17 
fbc8ce17: folds
5affe9bf: raises $0.08 to $0.13
Hero: folds
Uncalled bet ($0.08) returned to 5affe9bf
*** SHOWDOWN ***
5affe9bf collected $0.1 from pot
*** SUMMARY ***
Total pot $0.1 | Rake $0 | Jackpot $0 | Bingo $0 | Fortune $0
Seat 2: 5affe9bf (small blind) collected ($0.1)
Seat 3: Hero (big blind) folded before Flop
Seat 6: fbc8ce17 (button) folded before Flop (didn't bet)


Poker Hand #HD1177157626: Hold'em No Limit  ($0.02/$0.05) - 2023/03/26 20:29:47
Table 'NLHBlue29' 6-max Seat #3 is the button
Seat 2: 5affe9bf ($10.45 in chips)
Seat 3: Hero ($7.96 in chips)
Seat 6: fbc8ce17 ($3.94 in chips)
fbc8ce17: posts small blind $0.02
5affe9bf: posts big blind $0.05
*** HOLE CARDS ***
Dealt to 5affe9bf 
Dealt to Hero [6h 2d]
Dealt to fbc8ce17 
Hero: folds
fbc8ce17: raises $0.05 to $0.1
5affe9bf: folds
Uncalled bet ($0.05) returned to fbc8ce17
*** SHOWDOWN ***
fbc8ce17 collected $0.1 from pot
*** SUMMARY ***
Total pot $0.1 | Rake $0 | Jackpot $0 | Bingo $0 | Fortune $0
Seat 2: 5affe9bf (big blind) folded before Flop
Seat 3: Hero (button) folded before Flop (didn't bet)
Seat 6: fbc8ce17 (small blind) collected ($0.1)


Poker Hand #HD1177157498: Hold'em No Limit  ($0.02/$0.05) - 2023/03/26 20:28:46
Table 'NLHBlue29' 6-max Seat #2 is the button
Seat 2: 5affe9bf ($10.45 in chips)
Seat 3: Hero ($8.66 in chips)
Seat 6: fbc8ce17 ($3.31 in chips)
Hero: posts small blind $0.02
fbc8ce17: posts big blind $0.05
*** HOLE CARDS ***
Dealt to 5affe9bf 
Dealt to Hero [4s As]
Dealt to fbc8ce17 
5affe9bf: folds
Hero: raises $0.09 to $0.14
fbc8ce17: calls $0.09
*** FLOP *** [4d 3d 5h]
Hero: checks
fbc8ce17: bets $0.21
Hero: calls $0.21
*** TURN *** [4d 3d 5h] [8h]
Hero: checks
fbc8ce17: bets $0.35
Hero: calls $0.35
*** RIVER *** [4d 3d 5h 8h] [Jc]
Hero: checks
fbc8ce17: checks
Hero: shows [4s As] (Pair of Fours)
fbc8ce17: shows [8d 6d] (Pair of Eights)
*** SHOWDOWN ***
fbc8ce17 collected $1.33 from pot
*** SUMMARY ***
Total pot $1.4 | Rake $0.07 | Jackpot $0 | Bingo $0 | Fortune $0
Board [4d 3d 5h 8h Jc]
Seat 2: 5affe9bf (button) folded before Flop (didn't bet)
Seat 3: Hero (small blind) showed [4s As] and lost with Pair of Fours
Seat 6: fbc8ce17 (big blind) showed [8d 6d] and won ($1.33) with Pair of Eights


Poker Hand #HD1177157416: Hold'em No Limit  ($0.02/$0.05) - 2023/03/26 20:28:07
Table 'NLHBlue29' 6-max Seat #6 is the button
Seat 2: 5affe9bf ($10.27 in chips)
Seat 3: Hero ($8.86 in chips)
Seat 6: fbc8ce17 ($3.31 in chips)
5affe9bf: posts small blind $0.02
Hero: posts big blind $0.05
*** HOLE CARDS ***
Dealt to 5affe9bf 
Dealt to Hero [9c 8s]
Dealt to fbc8ce17 
fbc8ce17: folds
5affe9bf: raises $0.05 to $0.1
Hero: calls $0.05
*** FLOP *** [Ah 6s 7d]
5affe9bf: checks
Hero: checks
*** TURN *** [Ah 6s 7d] [3h]
5affe9bf: checks
Hero: bets $0.1
5affe9bf: calls $0.1
*** RIVER *** [Ah 6s 7d 3h] [Js]
5affe9bf: checks
Hero: checks
5affe9bf: shows [9h Kh] (Ace-High)
Hero: shows [9c 8s] (Ace-High)
*** SHOWDOWN ***
5affe9bf collected $0.38 from pot
*** SUMMARY ***
Total pot $0.4 | Rake $0.02 | Jackpot $0 | Bingo $0 | Fortune $0
Board [Ah 6s 7d 3h Js]
Seat 2: 5affe9bf (small blind) showed [9h Kh] and won ($0.38) with Ace-High
Seat 3: Hero (big blind) showed [9c 8s] and lost with Ace-High
Seat 6: fbc8ce17 (button) folded before Flop (didn't bet)


Poker Hand #HD1177157272: Hold'em No Limit  ($0.02/$0.05) - 2023/03/26 20:27:02
Table 'NLHBlue29' 6-max Seat #3 is the button
Seat 1: bf6f8809 ($0.32 in chips)
Seat 2: 5affe9bf ($10.27 in chips)
Seat 3: Hero ($8.86 in chips)
Seat 4: 8c8da217 ($5.45 in chips)
Seat 6: fbc8ce17 ($3 in chips)
8c8da217: posts small blind $0.02
fbc8ce17: posts big blind $0.05
bf6f8809: posts missed blind $0.02
*** HOLE CARDS ***
Dealt to bf6f8809 
Dealt to 5affe9bf 
Dealt to Hero [Kd 5d]
Dealt to 8c8da217 
Dealt to fbc8ce17 
bf6f8809: raises $0.25 to $0.3 and is all-in
5affe9bf: folds
Hero: folds
8c8da217: folds
fbc8ce17: calls $0.25
bf6f8809: shows [6s 6h]
fbc8ce17: shows [Js Qc]
*** FLOP *** [Qd Tc 5h]
*** TURN *** [Qd Tc 5h] [4s]
*** RIVER *** [Qd Tc 5h 4s] [8s]
*** SHOWDOWN ***
fbc8ce17 collected $0.61 from pot
*** SUMMARY ***
Total pot $0.64 | Rake $0.03 | Jackpot $0 | Bingo $0 | Fortune $0
Board [Qd Tc 5h 4s 8s]
Seat 1: bf6f8809 showed [6s 6h] and lost with Pair of Sixes
Seat 2: 5affe9bf folded before Flop (didn't bet)
Seat 3: Hero (button) folded before Flop (didn't bet)
Seat 4: 8c8da217 (small blind) folded before Flop
Seat 6: fbc8ce17 (big blind) showed [Js Qc] and won ($0.61) with Pair of Queens


Poker Hand #HD1177157247: Hold'em No Limit  ($0.02/$0.05) - 2023/03/26 20:26:52
Table 'NLHBlue29' 6-max Seat #2 is the button
Seat 2: 5affe9bf ($10.27 in chips)
Seat 3: Hero ($8.81 in chips)
Seat 4: 8c8da217 ($5.5 in chips)
Seat 6: fbc8ce17 ($3 in chips)
Hero: posts small blind $0.02
8c8da217: posts big blind $0.05
*** HOLE CARDS ***
Dealt to 5affe9bf 
Dealt to Hero [Tc Jd]
Dealt to 8c8da217 
Dealt to fbc8ce17 
fbc8ce17: folds
5affe9bf: folds
Hero: raises $0.09 to $0.14
8c8da217: folds
Uncalled bet ($0.09) returned to Hero
*** SHOWDOWN ***
Hero collected $0.1 from pot
*** SUMMARY ***
Total pot $0.1 | Rake $0 | Jackpot $0 | Bingo $0 | Fortune $0
Seat 2: 5affe9bf (button) folded before Flop (didn't bet)
Seat 3: Hero (small blind) collected ($0.1)
Seat 4: 8c8da217 (big blind) folded before Flop
Seat 6: fbc8ce17 folded before Flop (didn't bet)


Poker Hand #HD1177157174: Hold'em No Limit  ($0.02/$0.05) - 2023/03/26 20:26:18
Table 'NLHBlue29' 6-max Seat #6 is the button
Seat 2: 5affe9bf ($10.13 in chips)
Seat 3: Hero ($8.96 in chips)
Seat 4: 8c8da217 ($5.5 in chips)
Seat 6: fbc8ce17 ($3 in chips)
5affe9bf: posts small blind $0.02
Hero: posts big blind $0.05
*** HOLE CARDS ***
Dealt to 5affe9bf 
Dealt to Hero [3h Qh]
Dealt to 8c8da217 
Dealt to fbc8ce17 
8c8da217: folds
fbc8ce17: folds
5affe9bf: raises $0.05 to $0.1
Hero: calls $0.05
*** FLOP *** [Qs 6s Kh]
5affe9bf: checks
Hero: bets $0.05
5affe9bf: calls $0.05
*** TURN *** [Qs 6s Kh] [4c]
5affe9bf: checks
Hero: checks
*** RIVER *** [Qs 6s Kh 4c] [Ah]
5affe9bf: checks
Hero: checks
5affe9bf: shows [Qd Js] (Pair of Queens)
Hero: shows [3h Qh] (Pair of Queens)
*** SHOWDOWN ***
5affe9bf collected $0.29 from pot
*** SUMMARY ***
Total pot $0.3 | Rake $0.01 | Jackpot $0 | Bingo $0 | Fortune $0
Board [Qs 6s Kh 4c Ah]
Seat 2: 5affe9bf (small blind) showed [Qd Js] and won ($0.29) with Pair of Queens
Seat 3: Hero (big blind) showed [3h Qh] and lost with Pair of Queens
Seat 4: 8c8da217 folded before Flop (didn't bet)
Seat 6: fbc8ce17 (button) folded before Flop (didn't bet)


Poker Hand #HD1177157112: Hold'em No Limit  ($0.02/$0.05) - 2023/03/26 20:25:53
Table 'NLHBlue29' 6-max Seat #4 is the button
Seat 1: bf6f8809 ($0.37 in chips)
Seat 2: 5affe9bf ($10.13 in chips)
Seat 3: Hero ($8.96 in chips)
Seat 4: 8c8da217 ($5.43 in chips)
Seat 6: fbc8ce17 ($3 in chips)
fbc8ce17: posts small blind $0.02
bf6f8809: posts big blind $0.05
*** HOLE CARDS ***
Dealt to bf6f8809 
Dealt to 5affe9bf 
Dealt to Hero [Jh 2s]
Dealt to 8c8da217 
Dealt to fbc8ce17 
5affe9bf: folds
Hero: folds
8c8da217: raises $0.08 to $0.13
fbc8ce17: folds
bf6f8809: folds
Uncalled bet ($0.08) returned to 8c8da217
*** SHOWDOWN ***
8c8da217 collected $0.12 from pot
*** SUMMARY ***
Total pot $0.12 | Rake $0 | Jackpot $0 | Bingo $0 | Fortune $0
Seat 1: bf6f8809 (big blind) folded before Flop
Seat 2: 5affe9bf folded before Flop (didn't bet)
Seat 3: Hero folded before Flop (didn't bet)
Seat 4: 8c8da217 (button) collected ($0.12)
Seat 6: fbc8ce17 (small blind) folded before Flop


Poker Hand #HD1177157006: Hold'em No Limit  ($0.02/$0.05) - 2023/03/26 20:25:04
Table 'NLHBlue29' 6-max Seat #3 is the button
Seat 1: bf6f8809 ($0.37 in chips)
Seat 2: 5affe9bf ($8.9 in chips)
Seat 3: Hero ($8.96 in chips)
Seat 4: 8c8da217 ($5.45 in chips)
Seat 6: fbc8ce17 ($3 in chips)
8c8da217: posts small blind $0.02
fbc8ce17: posts big blind $0.05
*** HOLE CARDS ***
Dealt to bf6f8809 
Dealt to 5affe9bf 
Dealt to Hero [Ac 6s]
Dealt to 8c8da217 
Dealt to fbc8ce17 
bf6f8809: folds
5affe9bf: raises $0.08 to $0.13
Hero: folds
8c8da217: folds
fbc8ce17: calls $0.08
*** FLOP *** [9h 2s 7c]
fbc8ce17: bets $0.14
5affe9bf: calls $0.14
*** TURN *** [9h 2s 7c] [4s]
fbc8ce17: bets $0.28
5affe9bf: calls $0.28
*** RIVER *** [9h 2s 7c 4s] [8s]
fbc8ce17: checks
5affe9bf: bets $0.84
fbc8ce17: calls $0.84
5affe9bf: shows [Ks As] (Ace High Flush)
fbc8ce17: shows [9s Jc] (Pair of Nines)
*** SHOWDOWN ***
5affe9bf collected $2.62 from pot
*** SUMMARY ***
Total pot $2.8 | Rake $0.13 | Jackpot $0.05 | Bingo $0 | Fortune $0
Board [9h 2s 7c 4s 8s]
Seat 1: bf6f8809 folded before Flop (didn't bet)
Seat 2: 5affe9bf showed [Ks As] and won ($2.62) with Ace High Flush
Seat 3: Hero (button) folded before Flop (didn't bet)
Seat 4: 8c8da217 (small blind) folded before Flop
Seat 6: fbc8ce17 (big blind) showed [9s Jc] and lost with Pair of Nines


Poker Hand #HD1177156919: Hold'em No Limit  ($0.02/$0.05) - 2023/03/26 20:24:25
Table 'NLHBlue29' 6-max Seat #2 is the button
Seat 2: 5affe9bf ($8.9 in chips)
Seat 3: Hero ($9.45 in chips)
Seat 4: 8c8da217 ($5 in chips)
Seat 5: e095410f ($5.69 in chips)
Seat 6: fbc8ce17 ($3 in chips)
Hero: posts small blind $0.02
8c8da217: posts big blind $0.05
*** HOLE CARDS ***
Dealt to 5affe9bf 
Dealt to Hero [4d 4c]
Dealt to 8c8da217 
Dealt to e095410f 
Dealt to fbc8ce17 
e095410f: folds
fbc8ce17: folds
5affe9bf: folds
Hero: raises $0.09 to $0.14
8c8da217: raises $0.35 to $0.49
Hero: calls $0.35
*** FLOP *** [7d 8d Jh]
Hero: checks
8c8da217: bets $0.52
Hero: folds
Uncalled bet ($0.52) returned to 8c8da217
*** SHOWDOWN ***
8c8da217 collected $0.94 from pot
*** SUMMARY ***
Total pot $0.98 | Rake $0.04 | Jackpot $0 | Bingo $0 | Fortune $0
Board [7d 8d Jh]
Seat 2: 5affe9bf (button) folded before Flop (didn't bet)
Seat 3: Hero (small blind) folded on the Flop
Seat 4: 8c8da217 (big blind) won ($0.94)
Seat 5: e095410f folded before Flop (didn't bet)
Seat 6: fbc8ce17 folded before Flop (didn't bet)


Poker Hand #HD1177156706: Hold'em No Limit  ($0.02/$0.05) - 2023/03/26 20:22:52
Table 'NLHBlue29' 6-max Seat #1 is the button
Seat 1: bf6f8809 ($0.37 in chips)
Seat 2: 5affe9bf ($8.52 in chips)
Seat 3: Hero ($9.5 in chips)
Seat 4: 8c8da217 ($5 in chips)
Seat 5: e095410f ($5.69 in chips)
Seat 6: fbc8ce17 ($3 in chips)
5affe9bf: posts small blind $0.02
Hero: posts big blind $0.05
*** HOLE CARDS ***
Dealt to bf6f8809 
Dealt to 5affe9bf 
Dealt to Hero [Kc 5d]
Dealt to 8c8da217 
Dealt to e095410f 
Dealt to fbc8ce17 
8c8da217: folds
e095410f: folds
fbc8ce17: raises $0.12 to $0.17
bf6f8809: folds
5affe9bf: calls $0.15
Hero: folds
*** FLOP *** [7c Qh 5c]
5affe9bf: checks
fbc8ce17: bets $0.2
5affe9bf: calls $0.2
*** TURN *** [7c Qh 5c] [9s]
5affe9bf: checks
fbc8ce17: checks
*** RIVER *** [7c Qh 5c 9s] [Jh]
5affe9bf: checks
fbc8ce17: checks
5affe9bf: shows [8s 8c] (Pair of Eights)
fbc8ce17: shows [Ks As] (Ace-High)
*** SHOWDOWN ***
5affe9bf collected $0.75 from pot
*** SUMMARY ***
Total pot $0.79 | Rake $0.04 | Jackpot $0 | Bingo $0 | Fortune $0
Board [7c Qh 5c 9s Jh]
Seat 1: bf6f8809 (button) folded before Flop (didn't bet)
Seat 2: 5affe9bf (small blind) showed [8s 8c] and won ($0.75) with Pair of Eights
Seat 3: Hero (big blind) folded before Flop
Seat 4: 8c8da217 folded before Flop (didn't bet)
Seat 5: e095410f folded before Flop (didn't bet)
Seat 6: fbc8ce17 showed [Ks As] and lost with Ace-High


Poker Hand #HD1177156570: Hold'em No Limit  ($0.02/$0.05) - 2023/03/26 20:21:48
Table 'NLHBlue29' 6-max Seat #6 is the button
Seat 1: bf6f8809 ($5.37 in chips)
Seat 2: 5affe9bf ($8.57 in chips)
Seat 3: Hero ($5 in chips)
Seat 4: 8c8da217 ($5 in chips)
Seat 5: e095410f ($5.69 in chips)
Seat 6: fbc8ce17 ($3 in chips)
bf6f8809: posts small blind $0.02
5affe9bf: posts big blind $0.05
*** HOLE CARDS ***
Dealt to bf6f8809 
Dealt to 5affe9bf 
Dealt to Hero [Ks Qd]
Dealt to 8c8da217 
Dealt to e095410f 
Dealt to fbc8ce17 
Hero: raises $0.07 to $0.12
8c8da217: folds
e095410f: folds
fbc8ce17: folds
bf6f8809: calls $0.1
5affe9bf: folds
*** FLOP *** [4c 9s Ts]
bf6f8809: checks
Hero: bets $0.15
bf6f8809: calls $0.15
*** TURN *** [4c 9s Ts] [Js]
bf6f8809: bets $0.45
Hero: calls $0.45
*** RIVER *** [4c 9s Ts Js] [2s]
bf6f8809: bets $4.65 and is all-in
Hero: calls $4.28 and is all-in
Uncalled bet ($0.37) returned to bf6f8809
bf6f8809: shows [Qs 8d] (Queen High Flush)
Hero: shows [Ks Qd] (King High Flush)
*** SHOWDOWN ***
Hero collected $9.5 from pot
*** SUMMARY ***
Total pot $10.05 | Rake $0.5 | Jackpot $0.05 | Bingo $0 | Fortune $0
Board [4c 9s Ts Js 2s]
Seat 1: bf6f8809 (small blind) showed [Qs 8d] and lost with Queen High Flush
Seat 2: 5affe9bf (big blind) folded before Flop
Seat 3: Hero showed [Ks Qd] and won ($9.5) with King High Flush
Seat 4: 8c8da217 folded before Flop (didn't bet)
Seat 5: e095410f folded before Flop (didn't bet)
Seat 6: fbc8ce17 (button) folded before Flop (didn't bet)


Poker Hand #HD1177156417: Hold'em No Limit  ($0.02/$0.05) - 2023/03/26 20:20:35
Table 'NLHBlue29' 6-max Seat #5 is the button
Seat 1: bf6f8809 ($5.13 in chips)
Seat 2: 5affe9bf ($8.7 in chips)
Seat 3: Hero ($5 in chips)
Seat 4: 8c8da217 ($5 in chips)
Seat 5: e095410f ($5.69 in chips)
Seat 6: fbc8ce17 ($3.01 in chips)
fbc8ce17: posts small blind $0.02
bf6f8809: posts big blind $0.05
*** HOLE CARDS ***
Dealt to bf6f8809 
Dealt to 5affe9bf 
Dealt to Hero [Qs 5h]
Dealt to 8c8da217 
Dealt to e095410f 
Dealt to fbc8ce17 
5affe9bf: raises $0.08 to $0.13
Hero: folds
8c8da217: folds
e095410f: folds
fbc8ce17: calls $0.11
bf6f8809: calls $0.08
*** FLOP *** [Td Ad 4s]
fbc8ce17: checks
bf6f8809: checks
5affe9bf: checks
*** TURN *** [Td Ad 4s] [8s]
fbc8ce17: checks
bf6f8809: checks
5affe9bf: checks
*** RIVER *** [Td Ad 4s 8s] [4c]
fbc8ce17: checks
bf6f8809: checks
5affe9bf: checks
fbc8ce17: shows [Ks Jc] (Pair of Fours)
bf6f8809: shows [Ts 7d] (Pair of Tens and Pair of Fours)
5affe9bf: shows [9d 9s] (Pair of Nines and Pair of Fours)
*** SHOWDOWN ***
bf6f8809 collected $0.37 from pot
*** SUMMARY ***
Total pot $0.39 | Rake $0.02 | Jackpot $0 | Bingo $0 | Fortune $0
Board [Td Ad 4s 8s 4c]
Seat 1: bf6f8809 (big blind) showed [Ts 7d] and won ($0.37) with Pair of Tens and Pair of Fours
Seat 2: 5affe9bf showed [9d 9s] and lost with Pair of Nines and Pair of Fours
Seat 3: Hero folded before Flop (didn't bet)
Seat 4: 8c8da217 folded before Flop (didn't bet)
Seat 5: e095410f (button) folded before Flop (didn't bet)
Seat 6: fbc8ce17 (small blind) showed [Ks Jc] and lost with Pair of Fours


Poker Hand #HD1177156285: Hold'em No Limit  ($0.02/$0.05) - 2023/03/26 20:19:33
Table 'NLHBlue29' 6-max Seat #4 is the button
Seat 1: bf6f8809 ($5.06 in chips)
Seat 2: 5affe9bf ($8.7 in chips)
Seat 3: Hero ($5 in chips)
Seat 4: 8c8da217 ($5 in chips)
Seat 5: e095410f ($5.71 in chips)
Seat 6: fbc8ce17 ($3.06 in chips)
e095410f: posts small blind $0.02
fbc8ce17: posts big blind $0.05
*** HOLE CARDS ***
Dealt to bf6f8809 
Dealt to 5affe9bf 
Dealt to Hero [3d Jc]
Dealt to 8c8da217 
Dealt to e095410f 
Dealt to fbc8ce17 
bf6f8809: calls $0.05
5affe9bf: folds
Hero: folds
8c8da217: folds
e095410f: folds
fbc8ce17: checks
*** FLOP *** [6c 8h Tc]
fbc8ce17: checks
bf6f8809: checks
*** TURN *** [6c 8h Tc] [9c]
fbc8ce17: checks
bf6f8809: bets $0.06
fbc8ce17: folds
Uncalled bet ($0.06) returned to bf6f8809
*** SHOWDOWN ***
bf6f8809 collected $0.12 from pot
*** SUMMARY ***
Total pot $0.12 | Rake $0 | Jackpot $0 | Bingo $0 | Fortune $0
Board [6c 8h Tc 9c]
Seat 1: bf6f8809 won ($0.12)
Seat 2: 5affe9bf folded before Flop (didn't bet)
Seat 3: Hero folded before Flop (didn't bet)
Seat 4: 8c8da217 (button) folded before Flop (didn't bet)
Seat 5: e095410f (small blind) folded before Flop
Seat 6: fbc8ce17 (big blind) folded on the Turn


Poker Hand #HD1177156188: Hold'em No Limit  ($0.02/$0.05) - 2023/03/26 20:18:45
Table 'NLHBlue29' 6-max Seat #3 is the button
Seat 1: bf6f8809 ($5.05 in chips)
Seat 2: 5affe9bf ($8.7 in chips)
Seat 3: Hero ($5 in chips)
Seat 4: 8c8da217 ($5 in chips)
Seat 5: e095410f ($5.7 in chips)
Seat 6: fbc8ce17 ($3.06 in chips)
8c8da217: posts small blind $0.02
e095410f: posts big blind $0.05
*** HOLE CARDS ***
Dealt to bf6f8809 
Dealt to 5affe9bf 
Dealt to Hero [5c 6h]
Dealt to 8c8da217 
Dealt to e095410f 
Dealt to fbc8ce17 
fbc8ce17: folds
bf6f8809: calls $0.05
5affe9bf: folds
Hero: folds
8c8da217: folds
e095410f: checks
*** FLOP *** [Ts 3c Th]
e095410f: checks
bf6f8809: checks
*** TURN *** [Ts 3c Th] [Ad]
e095410f: checks
bf6f8809: checks
*** RIVER *** [Ts 3c Th Ad] [3h]
e095410f: checks
bf6f8809: checks
e095410f: shows [5h Kh] (Pair of Tens and Pair of Treys)
bf6f8809: shows [Qd 6c] (Pair of Tens and Pair of Treys)
*** SHOWDOWN ***
e095410f collected $0.06 from pot
bf6f8809 collected $0.06 from pot
*** SUMMARY ***
Total pot $0.12 | Rake $0 | Jackpot $0 | Bingo $0 | Fortune $0
Board [Ts 3c Th Ad 3h]
Seat 1: bf6f8809 showed [Qd 6c] and won ($0.06) with Pair of Tens and Pair of Treys
Seat 2: 5affe9bf folded before Flop (didn't bet)
Seat 3: Hero (button) folded before Flop (didn't bet)
Seat 4: 8c8da217 (small blind) folded before Flop
Seat 5: e095410f (big blind) showed [5h Kh] and won ($0.06) with Pair of Tens and Pair of Treys
Seat 6: fbc8ce17 folded before Flop (didn't bet)


Poker Hand #HD1177156016: Hold'em No Limit  ($0.02/$0.05) - 2023/03/26 20:17:26
Table 'NLHBlue29' 6-max Seat #2 is the button
Seat 1: bf6f8809 ($4.59 in chips)
Seat 2: 5affe9bf ($9.13 in chips)
Seat 3: Hero ($5 in chips)
Seat 4: 8c8da217 ($5 in chips)
Seat 5: e095410f ($5.7 in chips)
Seat 6: fbc8ce17 ($3.06 in chips)
Hero: posts small blind $0.02
8c8da217: posts big blind $0.05
*** HOLE CARDS ***
Dealt to bf6f8809 
Dealt to 5affe9bf 
Dealt to Hero [As 4s]
Dealt to 8c8da217 
Dealt to e095410f 
Dealt to fbc8ce17 
e095410f: folds
fbc8ce17: folds
bf6f8809: raises $0.1 to $0.15
5affe9bf: calls $0.15
Hero: folds
8c8da217: folds
*** FLOP *** [Kd 6c 7d]
bf6f8809: bets $0.28
5affe9bf: calls $0.28
*** TURN *** [Kd 6c 7d] [Jc]
bf6f8809: bets $0.93
5affe9bf: folds
Uncalled bet ($0.93) returned to bf6f8809
*** SHOWDOWN ***
bf6f8809 collected $0.89 from pot
*** SUMMARY ***
Total pot $0.93 | Rake $0.04 | Jackpot $0 | Bingo $0 | Fortune $0
Board [Kd 6c 7d Jc]
Seat 1: bf6f8809 won ($0.89)
Seat 2: 5affe9bf (button) folded on the Turn
Seat 3: Hero (small blind) folded before Flop
Seat 4: 8c8da217 (big blind) folded before Flop
Seat 5: e095410f folded before Flop (didn't bet)
Seat 6: fbc8ce17 folded before Flop (didn't bet)


Poker Hand #HD1177155959: Hold'em No Limit  ($0.02/$0.05) - 2023/03/26 20:16:53
Table 'NLHBlue29' 6-max Seat #1 is the button
Seat 1: bf6f8809 ($4.49 in chips)
Seat 2: 5affe9bf ($9.18 in chips)
Seat 3: Hero ($5 in chips)
Seat 4: 8c8da217 ($5 in chips)
Seat 5: e095410f ($5.7 in chips)
Seat 6: fbc8ce17 ($3.06 in chips)
5affe9bf: posts small blind $0.02
Hero: posts big blind $0.05
*** HOLE CARDS ***
Dealt to bf6f8809 
Dealt to 5affe9bf 
Dealt to Hero [Jd 2d]
Dealt to 8c8da217 
Dealt to e095410f 
Dealt to fbc8ce17 
8c8da217: folds
e095410f: folds
fbc8ce17: folds
bf6f8809: calls $0.05
5affe9bf: calls $0.03
Hero: checks
*** FLOP *** [Qs 3h Qd]
5affe9bf: checks
Hero: checks
bf6f8809: bets $0.12
5affe9bf: folds
Hero: folds
Uncalled bet ($0.12) returned to bf6f8809
*** SHOWDOWN ***
bf6f8809 collected $0.15 from pot
*** SUMMARY ***
Total pot $0.15 | Rake $0 | Jackpot $0 | Bingo $0 | Fortune $0
Board [Qs 3h Qd]
Seat 1: bf6f8809 (button) won ($0.15)
Seat 2: 5affe9bf (small blind) folded on the Flop
Seat 3: Hero (big blind) folded on the Flop
Seat 4: 8c8da217 folded before Flop (didn't bet)
Seat 5: e095410f folded before Flop (didn't bet)
Seat 6: fbc8ce17 folded before Flop (didn't bet)


